-กัดกร่อน	corrosive	๗ มี.ค. ๒๕๔๕
-ต่อตรง	direct connected	๗ มี.ค. ๒๕๔๕
-ตั้งพื้น	floor mounted	๗ มี.ค. ๒๕๔๕
-ติดกันโดยวิธีกล	mechanically bonded	๗ มี.ค. ๒๕๔๕
-ติดผนัง	wall mounted	๗ มี.ค. ๒๕๔๕
-ติดเพดาน	ceiling mounted	๗ มี.ค. ๒๕๔๕
-ทำงานด้วยลมอัด	air-operated	๗ มี.ค. ๒๕๔๕
-พับไข้วทแยงมุม	cross broken	๗ มี.ค. ๒๕๔๕
โรงทำความเย็น	refrigerating plant	๗ มี.ค. ๒๕๔๕
แมนอมิเตอร์	manometer	๗ มี.ค. ๒๕๔๕
absolute humidity	ความชื้นสัมบูรณ์	๗ มี.ค. ๒๕๔๕
absolute pressure	ความดันสัมบูรณ์	๗ มี.ค. ๒๕๔๕
absolute temperature	อุณหภูมิสัมบูรณ์	๗ มี.ค. ๒๕๔๕
absolute zero	ศูนย์สัมบูรณ์	๗ มี.ค. ๒๕๔๕
absorber	ชุดดูดกลืน	๗ มี.ค. ๒๕๔๕
absorption	การดูดกลืน	๗ มี.ค. ๒๕๔๕
absorbent	ตัวดูดกลืน	๗ มี.ค. ๒๕๔๕
absorption chiller	เครื่องทำน้ำเย็นแบบดูดกลืน	๗ มี.ค. ๒๕๔๕
absorption refrigerator	เครื่องทำความเย็นแบบดูดกลืน	๗ มี.ค. ๒๕๔๕
absorptivity	สภาพดูดกลืน	๗ มี.ค. ๒๕๔๕
access door	ช่องทางเข้า	๗ มี.ค. ๒๕๔๕
accumulator	ถังพัก	๗ มี.ค. ๒๕๔๕
activated alumina	อะลูมินากัมมันต์	๗ มี.ค. ๒๕๔๕
activated carbon	คาร์บอนกัมมันต์	๗ มี.ค. ๒๕๔๕
actual displacement	ปริมาตรกระจัดจริง	๗ มี.ค. ๒๕๔๕
ระยะตก (ของลม)	drop	๗ มี.ค. ๒๕๔๕
ระยะพุ่ง (ของลม)	throw	๗ มี.ค. ๒๕๔๕
adiabatic process	กระบวนการแอเดียแบติก	๗ มี.ค. ๒๕๔๕
adjustable grille	ช่องลมปรับทิศทางได้	๗ มี.ค. ๒๕๔๕
adsorbent	ตัวดูดซับ	๗ มี.ค. ๒๕๔๕
adsorption	การดูดซับ	๗ มี.ค. ๒๕๔๕
ระดับวิสัยสามารถ	capacity step	๗ มี.ค. ๒๕๔๕
ระดับขั้นการอิ่มตัว	degree of saturation	๗ มี.ค. ๒๕๔๕
ระดับความสูง	altitude	๗ มี.ค. ๒๕๔๕
ระบบระเหยสารทำความเย็นโดยตรง	direct expansion system	๗ มี.ค. ๒๕๔๕
ระบบสะสมน้ำเย็น	chilled water storage system	๗ มี.ค. ๒๕๔๕
ระบบสะสมน้ำเกลือแข็ง	salt storage system	๗ มี.ค. ๒๕๔๕
ระบบสะสมน้ำแข็ง	ice storage system	๗ มี.ค. ๒๕๔๕
ระบบสะสมน้ำแข็งในถุงพลาสติก	encapsulated ice storage system	๗ มี.ค. ๒๕๔๕
ระบบสะสมน้ำแข็งแบบเก็บเกี่ยว	ice harvesting storage system	๗ มี.ค. ๒๕๔๕
ระบบสะสมน้ำแข็งบนคอยล์	ice-on coil storage system	๗ มี.ค. ๒๕๔๕
ระบบลมจ่ายแปรเปลี่ยน, ระบบวีเอวี	variable air volume system; VAV system	๗ มี.ค. ๒๕๔๕
ระบบลมจ่ายคงที่, ระบบซีเอซี	constant air volume system; CAV system	๗ มี.ค. ๒๕๔๕
ระบบการอัด	compression system	๗ มี.ค. ๒๕๔๕
ระบบกระจายลม	air distribution system	๗ มี.ค. ๒๕๔๕
ระบบซีเอวี, ระบบลมจ่ายคงที่	CAV system; constant air volume system	๗ มี.ค. ๒๕๔๕
ระบบทำความเย็น	refrigerating system	๗ มี.ค. ๒๕๔๕
ระบบทำความเย็นเชิงกล	mechanical refrigerating system	๗ มี.ค. ๒๕๔๕
ระบบทำความเย็นแบบพหุคูณ	multiple refrigeration system	๗ มี.ค. ๒๕๔๕
ระบบทำความเย็นส่วนกลาง	central plant system	๗ มี.ค. ๒๕๔๕
ระบบท่อลม	duct system	๗ มี.ค. ๒๕๔๕
ระบบท่อลมความดันต่ำ	low pressure duct system	๗ มี.ค. ๒๕๔๕
ระบบปรับอากาศแบบลมล้วน	all-air air conditioning system	๗ มี.ค. ๒๕๔๕
ระบบปรับอากาศแบบน้ำล้วน	all-water air conditioning system; hydronic air conditioning system	๗ มี.ค. ๒๕๔๕
ระบบพัดลมส่วนกลาง	central fan system	๗ มี.ค. ๒๕๔๕
ระบบพัดลมส่วนกลาง	central fan system	๗ มี.ค. ๒๕๔๕
เส้นภาวะสบาย	comfort line	๗ มี.ค. ๒๕๔๕
รหัส	code	๗ มี.ค. ๒๕๔๕
เสียงรบกวน; สัญญาณรบกวน	noise	๗ มี.ค. ๒๕๔๕
aeration	การผึ่งลม	๗ มี.ค. ๒๕๔๕
aerosol	ละอองลอย	๗ มี.ค. ๒๕๔๕
affinity laws	กฎสัมพรรคภาพ	๗ มี.ค. ๒๕๔๕
AHU (air handling unit)	เอเอชยู (หน่วยเครื่องส่งลม)	๗ มี.ค. ๒๕๔๕
เอเอชยู (หน่วยเครื่องส่งลม)	AHU (air handling unit)	๗ มี.ค. ๒๕๔๕
รอยต่อเชิงกล	mechanical joint	๗ มี.ค. ๒๕๔๕
รอยต่อเชื่อม	welded joint	๗ มี.ค. ๒๕๔๕
รอยต่อเชื่อมประสาน	brazed joint	๗ มี.ค. ๒๕๔๕
มอเตอร์เวลา	timer motor	๗ มี.ค. ๒๕๔๕
มอเตอร์แบบขั้น	stepping motor	๗ มี.ค. ๒๕๔๕
มอเตอร์สมวาร, ซิงโครนัสมอเตอร์	synchrorous motor	๗ มี.ค. ๒๕๔๕
มอเตอร์หมุนปรับแบบต่อเนื่อง	modulatint motor	๗ มี.ค. ๒๕๔๕
มอเตอร์ส่ายลม	swng motor	๗ มี.ค. ๒๕๔๕
มอเตอร์ลม	air motor	๗ มี.ค. ๒๕๔๕
มอเตอร์ชุดแผ่นปรับลม	damper motor	๗ มี.ค. ๒๕๔๕
air chamber	๑. ห้องอากาศ๒. ห้องลม	๗ มี.ค. ๒๕๔๕
air change	การผลัดเปลี่ยนลม	๗ มี.ค. ๒๕๔๕
air changes	หน่วยปริมาณผลัดเปลี่ยนลม	๗ มี.ค. ๒๕๔๕
air circulation	การหมุนเวียนลม	๗ มี.ค. ๒๕๔๕
air cleaner	เครื่องฟอกอากาศ	๗ มี.ค. ๒๕๔๕
air	อากาศ, ลม	๗ มี.ค. ๒๕๔๕
air conditioner; air conditioning unit	เครื่องปรับอากาศ	๗ มี.ค. ๒๕๔๕
air conditioner; air conditioning unit	เครื่องปรับอากาศ	๗ มี.ค. ๒๕๔๕
air conditioning	การปรับอากาศ	๗ มี.ค. ๒๕๔๕
air conditioning unit; air conditioner	เครื่องปรับอากาศ	๗ มี.ค. ๒๕๔๕
air conditioning unit; air conditioner	เครื่องปรับอากาศ	๗ มี.ค. ๒๕๔๕
air deflector	แผ่นเบนทางลม	๗ มี.ค. ๒๕๔๕
air diffuser	หัวจ่ายลม	๗ มี.ค. ๒๕๔๕
air distribution system	ระบบกระจายลม	๗ มี.ค. ๒๕๔๕
air duct	ท่อลม	๗ มี.ค. ๒๕๔๕
air film	ฟิล์มอากาศ	๗ มี.ค. ๒๕๔๕
air filter	แผงกรองอากาศ	๗ มี.ค. ๒๕๔๕
air flow	การไหลของลม	๗ มี.ค. ๒๕๔๕
air handling equipment	เครื่องส่งลม	๗ มี.ค. ๒๕๔๕
air handling unit (AHU)	หน่วยเครื่องส่งลม (เอเอชยู)	๗ มี.ค. ๒๕๔๕
air intake	ช่องลมเข้า	๗ มี.ค. ๒๕๔๕
air stream	กระแสลม	๗ มี.ค. ๒๕๔๕
air terminal	หัวปรับจ่ายลม	๗ มี.ค. ๒๕๔๕
air tunnel	ช่องลมเยือกแข็ง	๗ มี.ค. ๒๕๔๕
air vent	ช่องอากาศ	๗ มี.ค. ๒๕๔๕
air motor	มอเตอร์ลม	๗ มี.ค. ๒๕๔๕
air released valve	วาล์วระบายอากาศ	๗ มี.ค. ๒๕๔๕
air volume control	การควบคุมปริมาณลม	๗ มี.ค. ๒๕๔๕
air washer	เครื่องล้างอากาศ	๗ มี.ค. ๒๕๔๕
air-operated	ทำงานด้วยลมอัด	๗ มี.ค. ๒๕๔๕
airfoil fan	พัดลมใบแพนอากาศ	๗ มี.ค. ๒๕๔๕
air-cooled condenser	เครื่องควบแน่นระบายความร้อนด้วยอากาศ	๗ มี.ค. ๒๕๔๕
air-cooled condensing unit	ชุดควบแน่นระบายความร้อนด้วยอากาศ	๗ มี.ค. ๒๕๔๕
เอชซีเอฟซี (ไฮโดรคอลโรฟลูออโรคาร์บอน)	HCFC (hydrochlorofluorocarbon)	๗ มี.ค. ๒๕๔๕
เอชซีเอฟซี-๒๒	HCFC-22	๗ มี.ค. ๒๕๔๕
เอชเอฟซี (ไฮโดรฟลูออโรคาร์บอน)	HFC (hydrofluorocarbon)	๗ มี.ค. ๒๕๔๕
เอชเอฟซี-๑๓๔เอ	HFC-134a	๗ มี.ค. ๒๕๔๕
โอทีทีวี (ค่าการถ่ายโอนความร้อนรวบยอด)	OTTV (overall thermal transfer value)	๗ มี.ค. ๒๕๔๕
มอนิเตอร์, เครื่องเฝ้าสังเกต; ตัวจอภาพ	monitor	๗ มี.ค. ๒๕๔๕
รอบต่อนาที (อาร์พีเอ็ม)	revolution per minute (rpm)	๗ มี.ค. ๒๕๔๕
algae	สาหร่าย	๗ มี.ค. ๒๕๔๕
algicide	สารฆ่าสาหร่าย	๗ มี.ค. ๒๕๔๕
alignment	การปรับแนว	๗ มี.ค. ๒๕๔๕
all-water air conditioning system; hydronic air conditioning system	ระบบปรับอากาศแบบน้ำล้วน	๗ มี.ค. ๒๕๔๕
all-air air conditioning system	ระบบปรับอากาศแบบลมล้วน	๗ มี.ค. ๒๕๔๕
altitude	ระดับความสูง	๗ มี.ค. ๒๕๔๕
ambient	โดยรอบ	๗ มี.ค. ๒๕๔๕
ambient conditions	ภาวะโดยรอบ	๗ มี.ค. ๒๕๔๕
ambient temperature	อุณหภุมิโดยรอบ	๗ มี.ค. ๒๕๔๕
analyser	เครื่องวิเคราะห์	๗ มี.ค. ๒๕๔๕
anemometer	มาตรความเร็วลม	๗ มี.ค. ๒๕๔๕
angle of incidence	มุมตกกระทบ	๗ มี.ค. ๒๕๔๕
ภาระเกิน	overload	๗ มี.ค. ๒๕๔๕
ภาระการทำความเย็น	cooling load	๗ มี.ค. ๒๕๔๕
ภาระของหอทำความเย็น	cooling tower loading	๗ มี.ค. ๒๕๔๕
รีเลย์	relay	๗ มี.ค. ๒๕๔๕
รีเลย์กันภาระเกิน	overload relay	๗ มี.ค. ๒๕๔๕
ภายนอกอาคาร	outdoor	๗ มี.ค. ๒๕๔๕
ภาวะมาตรฐาน	standard condition	๗ มี.ค. ๒๕๔๕
ภาวะโดยรอบ	ambient condition	๗ มี.ค. ๒๕๔๕
ภาวะออกแบบ	design conditions	๗ มี.ค. ๒๕๔๕
ภาวะสถานะคงตัว	steady state condition	๗ มี.ค. ๒๕๔๕
ภาวะค่าประเมินมาตรฐาน	standard rating conditions	๗ มี.ค. ๒๕๔๕
ภาวะทองแดงเคลือบ	copper plating	๗ มี.ค. ๒๕๔๕
ภาคตัดขวาง	cross section; x-section	๗ มี.ค. ๒๕๔๕
รางแผงกรองอากาศ	filter rack	๗ มี.ค. ๒๕๔๕
มาตรความหนาแน่นของเหลว	hydrometer	๗ มี.ค. ๒๕๔๕
มาตรความเร็วลม	anemometer	๗ มี.ค. ๒๕๔๕
มาตรความเร็วลม	veloveter	๗ มี.ค. ๒๕๔๕
มาตรความเร็วลมแบบพิโทต์ทิวบ์	pitot tube anemometer	๗ มี.ค. ๒๕๔๕
มาตรความชื้นสัมพัทธ์	hygrometer	๗ มี.ค. ๒๕๔๕
มาตรความชื้นสัมพัทธ์แบบกระเปาะเปียก-แห้ง, ไซโครมิเตอร์	psychrometer	๗ มี.ค. ๒๕๔๕
มาตรฐานสิ่งแวดล้อม	environmental standards	๗ มี.ค. ๒๕๔๕
มาตรปริมาณความร้อน, แคลอริมิเตอร์	calorimeter	๗ มี.ค. ๒๕๔๕
appliances heat	ความร้อนของเครื่องใช้	๗ มี.ค. ๒๕๔๕
application rating	ค่าประเมินใช้งานจริง	๗ มี.ค. ๒๕๔๕
approach	อุณหภูมิแอปโพรช	๗ มี.ค. ๒๕๔๕
appratus dew point	จุดน้ำค้าอุปกรณ์	๗ มี.ค. ๒๕๔๕
aspect ration	๑. อัตราส่วนขนาดท่อลม๒. อัตราส่วนยาวต่อกว้าง	๗ มี.ค. ๒๕๔๕
assembly	ชุดชิ้ส่วน, ชุดรวม	๗ มี.ค. ๒๕๔๕
atmospheric pressure	ความดันบรรยากาศ	๗ มี.ค. ๒๕๔๕
atomisation; atomization	การทำละออง	๗ มี.ค. ๒๕๔๕
atomization; atomisation	การทำละออง	๗ มี.ค. ๒๕๔๕
atmospheric cooling tower	หอทำความเย็นด้วยบรรยากาศ มีความหมายเหมือนกับ natural-draft cooling tower	๗ มี.ค. ๒๕๔๕
attenuator; sound attenuator	กล่องลดเสียง	๗ มี.ค. ๒๕๔๕
รูระบายอากาศของคอยล์	coil vent	๗ มี.ค. ๒๕๔๕
automatic expansion valve	วาล์วระเหยสารทำความเย็นอัตโนมัติ	๗ มี.ค. ๒๕๔๕
automatic damper	ชุดแผ่นปรับลมอัตโนมัติ	๗ มี.ค. ๒๕๔๕
automatic defrost	การละลายน้ำแข็งอัตโนมัติ	๗ มี.ค. ๒๕๔๕
available pressure	ความดันใช้ได้	๗ มี.ค. ๒๕๔๕
axial flow fan	พัดลมตามแนวแกน	๗ มี.ค. ๒๕๔๕
โลหะดามท่อลม	duct stiffener	๗ มี.ค. ๒๕๔๕
แก๊สร้อนยวดยิ่ง	superheated gas	๗ มี.ค. ๒๕๔๕
แก๊สเฉื่อย	inert gas	๗ มี.ค. ๒๕๔๕
แก๊สไม่ควบแน่น	foul gas; noncondensable gas	๗ มี.ค. ๒๕๔๕
แก๊สไหลกลับ	return gas	๗ มี.ค. ๒๕๔๕
แก๊สทำความเย็น	refrigerant gas	๗ มี.ค. ๒๕๔๕
เกล็ดช่องลม	louver	๗ มี.ค. ๒๕๔๕
เกล็ดน้ำแข็งเกาะท่อดูด	frost back	๗ มี.ค. ๒๕๔๕
เขตสบาย	comfort zone	๗ มี.ค. ๒๕๔๕
เขตก่อเกิดผลึกสูงสุด	zone of macimum crystal formation	๗ มี.ค. ๒๕๔๕
เครื่องระเหย	evaporator	๗ มี.ค. ๒๕๔๕
เครื่อควบแน่นแบบระเหย	evaporative condenser	๗ มี.ค. ๒๕๔๕
เครื่องระเหยแบบแห้ง	dry-type evaporator	๗ มี.ค. ๒๕๔๕
เครื่องระเหยแบบแช่สารทำความเย็น	flooded-type evaporator	๗ มี.ค. ๒๕๔๕
เครื่องระเหยสารทำความเย็นโดยตรง	direct expansion evaporator	๗ มี.ค. ๒๕๔๕
เครื่องแลกเปลี่ยนควมร้อนแบบหมุน	rotary heat exchanger	๗ มี.ค. ๒๕๔๕
เครื่องแลกเปลี่ยนความร้อน	heat exchanger	๗ มี.ค. ๒๕๔๕
เครื่องแลกเปลี่ยนความร้อน; เครื่องถ่ายโอนความร้อนระหว่างสารทำความเย็น	heat interchanger	๗ มี.ค. ๒๕๔๕
เครื่องแลกเปลี่ยนความร้อนแบบเปลือกและท่อ	shell and tube heat exchanger	๗ มี.ค. ๒๕๔๕
เครื่องแลกเปลี่ยนความร้อนแบบแผ่น	plate heat exchanger	๗ มี.ค. ๒๕๔๕
เครื่องเป่าลม	blower	๗ มี.ค. ๒๕๔๕
เครื่องเฝ้าสังเกต, มอนิเตอร์; ตัวจอภาพ	monitor	๗ มี.ค. ๒๕๔๕
เครื่องเพิ่มความชื้น	humidifier	๗ มี.ค. ๒๕๔๕
เครื่องวิเคราะห์	analyser	๗ มี.ค. ๒๕๔๕
เครื่องส่งลม	air handling equipment	๗ มี.ค. ๒๕๔๕
เครื่องอัดแก๊ส; คอมเพรสเซอร์, เครื่องอัดแก๊สทำความเย็น	compressor	๗ มี.ค. ๒๕๔๕
เครื่องอัดแก๊สทำความเย็น	refrigerant compressor	๗ มี.ค. ๒๕๔๕
เครื่องอัดแก๊สทำความเย็น, คอมเพรสเซอร์; เครื่องอัดแก๊ส	compressor	๗ มี.ค. ๒๕๔๕
เครื่องอัดแก๊สทำความเย็นแบบเกลียว, คอมเพรสเซอร์แบบเกลียว	screw compressor	๗ มี.ค. ๒๕๔๕
เครื่องอัดแก๊สทำความเย็นแบบก้นหอย, คอมเพรสเซอร์แบบก้นหอย	scrool compressor	๗ มี.ค. ๒๕๔๕
เครื่องอัดแก๊สทำความเย็นแบบทวิภาวะ, คอมเพรสเซอร์แบบทวิภาวะ	dual compression compressor	๗ มี.ค. ๒๕๔๕
เครื่องอัดแก๊สทำความเย็นแบบประกอบปิด, คอมเพรสเซอร์แบบประกอบปิด	semi-hermetic compressor	๗ มี.ค. ๒๕๔๕
เครื่องล้างอากาศ	air washer	๗ มี.ค. ๒๕๔๕
เครื่องอัดแก๊สทำความเย็นแบบเกลียวหมุน, คอมเพรสเซอ์แบบเกลียวหมุน	helical rotary compressor	๗ มี.ค. ๒๕๔๕
เครื่องอัดแก๊สทำความเย็นแบบเชื่อมปิด, คอมเพรสเซอร์แบบเชื่อมปิด	welded hermetic compressor	๗ มี.ค. ๒๕๔๕
เครื่องอัดแก๊สทำความเย็นแบบใบหมุน, คอมเพรสเซอร์แบบใบหมุน	vane rotary compressor	๗ มี.ค. ๒๕๔๕
เครื่องอัดแก๊สทำความเย็นแบบเปิด, คอมเพรสเซอร์แบบเปิด	open-type compressor	๗ มี.ค. ๒๕๔๕
เครื่องอัดแก๊สทำความเย็นแบบเปลี่ยนปริมาตร, คอมเพรสเซอร์แบบเปลี่ยนปริมาตร	positive displacement compressor	๗ มี.ค. ๒๕๔๕
เครื่องอัดแก๊สทำความเย็นแบบหมุน, คอมเพรสเซอร์แบบหมุน	rotary compressor	๗ มี.ค. ๒๕๔๕
เครื่องอัดแก๊สทำความเย็นแบบหมุนกวาด, คอมเพรสเซอร์แบบหมุนกวาด	swash plate rotary compressor	๗ มี.ค. ๒๕๔๕
เครื่องอัดแก๊สทำความเย็นแบบหอยโข่ง, คอมเพรสเซอร์แบบหอยโข่ง	centrifugal compressor	๗ มี.ค. ๒๕๔๕
เครื่องอัดแก๊สทำความเย็นแบบหุ้มปิด, คอมเพรสเซอร์แบบหุ้มปิด	hermetic compressor; sealed unit compressor	๗ มี.ค. ๒๕๔๕
เครื่องอัดแก๊สทำความเย็นแบบลูกสูบ, คอมเพรสเซอร์แบบลูกสูบ	reciprocating compressor	๗ มี.ค. ๒๕๔๕
เครื่องควบแน่นแบบเปลือกและท่อเปิด	oper-shell-and-tube condenser	๗ มี.ค. ๒๕๔๕
เครื่องควบแน่นแบบท่อสวมซ้อน	tube-in-tube condenser	๗ มี.ค. ๒๕๔๕
เครื่องควบแน่น, คอนเดนเซอร์	dondenser	๗ มี.ค. ๒๕๔๕
เครื่องควบแน่นระบายความร้อนด้วยอากาศ	air-cooled condenser	๗ มี.ค. ๒๕๔๕
เครื่องควบแน่นระบายความร้อนด้วยน้ำ	water-cooled condenser	๗ มี.ค. ๒๕๔๕
เครื่องควบแน่นแบบเปลือกและท่อ	shell-and-tube condenser	๗ มี.ค. ๒๕๔๕
เครื่องตรวจหารอยรั่ว	leak detector	๗ มี.ค. ๒๕๔๕
เครื่องถ่ายโอนความร้อนระหว่างสารทำความเย็น; เครื่องแลกเปลี่ยนความร้อน	heat interchanger	๗ มี.ค. ๒๕๔๕
เครื่องทำของเหลวเย็น	liquid chiller	๗ มี.ค. ๒๕๔๕
เครื่องทำของเหลวเย็นแบบเกลียว	screw chiller	๗ มี.ค. ๒๕๔๕
เครื่องทำของเหลวเย็นแบบหมุน	rotary chiller	๗ มี.ค. ๒๕๔๕
เครื่องทำของเหลวเย็นแบบลูกสูบ	reciprocating chiller	๗ มี.ค. ๒๕๔๕
เครื่องทำของเหลวแบบหอยโข่ง	centrifugal chiller	๗ มี.ค. ๒๕๔๕
เครื่องทำความเย็นแบบหอยโข่ง	centrifugal machine	๗ มี.ค. ๒๕๔๕
เครื่องทำความเย็นแบบดูดกลืน	absorption refrigerator	๗ มี.ค. ๒๕๔๕
เครื่องทำน้ำเย็น	water chiller	๗ มี.ค. ๒๕๔๕
เครื่องทำน้ำเย็นแบบดูดกลืน	absorption chiller	๗ มี.ค. ๒๕๔๕
เครื่องทำน้ำเกลือเย็น	brine chiller	๗ มี.ค. ๒๕๔๕
เครื่องทำน้ำแข็ง	ice chiller	๗ มี.ค. ๒๕๔๕
เครื่องทำน้ำอ่อนชนิดแลกเปลี่ยนไอออน	ion cxchange softener	๗ มี.ค. ๒๕๔๕
เครื่องปรับอากาศ	air conditioner; air conditioning unit	๗ มี.ค. ๒๕๔๕
เครื่องปรับอากาศรวมหน่วย	unitry air conditioner	๗ มี.ค. ๒๕๔๕
เครื่องปรับอากาศแบบแยกส่วน	split type air conditioner	๗ มี.ค. ๒๕๔๕
เครื่องปรับอากาศแบบรวมส่วน	packaged type air conditioner; self-contained air conditioner	๗ มี.ค. ๒๕๔๕
เครื่องปรับอากาศติดห้อง	room air conditioner	๗ มี.ค. ๒๕๔๕
เครื่องปรับอากาศติดบนหลังคา	rooftop air conditioner	๗ มี.ค. ๒๕๔๕
เครื่องฟอกอากาศ	air cleaner	๗ มี.ค. ๒๕๔๕
เครื่องฟอกความชื้น	humidifier	๗ มี.ค. ๒๕๔๕
แคลอริมิเตอร์, มาตรปริมาณความร้อน	calorimeter	๗ มี.ค. ๒๕๔๕
โดยรอบ	ambient	๗ มี.ค. ๒๕๔๕
เดซิเบล (ดีบี)	decible (dB)	๗ มี.ค. ๒๕๔๕
โต๊ะชุดควบคุม	control console	๗ มี.ค. ๒๕๔๕
แถบโลหะคู่ต่าง	bimetallic element	๗ มี.ค. ๒๕๔๕
เทอร์มอสแตตในห้อง	room thermostat	๗ มี.ค. ๒๕๔๕
เทอร์มอสแตตแบบสัดส่วน	proportional thermostat	๗ มี.ค. ๒๕๔๕
เทอร์มอสแตตแบบหางกระเปาะ	remote bulb thermostat	๗ มี.ค. ๒๕๔๕
เทอร์มอสแตตแบบกลางวัน-กลางคืน	day-night thermostat	๗ มี.ค. ๒๕๔๕
เทอร์มอสแตตแบบขีดจำกัด	limiting thermostat	๗ มี.ค. ๒๕๔๕
เทอร์มอสแตตแบบต่อเนื่อง	modulating thermostat	๗ มี.ค. ๒๕๔๕
เทอร์มอสแตตแบบทำงานโดยตรง	direct-acting thermostat	๗ มี.ค. ๒๕๔๕
เทอร์มอสแตตแบบทำงานผันกลับ	reverse-acting thermostat	๗ มี.ค. ๒๕๔๕
เทอร์มอสแตตละลายเกล็ดน้ำแข็ง	de-ice thermostat	๗ มี.ค. ๒๕๔๕
เทอร์มอสแตตละลายน้ำแข็ง	defrost thermostat	๗ มี.ค. ๒๕๔๕
เทอร์มอสแตตนอกอาคาร	outdoor thermostat	๗ มี.ค. ๒๕๔๕
เทอร์มอสแตตพัดลม	fan thermostat	๗ มี.ค. ๒๕๔๕
เทอร์มอสแตต	thermostat	๗ มี.ค. ๒๕๔๕
เนื้อเสียเหตุเย็นจัด	frostbite	๗ มี.ค. ๒๕๔๕
ใบนำร่องทางเข้า	inlet guide vane	๗ มี.ค. ๒๕๔๕
เปิดทิ้ง	blow down	๗ มี.ค. ๒๕๔๕
เปลือกอาคาร	building envelope	๗ มี.ค. ๒๕๔๕
เปลือกคอมเพรสเซอร์, เปลือกเครื่องอัดแก๊สทำความเย็น	compressor shell	๗ มี.ค. ๒๕๔๕
เปลือกพัดลม	fan housing	๗ มี.ค. ๒๕๔๕
แผ่นแบ่งช่องท่อเลี้ยว	elbow vanes	๗ มี.ค. ๒๕๔๕
แผ่นเบนทางลม	air deflector	๗ มี.ค. ๒๕๔๕
แผ่นไม้ก๊อก	corkboard	๗ มี.ค. ๒๕๔๕
แผ่นกรุ	fill	๗ มี.ค. ๒๕๔๕
แผ่นช่อง	orifice plate	๗ มี.ค. ๒๕๔๕
แผ่นกั้น	baffle	๗ มี.ค. ๒๕๔๕
แผ่นกั้นไอ	vapour barrier	๗ มี.ค. ๒๕๔๕
แผงเกล็ดกันน้ำปลิว	drift eliminator	๗ มี.ค. ๒๕๔๕
แผงไฟ	panel board	๗ มี.ค. ๒๕๔๕
แผงกรองอากาศ	air filter	๗ มี.ค. ๒๕๔๕
แผงควบคุม	control panel	๗ มี.ค. ๒๕๔๕
แผงน้ำแข็ง	ice blank	๗ มี.ค. ๒๕๔๕
แผนภาพไซโครเมตรี	psychrometric chart	๗ มี.ค. ๒๕๔๕
แผนภาพสัญลักษณ์	label diagram	๗ มี.ค. ๒๕๔๕
แผนภาพระบบไฟฟ้า	wiring diagram; wiring schematics	๗ มี.ค. ๒๕๔๕
แผนภูมิภาวะสบาย	comfort chart	๗ มี.ค. ๒๕๔๕
โพเทนชิออมิเตอร์	potentiometer	๗ มี.ค. ๒๕๔๕
เพลาสองข้าง	double shaft	๗ มี.ค. ๒๕๔๕
เพดานกล่องลม	plenum ceiling	๗ มี.ค. ๒๕๔๕
เฟส	phase	๗ มี.ค. ๒๕๔๕
แฟลชแก๊ส	flash gas	๗ มี.ค. ๒๕๔๕
แฟกเตอร์แสงอาทิตย์	solar factor	๗ มี.ค. ๒๕๔๕
แฟกเตอร์ภาระการทำความเย็น	cooling load factor	๗ มี.ค. ๒๕๔๕
แฟกเตอร์เลี่ยง (บีเอฟ)	bypass factor (BF)	๗ มี.ค. ๒๕๔๕
แฟกเตอร์สัมผัส (ซีเอฟ)	contact factor (CF)	๗ มี.ค. ๒๕๔๕
แฟกเตอร์ลมเลี่ยงผ่านคอยล์	coil bypass factor	๗ มี.ค. ๒๕๔๕
แฟกเตอร์ความสกปรกของผิว	fouling factor	๗ มี.ค. ๒๕๔๕
แฟกเตอร์ความปลอดภัย	safety factor	๗ มี.ค. ๒๕๔๕
มุมภาคทิศดวงอาทิตย์	solar azimuth; solar azimuth angle	๗ มี.ค. ๒๕๔๕
มุมภาคทิศดวงอาทิตย์ของผนัง	wall solar azimuth angle	๗ มี.ค. ๒๕๔๕
มุมแผ่กระจาย	spread	๗ มี.ค. ๒๕๔๕
มุมตกกระทบ	angle of incidence	๗ มี.ค. ๒๕๔๕
มุมทางสูงดวงอาทิตย์	solar altitude; solar altitude angle	๗ มี.ค. ๒๕๔๕
back pressure	ความดันต้านกลับ	๗ มี.ค. ๒๕๔๕
back pressure valve	วาล์วความดันต้านกลับ	๗ มี.ค. ๒๕๔๕
baffle	แผ่นกั้น	๗ มี.ค. ๒๕๔๕
backward-curved blade fan	พัดลมใบโค้งเอียงหลัง	๗ มี.ค. ๒๕๔๕
backward-inclined blade fan	พัดลมใบตรงเอียงหลัง	๗ มี.ค. ๒๕๔๕
balance pressure	ความดันดุล	๗ มี.ค. ๒๕๔๕
balancing	การปรับดุล	๗ มี.ค. ๒๕๔๕
bar grille	ช่องลมแบบเกล็ด	๗ มี.ค. ๒๕๔๕
base pan	ถาดส่วนฐาน, ถาดล่าง	๗ มี.ค. ๒๕๔๕
bellows seal	กันรั่วแบบจีบ	๗ มี.ค. ๒๕๔๕
BF (bypass factor)	บีเอฟ (แฟกเตอร์เลี่ยง)	๗ มี.ค. ๒๕๔๕
bimetallic element	แถบโลหะคู่ต่าง	๗ มี.ค. ๒๕๔๕
bleed off	ผ่อนทิ้ง	๗ มี.ค. ๒๕๔๕
bleeder	ท่อแยกขนาน	๗ มี.ค. ๒๕๔๕
blow down	เปิดทิ้ง	๗ มี.ค. ๒๕๔๕
blower	เครื่องเป่าลม	๗ มี.ค. ๒๕๔๕
blower wheel	ล้อเครื่องเป่าลม	๗ มี.ค. ๒๕๔๕
booster fan; turbo fan	พัดลมเสริมกำลัง	๗ มี.ค. ๒๕๔๕
branch duct	ท่อแยก	๗ มี.ค. ๒๕๔๕
brazed joint	รอยต่อเชื่อมประสาน	๗ มี.ค. ๒๕๔๕
brazing	การแล่นประสาน	๗ มี.ค. ๒๕๔๕
brine	น้ำเกลือ	๗ มี.ค. ๒๕๔๕
brine chiller	เครื่องทำน้ำเกลือเย็น	๗ มี.ค. ๒๕๔๕
brine cooler	ชุดทำน้ำเกลือเย็น	๗ มี.ค. ๒๕๔๕
British Thermal Unit (Btu)	หน่วยความร้อนระบบอังกฤษ (บีทียู)	๗ มี.ค. ๒๕๔๕
building envelope	เปลือกอาคาร	๗ มี.ค. ๒๕๔๕
building orientation	ทิศอาคาร	๗ มี.ค. ๒๕๔๕
bypass	ทางเลี่ยง	๗ มี.ค. ๒๕๔๕
bypass air	ลมเลี่ยง	๗ มี.ค. ๒๕๔๕
bypass factor (BF)	แฟกเตอร์เลี่ยง (บีเอฟ)	๗ มี.ค. ๒๕๔๕
bypass timer	อุปกรณ์จับเวลาเลี่ยง	๗ มี.ค. ๒๕๔๕
cabinet	ตู้ มีความหมายเหมือนกับ casing ๑	๗ มี.ค. ๒๕๔๕
calibrated circuit breaker	ตัวตัดวงจรปรับพิกัดแล้ว	๗ มี.ค. ๒๕๔๕
calibration	การเทียบมาตรฐาน	๗ มี.ค. ๒๕๔๕
calorimeter	มาตรปริมาณความร้อน, แคลอริมิเตอร์	๗ มี.ค. ๒๕๔๕
calorimeter room	ห้องวัดปริมาณความร้อน	๗ มี.ค. ๒๕๔๕
capacitor	ตัวเก็บประจุ	๗ มี.ค. ๒๕๔๕
capacity rating	ค่าประเมินวิสัยสามารถ มีความหมายเหมือนกับ rated capacity	๗ มี.ค. ๒๕๔๕
capacity reducer	อุปกรณ์ลดวิสัยสามารถ	๗ มี.ค. ๒๕๔๕
capacity step	ระดับวิสัยสามารถ	๗ มี.ค. ๒๕๔๕
capacity	วิสัยสามารถ	๗ มี.ค. ๒๕๔๕
capacity control	การควบคุมวิสัยสามารถ	๗ มี.ค. ๒๕๔๕
capillary tube	หลอดรูเล็ก	๗ มี.ค. ๒๕๔๕
casing	๑. ตู้๒. ตัวเรือน	๗ มี.ค. ๒๕๔๕
CAV system; constant air volume system	ระบบซีเอวี, ระบบลมจ่ายคงที่ 	๗ มี.ค. ๒๕๔๕
cavitation	การเกิดโพรง (ในของเหลว)	๗ มี.ค. ๒๕๔๕
ceiling diffuser	หัวจ่ายลมฝ้าเพดาน	๗ มี.ค. ๒๕๔๕
ceiling mounted	-ติดเพดาน	๗ มี.ค. ๒๕๔๕
ceiling outlet	ช่องจ่ายลมฝ้าเพดาน	๗ มี.ค. ๒๕๔๕
central fan system	ระบบพัดลมส่วนกลาง	๗ มี.ค. ๒๕๔๕
central plant system	ระบบทำความเย็นส่วนกลาง มีความหมายเหมือนกับ multiple refrigeration system	๗ มี.ค. ๒๕๔๕
centrifugal chiller	เครื่องทำของเหลวเย็นแบบหอยโข่ง	๗ มี.ค. ๒๕๔๕
centrifugal compressor	เครื่องอัดแก๊สทำความเย็นแบบหอยโข่ง, คอมเพรสเซอร์แบบหอยโข่ง	๗ มี.ค. ๒๕๔๕
centrifugal fan	พัดลมหอยโข่ง	๗ มี.ค. ๒๕๔๕
centrifugal machine	เครื่องทำความเย็นแบบหอยโข่ง	๗ มี.ค. ๒๕๔๕
centrifugal pump	ปั๊มหอยโข่ง	๗ มี.ค. ๒๕๔๕
CF (contact factor)	ซีเอฟ (แฟกเตอร์สัมผัส)	๗ มี.ค. ๒๕๔๕
CFC (chlorofluorocarbon)	ซีเอฟซี (คลอโรฟลูออโรคาร์บอน)	๗ มี.ค. ๒๕๔๕
CFC refrigerant	สารทำความเย็นซีเอฟซี	๗ มี.ค. ๒๕๔๕
characteristic	ลักษณะเฉพาะ	๗ มี.ค. ๒๕๔๕
charging	การประจุ	๗ มี.ค. ๒๕๔๕
charging valve	วาล์วประจุ (สารทำความเย็น)	๗ มี.ค. ๒๕๔๕
check valve	วาล์วกันย้อน	๗ มี.ค. ๒๕๔๕
chilled water coil	คอยล์น้ำเย็น	๗ มี.ค. ๒๕๔๕
chilled water storage system	ระบบสะสมน้ำเย็น	๗ มี.ค. ๒๕๔๕
chimney effect; stack effect	ปรากฏการณ์ลมลอยตัว	๗ มี.ค. ๒๕๔๕
chlorofluorocarbon (CFC)	คลอโรฟลูออโรคาร์บอน (ซีเอฟซี)	๗ มี.ค. ๒๕๔๕
circuit breaker	ตัวตัดวงจร	๗ มี.ค. ๒๕๔๕
circuit	วงจร	๗ มี.ค. ๒๕๔๕
circulating air	ลมหมุนเวียน	๗ มี.ค. ๒๕๔๕
circulating water	น้ำหมุนเวียน	๗ มี.ค. ๒๕๔๕
clamp	ข้อรัด	๗ มี.ค. ๒๕๔๕
clearance volume	ช่องห่าง	๗ มี.ค. ๒๕๔๕
closed cycle	วัฏจักรปิด	๗ มี.ค. ๒๕๔๕
วัสดุอัด	packing	๗ มี.ค. ๒๕๔๕
วัฏจักรทำความเย็น	refrigerating cycle	๗ มี.ค. ๒๕๔๕
วัฏจักรปิด	closed cycle	๗ มี.ค. ๒๕๔๕
วัฏจักรละลายน้ำแข็ง	defrosting cycle	๗ มี.ค. ๒๕๔๕
วัฏจักรความเข้มข้น	cycles of concentration	๗ มี.ค. ๒๕๔๕
วัฏจักรผันกลับ	reversible cycle	๗ มี.ค. ๒๕๔๕
code	รหัส	๗ มี.ค. ๒๕๔๕
วิศวกรรมทำความเย็น	refrigerating engineering	๗ มี.ค. ๒๕๔๕
วิศวกรรมสิ่งแวดล้อม	environmental engineering	๗ มี.ค. ๒๕๔๕
coefficient of performance of heat pump (COP)	สัมประสิทธิ์สมรรถนะฮีตปั๊ม (ซีโอพี)	๗ มี.ค. ๒๕๔๕
coefficient of performance of refrigeration (COP)	สัมประสิทธิ์สมรรถนะทำความเย็น (ซีโอพี)	๗ มี.ค. ๒๕๔๕
วิสัยสมารถของวาล์วระเหยสารทำความเย็น	expansion valve capacity	๗ มี.ค. ๒๕๔๕
วิสัยสามารถ	capacity	๗ มี.ค. ๒๕๔๕
วิสัยสามารถกักฝุ่นผง	dust-holding capacity	๗ มี.ค. ๒๕๔๕
วิสัยสามารถทำให็เย็น	cooling capacity	๗ มี.ค. ๒๕๔๕
วิสัยสามารถทำความเย็น	refrigerating capacity	๗ มี.ค. ๒๕๔๕
วิสัยสามารถประเมิน	rated capacity	๗ มี.ค. ๒๕๔๕
coil bypass factor	แฟกเตอร์ลมเลี่ยงผ่านคอยล์	๗ มี.ค. ๒๕๔๕
coil circuiting	การจัดวงจรในคอยล์	๗ มี.ค. ๒๕๔๕
coil depth	ความลึกคอยล์	๗ มี.ค. ๒๕๔๕
coil face area; face area of coil	พื้นที่หน้าคอยล์	๗ มี.ค. ๒๕๔๕
coil height	ความสูงคอยล์	๗ มี.ค. ๒๕๔๕
coil performance	สมรรถนะคอยล์	๗ มี.ค. ๒๕๔๕
coil surface area	พื้นที่ผิวคอยล์	๗ มี.ค. ๒๕๔๕
coil	๑. คอยล์, ท่อขอ๒. ขดลวด	๗ มี.ค. ๒๕๔๕
coil vent	รูระบายอากาศของคอยล์	๗ มี.ค. ๒๕๔๕
cold storage	๑. การเก็บเย็น๒. ห้องเย็น	๗ มี.ค. ๒๕๔๕
comfort air conditioning	การปรับอากาศเพื่อความสบาย มีความหมายเหมือนกับ comfort cooling	๗ มี.ค. ๒๕๔๕
comfort chart	แผนภูมิภาวะสบาย	๗ มี.ค. ๒๕๔๕
comfort cooling	การทำความเย็นสบาย	๗ มี.ค. ๒๕๔๕
comfort line	เส้นภาวะสบาย	๗ มี.ค. ๒๕๔๕
comfort zone	เขตสบาย	๗ มี.ค. ๒๕๔๕
commercial refrigeration system	ระบบทำความเย็นเชิงพาณิชย์	๗ มี.ค. ๒๕๔๕
commercial refrigerator	ตู้เย็นเชิงพาณิชย์	๗ มี.ค. ๒๕๔๕
compartment	ส่วนกั้นแยก	๗ มี.ค. ๒๕๔๕
component	ส่วนประกอบ	๗ มี.ค. ๒๕๔๕
compression	การอัด	๗ มี.ค. ๒๕๔๕
compression efficiency	ประสิทธิภาพการอัด	๗ มี.ค. ๒๕๔๕
compression equipment	อุปกรณ์การอัด	๗ มี.ค. ๒๕๔๕
compound compression	การอัดประกอบ	๗ มี.ค. ๒๕๔๕
compression ratio; ratio of compression	อัตราส่วนการอัด	๗ มี.ค. ๒๕๔๕
compressor	๑. เครื่องอัดแก๊ส๒. เครื่องอัดแก๊สทำความเย็น, คอมเพรสเซอร์ มีความหมายเหมือนกับ refrigerant compressor	๗ มี.ค. ๒๕๔๕
compressor refrigerating effect	ผลทำความเย็นของเครื่องอัดแก๊สทำความเย็น, ผลทำความเย็นของคอมเพรสเซอร์	๗ มี.ค. ๒๕๔๕
compressor shell	เปลือกเครื่องอัดแก๊สทำความเย็น, เปลือกคอมเพรสเซอร์	๗ มี.ค. ๒๕๔๕
compressor unit	๑. ชุดอัดแก๊ส๒. ชุดอัดแก๊สทำความเย็น, ชุดคอมเพรสเซอร์	๗ มี.ค. ๒๕๔๕
compression system	ระบบการอัด	๗ มี.ค. ๒๕๔๕
compression tank	ถังอัด	๗ มี.ค. ๒๕๔๕
concentric reducer	ข้อลดแบบร่วมศูนย์กลาง	๗ มี.ค. ๒๕๔๕
condenser	เครื่องควบแน่น, คอนเดนเซอร์	๗ มี.ค. ๒๕๔๕
condenser water; cooling water	น้ำหล่อเย็น	๗ มี.ค. ๒๕๔๕
condensing pressure	ความดันเครื่องควบแน่น	๗ มี.ค. ๒๕๔๕
condensing temperature	อุณหภูมิควบแน่น	๗ มี.ค. ๒๕๔๕
condensing unit	ชุดควบแน่น	๗ มี.ค. ๒๕๔๕
condensing unit refrigerating effect	ผลทำความเย็นของชุดควบแน่น	๗ มี.ค. ๒๕๔๕
condensate	ของเหลวผลควบแน่น	๗ มี.ค. ๒๕๔๕
condensate pan; drain pan	ถาดรับน้ำทิ้ง	๗ มี.ค. ๒๕๔๕
condensation	การควบแน่น	๗ มี.ค. ๒๕๔๕
conditioned air	อากาศปรับภาวะ	๗ มี.ค. ๒๕๔๕
conduit	๑. ท่อร้อยสาย๒. ท่อส่งของไหล	๗ มี.ค. ๒๕๔๕
connecting rod	ก้านสูบ	๗ มี.ค. ๒๕๔๕
constant air volume system; CAV system	ระบบลมจ่ายคงที่, ระบบซีเอวี	๗ มี.ค. ๒๕๔๕
contact factor (CF)	แฟกเตอร์สัมผัส (ซีเอฟ)	๗ มี.ค. ๒๕๔๕
control	การควบคุม	๗ มี.ค. ๒๕๔๕
control box	กล่องควบคุม	๗ มี.ค. ๒๕๔๕
control centre	ศูนย์ควบคุม	๗ มี.ค. ๒๕๔๕
control console	โต๊ะชุดควบคุม	๗ มี.ค. ๒๕๔๕
control panel	แผงควบคุม	๗ มี.ค. ๒๕๔๕
controller	ตัวควบคุม	๗ มี.ค. ๒๕๔๕
coolant	ตัวทำให้เย็น	๗ มี.ค. ๒๕๔๕
cooler	ชุดทำให้เย็น	๗ มี.ค. ๒๕๔๕
cooler refrigerating effect	ผลทำความเย็นของชุดทำให้เย็น มีความหมายเหมือนกับ system refrigerating effect	๗ มี.ค. ๒๕๔๕
cooling capacity	วิสัยสามารถทำให้เย็น	๗ มี.ค. ๒๕๔๕
cooling coil	คอยล์ทำความเย็น	๗ มี.ค. ๒๕๔๕
cooling element	ผิวทำความเย็น	๗ มี.ค. ๒๕๔๕
cooling load	ภาระการทำความเย็น	๗ มี.ค. ๒๕๔๕
cooling load factor	แฟกเตอร์ภาระการทำความเย็น	๗ มี.ค. ๒๕๔๕
cooling medium	ตัวกลางทำความเย็น	๗ มี.ค. ๒๕๔๕
cooling range	ช่วงทำความเย็น	๗ มี.ค. ๒๕๔๕
COPh (coefficient of performance of heat pump)	ซีโอพี (สัมประสิทธิ์สมรรถนะฮีตปั๊ม)	๗ มี.ค. ๒๕๔๕
copper plating	ภาวะทองแดงเคลือบ	๗ มี.ค. ๒๕๔๕
COPc (coefficient of performance of refrigeration)	ซีโอพี (สัมประสิทธิ์สมรรถนะการทำความเย็น)	๗ มี.ค. ๒๕๔๕
cooling tower	หอทำความเย็น บางครั้งเรียก water-cooling tower	๗ มี.ค. ๒๕๔๕
cooling tower loading	ภาระของหอทำความเย็น	๗ มี.ค. ๒๕๔๕
cooling water; condenser water	น้ำหล่อเย็น	๗ มี.ค. ๒๕๔๕
corkboard	แผ่นไม้ก๊อก	๗ มี.ค. ๒๕๔๕
core area	พื้นที่ท่อสวมต่อ	๗ มี.ค. ๒๕๔๕
corrosion	การกัดกร่อน	๗ มี.ค. ๒๕๔๕
corrosive	-กัดกร่อน	๗ มี.ค. ๒๕๔๕
counterflow	การไหลสวนทาง	๗ มี.ค. ๒๕๔๕
วาล์ระเหยสารทำความเย็นปรับด้วยมือ	hand expansion valve	๗ มี.ค. ๒๕๔๕
วาล์วระเหยสารทำความเย็น	expansion valve	๗ มี.ค. ๒๕๔๕
วาล์วระเหยสารทำความเย็นแบบทำงานด้วยอุณหภูมิ	thermostatic expansion valve	๗ มี.ค. ๒๕๔๕
วาล์วระเหยสารทำความเย็นอัตโนมัติ	automatic expansion valve	๗ มี.ค. ๒๕๔๕
วาล์วระบายอากาศ	air released valve	๗ มี.ค. ๒๕๔๕
วาล์วโซเลนอยด์	solenoid valve	๗ มี.ค. ๒๕๔๕
วาล์วแบบต่อเนื่อง	modulating valve	๗ มี.ค. ๒๕๔๕
วาล์วลูกลอย	float valve	๗ มี.ค. ๒๕๔๕
วาล์วลูกลอยด้านความดันต่ำ	low-side float valve	๗ มี.ค. ๒๕๔๕
วาล์วลดความดัน	pressure reducing valve	๗ มี.ค. ๒๕๔๕
วาล์วไร้วัสดุอัด	packless valve	๗ มี.ค. ๒๕๔๕
วาล์วไล่แก๊ส	purge valve	๗ มี.ค. ๒๕๔๕
วาล์วไดอะแพรมแบบทำงานโดยตรง	direct-acting diaphragm valve	๗ มี.ค. ๒๕๔๕
วาล์วไดอะแฟรม	diaphramgm valve	๗ มี.ค. ๒๕๔๕
วาล์วไดอะแฟรมแบบทำงานผันกลับ	reverse-acting diaphragm valve	๗ มี.ค. ๒๕๔๕
วาล์วกันย้อน	check valve	๗ มี.ค. ๒๕๔๕
วาล์วขับด้วยมอเตอร์	motorised valve	๗ มี.ค. ๒๕๔๕
วาล์วความร้อน	thermal valve	๗ มี.ค. ๒๕๔๕
วาล์วความดันต้านกลับ	back pressure valve	๗ มี.ค. ๒๕๔๕
วาล์วควบคุมน้ำ	water regulator valve	๗ มี.ค. ๒๕๔๕
วาล์วด้านจ่าย	discharge valve	๗ มี.ค. ๒๕๔๕
วาล์วด้านดูด	suction valve	๗ มี.ค. ๒๕๔๕
วาล์วนิรภัย	safety valve	๗ มี.ค. ๒๕๔๕
วาล์วบริการ	service valve	๗ มี.ค. ๒๕๔๕
วาล์วประจุ (สารทำความเย็น)	charging valve	๗ มี.ค. ๒๕๔๕
วาล์วปิดเปิด	stop valve	๗ มี.ค. ๒๕๔๕
วิชาการทำความเย็น; การทำความเย็น	refrigeration	๗ มี.ค. ๒๕๔๕
crankcase heater	อุปกรณ์อุ่นน้ำมันหล่อลื่น	๗ มี.ค. ๒๕๔๕
crankcase	ห้องข้อเหวี่ยง	๗ มี.ค. ๒๕๔๕
critical pressure	ความดันวิกฤต	๗ มี.ค. ๒๕๔๕
critical temperature	อุณหภูมิวิกฤต	๗ มี.ค. ๒๕๔๕
critical velocity	ความเร็ววิกฤต	๗ มี.ค. ๒๕๔๕
cross broken	-พับไขว้ทแยงมุม	๗ มี.ค. ๒๕๔๕
cross connection	การต่อข้าม	๗ มี.ค. ๒๕๔๕
cross section; x-section	ภาคตัดขวาง	๗ มี.ค. ๒๕๔๕
cross-flow	การไหลข้ามข้าง	๗ มี.ค. ๒๕๔๕
cryogenics	อติสีตศาสตร์	๗ มี.ค. ๒๕๔๕
cryohydrate	ไครโอไฮเดรต	๗ มี.ค. ๒๕๔๕
cycles of concentration	วัฏจักรความเข้มข้น	๗ มี.ค. ๒๕๔๕
cycling	การทำงานเป็นรอบ	๗ มี.ค. ๒๕๔๕
วงจร	circuit	๗ มี.ค. ๒๕๔๕
วงจรทำความเย็น	refrigerating circuit	๗ มี.ค. ๒๕๔๕
Dalton’s law of partial pressure	กฎความดันย่อยของดอลตัน	๗ มี.ค. ๒๕๔๕
damper	ชุดแผ่นปรับลม	๗ มี.ค. ๒๕๔๕
damper motor	มอเตอร์ชุดแผ่นปรับลม	๗ มี.ค. ๒๕๔๕
day-night thermostat	เทอร์มอสแตตแบบกลางวัน-กลางคืน	๗ มี.ค. ๒๕๔๕
dB (decible)	ดีบี (เดซิเบล)	๗ มี.ค. ๒๕๔๕
de-ice thermostat	เทอร์มอสแตตละลายเกล็ดน้ำแข็ง	๗ มี.ค. ๒๕๔๕
decible (dB)	เดซิเบล (ดีบี)	๗ มี.ค. ๒๕๔๕
declination of sun	การบ่ายเบนของดวงอาทิตย์	๗ มี.ค. ๒๕๔๕
defrost thermostat	เทอร์มอสแตตละลายน้ำแข็ง	๗ มี.ค. ๒๕๔๕
defrost timer	อุปกรณ์จับเวลาละลายน้ำแข็ง	๗ มี.ค. ๒๕๔๕
defrosting cycle	วัฏจักรละลายน้ำแข็ง	๗ มี.ค. ๒๕๔๕
degree of saturation	ระดับขั้นการอิ่มตัว มีความหมายเหมือนกับ percentage humidity และ saturation ratio	๗ มี.ค. ๒๕๔๕
degree of subcool	องศาเย็นยิ่ง	๗ มี.ค. ๒๕๔๕
degree of superheat	องศาร้อนยวดยิ่ง	๗ มี.ค. ๒๕๔๕
dehumidification	การลดความชื้น	๗ มี.ค. ๒๕๔๕
dehumidified air	อากาศปรับลดความชื้น	๗ มี.ค. ๒๕๔๕
dehumidifier	อุปกรณ์ลดความชื้น	๗ มี.ค. ๒๕๔๕
dehumidifying effect	ผลลดความชื้น	๗ มี.ค. ๒๕๔๕
dehydration	การขจัดน้ำ	๗ มี.ค. ๒๕๔๕
demand charge	ค่าอุปสงค์	๗ มี.ค. ๒๕๔๕
derivative action	การกระทำแบบอนุพันธ์ มีความหมายเหมือนกับ derivative control	๗ มี.ค. ๒๕๔๕
derivative control	การควบคุมแบบอนุพันธ์	๗ มี.ค. ๒๕๔๕
descaling	การขจัดตะกรัน	๗ มี.ค. ๒๕๔๕
design working pressure	ความดันกำหนดใช้งาน	๗ มี.ค. ๒๕๔๕
desiccant	สารดูดความชื้น	๗ มี.ค. ๒๕๔๕
desiccation	การดูดความชื้น	๗ มี.ค. ๒๕๔๕
design conditions	ภาวะออกแบบ	๗ มี.ค. ๒๕๔๕
developed pressure	ความดันวัดได้	๗ มี.ค. ๒๕๔๕
dew point	จุดน้ำค้าง มีความหมายเหมือนกับ dew-point temperature	๗ มี.ค. ๒๕๔๕
dew-point rise	การเพิ่มจุดน้ำค้าง	๗ มี.ค. ๒๕๔๕
dew-point temperature	อุณหภูมิจุดน้ำค้าง	๗ มี.ค. ๒๕๔๕
diaphragm valve	วาล์วไดอะแฟรม	๗ มี.ค. ๒๕๔๕
differential	ค่าส่วนต่าง	๗ มี.ค. ๒๕๔๕
differential pressure	ความดันส่วนต่าง	๗ มี.ค. ๒๕๔๕
differential pressure sensor	ตัวรับรู้ความดันส่วนต่าง	๗ มี.ค. ๒๕๔๕
diffusion temperature difference	ผลต่างอุณหภูมิแพร่	๗ มี.ค. ๒๕๔๕
digital control	การควบคุมเชิงดิจิทัล	๗ มี.ค. ๒๕๔๕
direct connected	-ต่อตรง มีความหมายเหมือนกับ direct drive	๗ มี.ค. ๒๕๔๕
direct drive	การขับตรง	๗ มี.ค. ๒๕๔๕
direct expansion	การระเหยสารทำความเย็นโดยตรง	๗ มี.ค. ๒๕๔๕
direct expansion coil	คอยล์ระเหยสารทำความเย็นโดยตรง	๗ มี.ค. ๒๕๔๕
direct expansion evaporator	เครื่องระเหยสารทำความเย็นโดยตรง	๗ มี.ค. ๒๕๔๕
direct expansion system	ระบบระเหยสารทำความเย็นโดยตรง	๗ มี.ค. ๒๕๔๕
direct- online starter	สตาร์ตเตอร์แบบต่อตรง	๗ มี.ค. ๒๕๔๕
direct-acting diaphragm valve	วาล์วไดอะแฟรมแบบทำงานโดยตรง	๗ มี.ค. ๒๕๔๕
direct-acting thermostat	เทอร์มอสแตตแบบทำงานโดยตรง	๗ มี.ค. ๒๕๔๕
discharge valve	วาล์วด้านจ่าย	๗ มี.ค. ๒๕๔๕
discharge air	ลมปล่อย	๗ มี.ค. ๒๕๔๕
discharge line	ท่อส่งออก	๗ มี.ค. ๒๕๔๕
discharge plenum	กล่องจ่ายลม	๗ มี.ค. ๒๕๔๕
discharge pressure	ความดันด้านจ่าย มีความหมายเหมือนกับ outlet pressure	๗ มี.ค. ๒๕๔๕
discharge temperature	อุณหภูมิทางออก	๗ มี.ค. ๒๕๔๕
discharge tube; hot gas line	ท่อแก๊สร้อน	๗ มี.ค. ๒๕๔๕
distributor; liquid distributor	หัวกระจายของเหลว	๗ มี.ค. ๒๕๔๕
domestic refrigerator; household refrigerator	ตู้เย็นในบ้าน	๗ มี.ค. ๒๕๔๕
double discharge riser	ท่อคู่ตั้งจ่าย	๗ มี.ค. ๒๕๔๕
double shaft	เพลาสองข้าง	๗ มี.ค. ๒๕๔๕
double suction riser	ท่อคู่ตั้งดูด	๗ มี.ค. ๒๕๔๕
double glazing wall	ผนังกระจกสองชั้น	๗ มี.ค. ๒๕๔๕
draft	ลมดูด, ลมเป่า	๗ มี.ค. ๒๕๔๕
drier	อุปกรณ์ดูดซับความชื้น	๗ มี.ค. ๒๕๔๕
drift	น้ำปลิว	๗ มี.ค. ๒๕๔๕
drift eliminator	แผงเกล็ดกันน้ำปลิว	๗ มี.ค. ๒๕๔๕
drain	ท่อระบายทิ้ง	๗ มี.ค. ๒๕๔๕
drain pan; condensate pan	ถาดรับน้ำทิ้ง	๗ มี.ค. ๒๕๔๕
drip	๑. ท่อไอกลั่นตัว๒. ชุดตัวดักไอน้ำพร้อมท่อ๓. หยดน้ำ	๗ มี.ค. ๒๕๔๕
drive	ชุดขับ	๗ มี.ค. ๒๕๔๕
drop	ระยะตก (ของลม)	๗ มี.ค. ๒๕๔๕
dry air	อากาศแห้ง	๗ มี.ค. ๒๕๔๕
dry coil	คอลย์แห้ง	๗ มี.ค. ๒๕๔๕
dry expansion	การระเหยสารทำความเย็นหมดพอดี	๗ มี.ค. ๒๕๔๕
dry weight	น้ำหนักเครื่อง	๗ มี.ค. ๒๕๔๕
dry-bulb temperature	อุณหภูมิกระเปาะแห้ง	๗ มี.ค. ๒๕๔๕
dry-type evaporator	เครื่องระเหยแบบแห้ง	๗ มี.ค. ๒๕๔๕
dual compression compressor	เครื่องอัดแก๊สทำความเย็นแบบทวิภาวะ, คอมเพรสเซอร์แบบทวิภาระ	๗ มี.ค. ๒๕๔๕
dual effect control	การควบคุมทวิภาวะ	๗ มี.ค. ๒๕๔๕
duct riser	ท่อลมแนวตั้ง	๗ มี.ค. ๒๕๔๕
duct shaft	ช่องท่อลม	๗ มี.ค. ๒๕๔๕
duct stiffener	โลหะดามท่อลม	๗ มี.ค. ๒๕๔๕
duct system	ระบบท่อลม	๗ มี.ค. ๒๕๔๕
duct take-off	ท่อลมแยก	๗ มี.ค. ๒๕๔๕
duct transformer	ท่อนท่อลมแปลงรูป	๗ มี.ค. ๒๕๔๕
ductwork	งานท่อลม	๗ มี.ค. ๒๕๔๕
dust	ฝุ่นผง	๗ มี.ค. ๒๕๔๕
dust-holding capacity	วิสัยสามารถกักฝุ่นผง	๗ มี.ค. ๒๕๔๕
dynamic head	ลำความดันพลวัต มีความหมายเหมือนกับ total head	๗ มี.ค. ๒๕๔๕
สมรรถนะ	performance	๗ มี.ค. ๒๕๔๕
สมรรถนะคอยล์	coil performance	๗ มี.ค. ๒๕๔๕
สมรรถนะพัดลม	fan performance	๗ มี.ค. ๒๕๔๕
หม้อลดจังหวะความดัน	surge drum	๗ มี.ค. ๒๕๔๕
สภาพเปล่งรังสี	emissivity	๗ มี.ค. ๒๕๔๕
สภาพสะท้อน	reflectivity	๗ มี.ค. ๒๕๔๕
สภาพละลายได้	solubility	๗ มี.ค. ๒๕๔๕
สภาพลุกไหม้ได้	flammability	๗ มี.ค. ๒๕๔๕
สภาพดูดกลืน	absorptivity	๗ มี.ค. ๒๕๔๕
สภาพต้านทานความร้อน	thermal resistivity	๗ มี.ค. ๒๕๔๕
สภาพนำความร้อน	thermal conductivity	๗ มี.ค. ๒๕๔๕
สภาพผสมเข้ากันได้	miscibility	๗ มี.ค. ๒๕๔๕
หยดน้ำ; ชุดตัวดักไอน้ำพร้อท่อ; ท่อไอกลั่นตัว	drip	๗ มี.ค. ๒๕๔๕
สมดุลแบบระเหย	evaporative equilibrium	๗ มี.ค. ๒๕๔๕
eccentric reducer	ข้อลดแบบเยื้องศูนย์กลาง	๗ มี.ค. ๒๕๔๕
สวิตช์ความดัน	pressurestat; pressure switch	๗ มี.ค. ๒๕๔๕
ส่วนกั้นแยก	compartment	๗ มี.ค. ๒๕๔๕
ส่วนประกอบ	component	๗ มี.ค. ๒๕๔๕
ห้องเย็น; การเก็บเย็น	cold storage	๗ มี.ค. ๒๕๔๕
ห้องวัดปริมาณความร้อน	calorimeter room	๗ มี.ค. ๒๕๔๕
ห้องเครื่อง	machine room; machinery room	๗ มี.ค. ๒๕๔๕
ห้องแช่แข็ง	freezer	๗ มี.ค. ๒๕๔๕
ห้องอากาศ; ห้องลม	air chamber	๗ มี.ค. ๒๕๔๕
ห้องลม; ห้องอากาศ	air chamber	๗ มี.ค. ๒๕๔๕
ห้องข้อเหวี่ยง	crankcase	๗ มี.ค. ๒๕๔๕
EER (energy efficiency ratio)	อีอีดาร์ (ประสิทธิภาพการให้ความเย็น)	๗ มี.ค. ๒๕๔๕
effective temperature	อุณหภูมิยังผล	๗ มี.ค. ๒๕๔๕
effective temperature difference	ผลต่างอุณหภูมิยังผล	๗ มี.ค. ๒๕๔๕
effective work	งานยังผล	๗ มี.ค. ๒๕๔๕
หอทำความเย็น	cooling tower	๗ มี.ค. ๒๕๔๕
หอทำความเย็นใช้ลมเป่าเข้า	forced-draft cooling tower	๗ มี.ค. ๒๕๔๕
หอทำความเย็นใช้ลมดูดออก	induced-draft cooling tower	๗ มี.ค. ๒๕๔๕
หอทำความเย็นใช้พัดลม	mechanical-draft cooling tower	๗ มี.ค. ๒๕๔๕
หอทำความเย็นด้วยลมธรรมชาติ	natural-draft cooling tower	๗ มี.ค. ๒๕๔๕
หอทำความเย็นด้วยน้ำ	water-cooling tower	๗ มี.ค. ๒๕๔๕
หอทำความเย็นด้วยบรรยากาศ	atmospheric cooling tower	๗ มี.ค. ๒๕๔๕
ejector	อีเจ็กเตอร์	๗ มี.ค. ๒๕๔๕
elbow vanes	แผ่นแบ่งช่องท่อเลี้ยว	๗ มี.ค. ๒๕๔๕
electric control	การควบคุมเชิงไฟฟ้า	๗ มี.ค. ๒๕๔๕
electric heating element	ชุดทำความร้อนด้วยลวดไฟฟ้า	๗ มี.ค. ๒๕๔๕
electric isolator	อุปกรณ์ตัดตอนไฟฟ้า	๗ มี.ค. ๒๕๔๕
electric precipitator	อุปกรณ์กรองฝุ่นด้วยไฟฟ้า	๗ มี.ค. ๒๕๔๕
electronic control	การควบคุมเชิงอิเล็กทรอนิกส์	๗ มี.ค. ๒๕๔๕
eliminator	ตัวกำจัด	๗ มี.ค. ๒๕๔๕
emissivity	สภาพเปล่งรังสี	๗ มี.ค. ๒๕๔๕
emittance	ความเปล่งรังสี	๗ มี.ค. ๒๕๔๕
สัมประสิทธิ์การส่งผ่านความร้อน	heat transmission coefficient	๗ มี.ค. ๒๕๔๕
สัมประสิทธิ์การถ่ายโอนความร้อน	heat transfer coefficient	๗ มี.ค. ๒๕๔๕
สัมประสิทธิ์สมรรถนะฮีตปั๊ม (ซีโอพี)	coefficient of performance of heat pump (COPh)	๗ มี.ค. ๒๕๔๕
สัมประสิทธิ์สมรรถนะทำความเย็น (ซีโอพี)	coeficient of performance of refrigeration (COPc)	๗ มี.ค. ๒๕๔๕
encapsulated ice storage system	ระบบสะสมน้ำแข็งในถุงพลาสติก	๗ มี.ค. ๒๕๔๕
หัวเปลวตรวจรั่ว	halide torch	๗ มี.ค. ๒๕๔๕
หัวกระจายของเหลว [สารทำความเย็น]	distributor; liquid distributor	๗ มี.ค. ๒๕๔๕
หัวจ่ายลม	air diffuser	๗ มี.ค. ๒๕๔๕
หัวจ่ายลมฝ้าเพดาน	ceiling diffuser	๗ มี.ค. ๒๕๔๕
หัวปรับจ่ายลม	air terminal	๗ มี.ค. ๒๕๔๕
energy efficiency ratio (EER)	ประสิทธิภาพการให้ความเย็น (อีอีอาร์)	๗ มี.ค. ๒๕๔๕
environmental engineering	วิศวกรรมสิ่งแวดล้อม	๗ มี.ค. ๒๕๔๕
environmental standards	มาตรฐานสิ่งแวดล้อม	๗ มี.ค. ๒๕๔๕
สัญญาณรบกวน; เสียงรบกวน	noise	๗ มี.ค. ๒๕๔๕
สารเหลวคั่ง	liquid slugging	๗ มี.ค. ๒๕๔๕
สารหล่อลื่น	lubricant	๗ มี.ค. ๒๕๔๕
สารฆ่าสาหร่าย	algicide	๗ มี.ค. ๒๕๔๕
สารดูดความชื้น	desiccant	๗ มี.ค. ๒๕๔๕
สารทำความเย็น	refrigerant	๗ มี.ค. ๒๕๔๕
สารทำความเย็นเอชเอฟซี	HFC refrigerant	๗ มี.ค. ๒๕๔๕
สารทำความเย็นเอชซีเอฟซี	HCFC refrigerant	๗ มี.ค. ๒๕๔๕
สารทำความเย็นไร้ซีเอฟซี	non-CFC refrigerant	๗ มี.ค. ๒๕๔๕
สารทำความเย็นไฮโดรคาร์บอน	hydrocarbon refrigerant	๗ มี.ค. ๒๕๔๕
สารทำความเย็นซีเอฟซี	CFC refrigerant	๗ มี.ค. ๒๕๔๕
สารทำความเย็นทุติยภูมิ	secondary refrigerant	๗ มี.ค. ๒๕๔๕
สารทำความเย็นประเภทแฮโลเจน	halogenated refrigerant	๗ มี.ค. ๒๕๔๕
สารทำความเย็นปฐมภูมิ	primary refrigerant	๗ มี.ค. ๒๕๔๕
สารผสม	mixture	๗ มี.ค. ๒๕๔๕
สาหร่าย	algae	๗ มี.ค. ๒๕๔๕
equalizer	ท่อรักษาสมภาพ	๗ มี.ค. ๒๕๔๕
equalizing pressure	ความดันสมภาพ	๗ มี.ค. ๒๕๔๕
equilibrium pressure	ความดันสมดุล บางครั้งใช้ในความหมายของ balance pressure	๗ มี.ค. ๒๕๔๕
equivalent length	ความยาวสมมูล	๗ มี.ค. ๒๕๔๕
erosion corrosion	การกัดกร่อนแบบเซาะลึก	๗ มี.ค. ๒๕๔๕
ศูนย์สัมบูรณ์	absolute zero	๗ มี.ค. ๒๕๔๕
ศูนย์ควบคุม	control centre	๗ มี.ค. ๒๕๔๕
evaporating temperature	อุณหภูมิระเหย	๗ มี.ค. ๒๕๔๕
evaporation	การระเหย	๗ มี.ค. ๒๕๔๕
evaporative condenser	เครื่องควบแน่นแบบระเหย	๗ มี.ค. ๒๕๔๕
evaporative cooling	การทำความเย็นแบบระเหย	๗ มี.ค. ๒๕๔๕
evaporative equilibrium	สมดุลแบบระเหย	๗ มี.ค. ๒๕๔๕
evaporator	เครื่องระเหย มีความหมายเหมือนกับ cooler	๗ มี.ค. ๒๕๔๕
evaporator coil	คอยล์เครื่องระเหย	๗ มี.ค. ๒๕๔๕
evaporator temperature	อุณหภูมิเครื่องระเหย	๗ มี.ค. ๒๕๔๕
exfiltration	ลมรั่วจากห้อง	๗ มี.ค. ๒๕๔๕
exhauster; exhaust fan	พัดลมดูดออก	๗ มี.ค. ๒๕๔๕
exhaust air	ลมถ่ายออก	๗ มี.ค. ๒๕๔๕
exhaust fan; exhauster	พัดลมดูดออก	๗ มี.ค. ๒๕๔๕
exhaust opening	ช่องลมถ่ายออก	๗ มี.ค. ๒๕๔๕
expansion coil	คอยล์ระเหยสารทำความเย็น	๗ มี.ค. ๒๕๔๕
expansion tank	ถังรับน้ำขยายตัว	๗ มี.ค. ๒๕๔๕
expansion valve	วาล์วระเหยสารทำความเย็น	๗ มี.ค. ๒๕๔๕
expansion valve capacity	วิสัยสามารถของวาล์วระเหยสารทำความเย็น	๗ มี.ค. ๒๕๔๕
expansion valve superheat	ค่าความร้อนยวดยิ่งของวาล์วระเหยสารทำความเย็น	๗ มี.ค. ๒๕๔๕
expansion valve superheat change	การเปลี่ยนค่าความร้อนยวดยิ่งของวาล์วระเหยสารทำความเย็น	๗ มี.ค. ๒๕๔๕
extended surface	พื้นผิวเพิ่มถ่ายโอนความร้อน	๗ มี.ค. ๒๕๔๕
external equalizer	ท่อรักษาสมภาพภายนอก	๗ มี.ค. ๒๕๔๕
หลอดรูเล็ก	capillary tube	๗ มี.ค. ๒๕๔๕
หลอดแก้วตรวจระดับ	gauge glass	๗ มี.ค. ๒๕๔๕
สตาร์ตเตอร์แบบวาย-เดลตา	wye-delta starter; y-delta starter	๗ มี.ค. ๒๕๔๕
สตาร์ตเตอร์แบบต่อตรง	direct-online starter	๗ มี.ค. ๒๕๔๕
หน่วยแฟนคอยล์	fan-coil unit	๗ มี.ค. ๒๕๔๕
หน่วยเครื่องส่งลม (เอเอชยู)	air handling unit (AHU)	๗ มี.ค. ๒๕๔๕
หน่วยความร้อนระบบอังกฤษ	British Thermal Unit (BTU)	๗ มี.ค. ๒๕๔๕
หน่วยปริมาณผลัดเปลี่ยนลม	air changes	๗ มี.ค. ๒๕๔๕
หน้าตัดผนัง	wall section	๗ มี.ค. ๒๕๔๕
face area of coil; coil face area	พื้นที่หน้าคอยล์	๗ มี.ค. ๒๕๔๕
face split coil	คอยล์แยกผิวหน้า	๗ มี.ค. ๒๕๔๕
face velocity	ความเร็วลมหน้าคอยล์	๗ มี.ค. ๒๕๔๕
fan	พัดลม	๗ มี.ค. ๒๕๔๕
fan arrangement; fan drive arrangement	การจัดตำแหน่งขับพัดลม	๗ มี.ค. ๒๕๔๕
fan class of construction	ชั้นสร้างพัดลม	๗ มี.ค. ๒๕๔๕
fan designation	การระบุพัดลม	๗ มี.ค. ๒๕๔๕
fan drive	ชุดขับพัดลม	๗ มี.ค. ๒๕๔๕
fan drive arrangement; fan arrangement	การจัดตำแหน่งขับพัดลม	๗ มี.ค. ๒๕๔๕
fan guard	ตะแกรงพัดลม	๗ มี.ค. ๒๕๔๕
fan housing	เปลือกพัดลม	๗ มี.ค. ๒๕๔๕
fan laws	กฎพัดลม	๗ มี.ค. ๒๕๔๕
fan performance	สมรรถนะพัดลม	๗ มี.ค. ๒๕๔๕
fan shroud	กะบังพัดลม	๗ มี.ค. ๒๕๔๕
fan thermostat	เทอร์มอสแตตพัดลม	๗ มี.ค. ๒๕๔๕
fan wheel	ล้อพัดลม	๗ มี.ค. ๒๕๔๕
fan-coil unit	หน่วยแฟนคอยล์	๗ มี.ค. ๒๕๔๕
fill	แผ่นกรุ	๗ มี.ค. ๒๕๔๕
fill insulation	ฉนวนใช้กรุ	๗ มี.ค. ๒๕๔๕
fin	ครีบ	๗ มี.ค. ๒๕๔๕
filter rack	รางแผงกรองอากาศ	๗ มี.ค. ๒๕๔๕
filter-dryer	ชุดดูดกรองสารทำความเย็น	๗ มี.ค. ๒๕๔๕
finned coil	คอยล์มีครีบ	๗ มี.ค. ๒๕๔๕
finned tube	ท่อมีครีบ	๗ มี.ค. ๒๕๔๕
fire damper	ชุดแผ่นปรับลมกั้นไฟลาม	๗ มี.ค. ๒๕๔๕
fixed grille	ช่องลมเกล็ดตรึง	๗ มี.ค. ๒๕๔๕
flare connection	การต่อแบบปลายบาน	๗ มี.ค. ๒๕๔๕
flash gas	แฟลชแก๊ส	๗ มี.ค. ๒๕๔๕
flammability	สภาพลุกไหม้ได้	๗ มี.ค. ๒๕๔๕
flexible connector	ข้อต่ออ่อน	๗ มี.ค. ๒๕๔๕
flexible duct	ท่อลมอ่อน	๗ มี.ค. ๒๕๔๕
flexible tube	ท่ออ่อน	๗ มี.ค. ๒๕๔๕
float valve	วาล์วลูกลอย	๗ มี.ค. ๒๕๔๕
flooded-type evaporator	เครื่องระเหยแบบแช่สารทำความเย็น	๗ มี.ค. ๒๕๔๕
floor mounted	-ตั้งพื้น	๗ มี.ค. ๒๕๔๕
foaming	การเกิดฟอง	๗ มี.ค. ๒๕๔๕
forced draft	ลมเป่าเข้า	๗ มี.ค. ๒๕๔๕
forced-draft cooling tower	หอทำความเย็นใช้ลมเป่าเข้า	๗ มี.ค. ๒๕๔๕
forward curved blade fan	พัดลมใบโค้งเอียงหน้า	๗ มี.ค. ๒๕๔๕
foul gas; noncondensable gas	แก๊สไม่ควบแน่น	๗ มี.ค. ๒๕๔๕
fouling factor	แฟกเตอร์ความสกปรกของผิว	๗ มี.ค. ๒๕๔๕
free area	พื้นที่สุทธิช่องลม	๗ มี.ค. ๒๕๔๕
freezing point	จุดเยือกแข็ง	๗ มี.ค. ๒๕๔๕
freeze-up	น้ำแข็งจับ	๗ มี.ค. ๒๕๔๕
freezer	ห้องแช่แข็ง	๗ มี.ค. ๒๕๔๕
freezing	การทำให้เยือกแข็ง	๗ มี.ค. ๒๕๔๕
fresh air; outdoor air	อากาศใหม่	๗ มี.ค. ๒๕๔๕
friction drop; friction loss	ความดันลด	๗ มี.ค. ๒๕๔๕
friction head	ลำความดันเสียดทาน	๗ มี.ค. ๒๕๔๕
friction loss; friction drop	ความดันลด	๗ มี.ค. ๒๕๔๕
friction rate	อัตราเสียดทาน	๗ มี.ค. ๒๕๔๕
frost back	เกล็ดน้ำแข็งเกาะท่อดูด	๗ มี.ค. ๒๕๔๕
frostbite	เนื้อเสียเหตุเย็นจัด	๗ มี.ค. ๒๕๔๕
fusible plug	จุกอุดหลอมละลาย	๗ มี.ค. ๒๕๔๕
galvanic corrosion	การกัดกร่อนแกลแวนิก	๗ มี.ค. ๒๕๔๕
gauge glass	หลอดแก้วตรวจระดับ	๗ มี.ค. ๒๕๔๕
gauge pressure	ความดันเกจ	๗ มี.ค. ๒๕๔๕
generator	อุปกรณ์แยกสารทำความเย็น	๗ มี.ค. ๒๕๔๕
glazing	การใช้แผ่นกระจกกับอาคาร	๗ มี.ค. ๒๕๔๕
glycol	ไกลคอล	๗ มี.ค. ๒๕๔๕
graduate acting	ปรับควบคุมตามส่วน	๗ มี.ค. ๒๕๔๕
gravity damper	ชุดแผ่นปรับลมแบบโน้นถ่วง	๗ มี.ค. ๒๕๔๕
grille	ช่องลม	๗ มี.ค. ๒๕๔๕
gross weight	น้ำหนักรวบยอด	๗ มี.ค. ๒๕๔๕
halide torch	หัวเปลวตรวจรั่ว	๗ มี.ค. ๒๕๔๕
halogenated refrigerant	สารทำความเย็นประเภทแฮโลเจน	๗ มี.ค. ๒๕๔๕
hand expansion valve	วาล์วระเหยสารทำความเย็นปรับด้วยมือ	๗ มี.ค. ๒๕๔๕
HCFC (hydrochlorofluorocarbon)	เอชซีเอฟซี (ไฮโดรคลอโรฟลูออโรคาร์บอน)	๗ มี.ค. ๒๕๔๕
HCFC refrigerant	สารทำความเย็นเอชซีเอฟซี	๗ มี.ค. ๒๕๔๕
HCFC-123	เอชซีเอฟซี-๑๒๓ มีความหมายเหมือนกับ R-123	๗ มี.ค. ๒๕๔๕
HCFC-22	เอชซีเอฟซี-๒๒ มีความหมายเหมือนกับ R-22	๗ มี.ค. ๒๕๔๕
head	ลำความดัน	๗ มี.ค. ๒๕๔๕
header	ท่อรวม	๗ มี.ค. ๒๕๔๕
heat	ความร้อน	๗ มี.ค. ๒๕๔๕
heat gain	ความร้อนรับ	๗ มี.ค. ๒๕๔๕
heat interchanger	๑. เครื่องแลกเปลี่ยนความร้อน๒. เครื่องถ่ายโอนความร้อนระหว่างสารทำความเย็น	๗ มี.ค. ๒๕๔๕
heat loss	ความร้อนสูญเสีย	๗ มี.ค. ๒๕๔๕
heat of fusion	ความร้อนของการหลอม	๗ มี.ค. ๒๕๔๕
heat pipe	ท่อแลกเปลี่ยนความร้อน	๗ มี.ค. ๒๕๔๕
heat exchanger	เครื่องแลกเปลี่ยนความร้อน มีความหมายเหมือนกับ heat interchanger ๑	๗ มี.ค. ๒๕๔๕
heat pump	ฮีตปั๊ม	๗ มี.ค. ๒๕๔๕
heat reclaim	การใช้ประโยชน์คืนจากความร้อน	๗ มี.ค. ๒๕๔๕
heating coil	คอยล์ทำความร้อน	๗ มี.ค. ๒๕๔๕
heat transfer	การถ่ายโอนความร้อน	๗ มี.ค. ๒๕๔๕
heat transfer coefficient	สัมประสิทธิ์การถ่ายโอนความร้อน มีความหมายเหมือนกับ heat transmission coefficient	๗ มี.ค. ๒๕๔๕
heat transfer fluid	ของไหลรับถ่ายโอนความร้อน	๗ มี.ค. ๒๕๔๕
heat transmission	การส่งผ่านความร้อน	๗ มี.ค. ๒๕๔๕
heat transmission coefficient	สัมประสิทธิ์การส่งผ่านความร้อน	๗ มี.ค. ๒๕๔๕
helical rotary compressor	เครื่องอัดแก๊สทำความเย็นแบบเกลียวหมุน, คอมเพรสเซอร์แบบเกลียวหมุน	๗ มี.ค. ๒๕๔๕
hermetic compressor; sealed unit compressor	เครื่องอัดแก๊สทำความเย็นแบบหุ้มปิด, คอมเพรสเซอร์แบบหุ้มปิด	๗ มี.ค. ๒๕๔๕
HFC (hydrofluorocarbon)	เอชเอฟซี (ไฮโดรฟลูออโรคาร์บอน)	๗ มี.ค. ๒๕๔๕
HFC refrigerant	สารทำความเย็นเอชเอฟซี	๗ มี.ค. ๒๕๔๕
HFC-134a	เอชเอฟซี-๑๓๔เอ มีความหมายเหมือนกับ R-134a	๗ มี.ค. ๒๕๔๕
high pressure side; high side	ด้านความดันสูง	๗ มี.ค. ๒๕๔๕
high side; high pressure side	ด้านความดันสูง	๗ มี.ค. ๒๕๔๕
hot gas	แก๊สร้อน	๗ มี.ค. ๒๕๔๕
hot gas defrosting	การละลายน้ำแข็งด้วยแก๊สร้อน	๗ มี.ค. ๒๕๔๕
hot gas line; discharge tube	ท่อแก๊สร้อน	๗ มี.ค. ๒๕๔๕
hot water coil	คอยล์น้ำร้อน	๗ มี.ค. ๒๕๔๕
household refrigerator; domestic refrigerator	ตู้เย็นในบ้าน	๗ มี.ค. ๒๕๔๕
humidifier	เครื่องเพิ่มความชื้น	๗ มี.ค. ๒๕๔๕
humidifying effect	ผลเพิ่มความชื้น	๗ มี.ค. ๒๕๔๕
humidistat; hygrostat	ตัวควบคุมความชื้น	๗ มี.ค. ๒๕๔๕
humidity	ความชื้น	๗ มี.ค. ๒๕๔๕
humidity control	การควบคุมความชื้น	๗ มี.ค. ๒๕๔๕
humidity ratio	อัตราส่วนความชื้น มีความหมายเหมือนกับ specific humidity	๗ มี.ค. ๒๕๔๕
hydrocarbon	ไฮโดรคาร์บอน	๗ มี.ค. ๒๕๔๕
hydrofluorocarbon (HFC)	ไฮโดรฟูลออโรคาร์บอน (เอชเอฟซี)	๗ มี.ค. ๒๕๔๕
hydrocarbon refrigerant	สารทำความเย็นไฮโดรคาร์บอน	๗ มี.ค. ๒๕๔๕
hydrochlorofluorocarbon (HCFC)	ไฮโดรคลอโรฟลูออโรคาร์บอน (เอชซีเอฟซี)	๗ มี.ค. ๒๕๔๕
hydrolysis	การแยกสลายด้วยน้ำ	๗ มี.ค. ๒๕๔๕
hydrometer	มาตรฐานความหนาแน่นของเหลว	๗ มี.ค. ๒๕๔๕
hydronic air conditioning system; all-water air conditioning system	ระบบปรับอากาศแบบน้ำล้วน	๗ มี.ค. ๒๕๔๕
hydrostatic pressure	ความดันอุทกสถิต	๗ มี.ค. ๒๕๔๕
hygrometer	มาตรความชื้นสัมพัทธ์	๗ มี.ค. ๒๕๔๕
hygrostat; humidistat	ตัวควบคุมความชื้น	๗ มี.ค. ๒๕๔๕
ice storage system	ระบบสะสมน้ำแข็ง	๗ มี.ค. ๒๕๔๕
ice-on-coil storage system	ระบบสะสมน้ำแข็งบนคอยล์	๗ มี.ค. ๒๕๔๕
ice bank	แผงน้ำแข็ง	๗ มี.ค. ๒๕๔๕
ice chiller	เครื่องทำน้ำแข็ง	๗ มี.ค. ๒๕๔๕
ice harvesting storage system	ระบบสะสมน้ำแข็งแบบเก็บเกี่ยว	๗ มี.ค. ๒๕๔๕
อะลูมินากัมมันต์	activated alumina	๗ มี.ค. ๒๕๔๕
impeller	จานใบพัด	๗ มี.ค. ๒๕๔๕
indicated work	งานวัดโดยตรง	๗ มี.ค. ๒๕๔๕
indirect refrigeration system	ระบบทำความเย็นโดยอ้อม	๗ มี.ค. ๒๕๔๕
indoor air	อากาศในห้อง	๗ มี.ค. ๒๕๔๕
induced air	ลมเหนี่ยวนำ	๗ มี.ค. ๒๕๔๕
induced draft	ลมดูดออก	๗ มี.ค. ๒๕๔๕
induced-draft cooling tower	หอทำความเย็นใช้ลมดูดออก	๗ มี.ค. ๒๕๔๕
induction unit	ชุดส่งลมเหนี่ยวนำ	๗ มี.ค. ๒๕๔๕
industrial air conditioning	การปรับอากาศเชิงอุตสาหกรรม	๗ มี.ค. ๒๕๔๕
inert gas	แก๊สเฉื่อย	๗ มี.ค. ๒๕๔๕
infiltration	ลมรั่วเข้าห้อง	๗ มี.ค. ๒๕๔๕
inline fan	พัดลมติดตั้งในท่อลม	๗ มี.ค. ๒๕๔๕
inlet guide vane	ใบนำร่องทางเข้า	๗ มี.ค. ๒๕๔๕
integral-finned coil	คอยล์มีครีบในตัว	๗ มี.ค. ๒๕๔๕
integral action	การกระทำแบบอินทิกรัล มีความหมายเหมือนกับ integral control	๗ มี.ค. ๒๕๔๕
integral control	การควบคุมแบบอินทิกรัล	๗ มี.ค. ๒๕๔๕
internal equalizer	ท่อรักษาสมภาพภายใน	๗ มี.ค. ๒๕๔๕
internal heat	ความร้อนภายใน	๗ มี.ค. ๒๕๔๕
internal heat gain	ความร้อนรับภายใน	๗ มี.ค. ๒๕๔๕
intertwined circuiting coil	คอยล์วงจรไขว้	๗ มี.ค. ๒๕๔๕
อัตรา; ค่าประเมิน	rating	๗ มี.ค. ๒๕๔๕
อัตราเร็วสมวาร	synchronous speed	๗ มี.ค. ๒๕๔๕
อัตราเสียดทาน	friction rate	๗ มี.ค. ๒๕๔๕
อัตราส่วนยาวต่อกว้าง; อัตราส่วนขนาดท่อลม	aspect ratio	๗ มี.ค. ๒๕๔๕
อัตราส่วนการอัด	compression ratio; ratio of compresion	๗ มี.ค. ๒๕๔๕
อัตราส่วนการอิ่มตัว	saturation ration	๗ มี.ค. ๒๕๔๕
อัตราส่วนขนาดท่อลม; อัตราส่วนยาวต่อกว้าง	aspect ratio	๗ มี.ค. ๒๕๔๕
อัตราส่วนความชื้น	humidity ratio	๗ มี.ค. ๒๕๔๕
อัตราการรั่ว	leakage rate	๗ มี.ค. ๒๕๔๕
อาร์-๑๒๓	R-123	๗ มี.ค. ๒๕๔๕
อาร์-๑๓๔เอ	R-134a	๗ มี.ค. ๒๕๔๕
อาร์-๒๒	R-22	๗ มี.ค. ๒๕๔๕
อาร์พีเอ็ม (รอบต่อนาที)	rpm (revolution per minute)	๗ มี.ค. ๒๕๔๕
อาร์ทีทีวี (ค่าการถ่ายโอนความร้อนของหลังคา)	RTTV (roof thermal transfer value)	๗ มี.ค. ๒๕๔๕
อีเจ๊กเตอร์	ejector	๗ มี.ค. ๒๕๔๕
อีอีอาร์ (ประสิทธิภาพการให้ความเย็น)	EER (energy efficiency ratio)	๗ มี.ค. ๒๕๔๕
ion exchange softener	เครื่องทำน้ำอ่อนชนิดแลกเปลี่ยนไอออน	๗ มี.ค. ๒๕๔๕
อากาศแห้ง	dry air	๗ มี.ค. ๒๕๔๕
อากาศภายนอก	outside air	๗ มี.ค. ๒๕๔๕
อากาศมาตรฐาน	standard air	๗ มี.ค. ๒๕๔๕
อากาศในห้อง	indoor air	๗ มี.ค. ๒๕๔๕
อากาศอิ่มตัว	saturated air	๗ มี.ค. ๒๕๔๕
อากาศไม่อิ่มตัว	unsaturated air	๗ มี.ค. ๒๕๔๕
อากาศชื้น	moist air	๗ มี.ค. ๒๕๔๕
อากาศปรับภาวะ	conditioned air	๗ มี.ค. ๒๕๔๕
อากาศปรับลดความชื้น	dehumidified air	๗ มี.ค. ๒๕๔๕
อากาศ, ลม	air	๗ มี.ค. ๒๕๔๕
อากาศใหม่	fresh air; outdoor air	๗ มี.ค. ๒๕๔๕
ฮีตปั๊ม	heat pump	๗ มี.ค. ๒๕๔๕
องศาเย็นยิ่ง	degree of subcool	๗ มี.ค. ๒๕๔๕
องศาร้อนยวดยิ่ง	degree of superheat	๗ มี.ค. ๒๕๔๕
อติสีตศาสตร์	cryogenics	๗ มี.ค. ๒๕๔๕
อุณหภูมิระเหย	evaporating temperature	๗ มี.ค. ๒๕๔๕
อุณหภูมิแอปโพรช	approach	๗ มี.ค. ๒๕๔๕
อุณหภูมิยังผล	effective temperature	๗ มี.ค. ๒๕๔๕
อุณหภูมิแกว่ง	temperature swing	๗ มี.ค. ๒๕๔๕
อุณหภูมิเครื่องระเหย	evaporator temperature	๗ มี.ค. ๒๕๔๕
อุณหภูมิเพิ่ม	temperature rise	๗ มี.ค. ๒๕๔๕
อุณหภูมิวิกฤต	critical temperature	๗ มี.ค. ๒๕๔๕
อุณหภูมิห้อง	room temperature	๗ มี.ค. ๒๕๔๕
อุณหภูมิสัมบูรณ์	absolute temperature	๗ มี.ค. ๒๕๔๕
อุณหภูมิอิ่มตัว	saturation temperature	๗ มี.ค. ๒๕๔๕
อุณหภูมิลด	temperature drop	๗ มี.ค. ๒๕๔๕
อุณหภูมิลดกระเปาะเปียก	wet-bulb depression temperature	๗ มี.ค. ๒๕๔๕
อุณหภูมิกระเปาะแห้ง	dry-bulb temperature	๗ มี.ค. ๒๕๔๕
อุณหภูมิกระเปาะเปียก	wet-bulb temperature	๗ มี.ค. ๒๕๔๕
อุณหภูมิจุดน้ำค้าง	dew-point temperature	๗ มี.ค. ๒๕๔๕
อุณหภูมิด้านดูด	suction temperature	๗ มี.ค. ๒๕๔๕
อุณหภูมิทางออก	discharge temperature	๗ มี.ค. ๒๕๔๕
อุปกรณ์แยกน้ำมันหล่อลื่น	oil separator	๗ มี.ค. ๒๕๔๕
อุปกรณ์แตกตามพิกัด	rupture member	๗ มี.ค. ๒๕๔๕
อุปกรณ์อุ่นอากาศ	reheater	๗ มี.ค. ๒๕๔๕
อุปกรณ์อุ่นน้ำมันหล่อลื่น	crankcase heater	๗ มี.ค. ๒๕๔๕
อุปกรณ์ลดวิสัยสามารถ	capacity reducer	๗ มี.ค. ๒๕๔๕
อุปกรณ์ระบายความร้อนน้ำมันหล่อลื่น	oil cooler	๗ มี.ค. ๒๕๔๕
อุปกรณ์ระบายความดัน	pressure relief device	๗ มี.ค. ๒๕๔๕
อุปกรณ์รองรับการสั่นสะเทือน	resilient mounting	๗ มี.ค. ๒๕๔๕
อุปกรณ์ลดการสั่นสะเทือน	vibration isolator	๗ มี.ค. ๒๕๔๕
อุปกรณ์ลดการอัดคอมเพรสเซอร์	unloader	๗ มี.ค. ๒๕๔๕
อุปกรณ์ลดความชื้น	dehumidifier	๗ มี.ค. ๒๕๔๕
อุปกรณ์ลดความชื้นด้วยผิวเย็น	surface dehumidifier	๗ มี.ค. ๒๕๔๕
อุปกรณ์ไล่แก๊ส	purger	๗ มี.ค. ๒๕๔๕
อุปกรณ์การอัด	compression equipment	๗ มี.ค. ๒๕๔๕
อุปกรณ์กลั่นแยกน้ำมันหล่อลื่น	oil still	๗ มี.ค. ๒๕๔๕
อุปกรณ์บังแดด	shading device	๗ มี.ค. ๒๕๔๕
อุปกรณ์ปกป้องมอเตอร์	motor protector	๗ มี.ค. ๒๕๔๕
อุปกรณ์จับเวลาเลี่ยง	bypass timer	๗ มี.ค. ๒๕๔๕
อุปกรณ์จับเวลาละลายน้ำแข็ง	defrost timer	๗ มี.ค. ๒๕๔๕
อุปกรณ์จำกัดความดัน	pressure limiting device	๗ มี.ค. ๒๕๔๕
อุปกรณ์ดูดซับความชื้น	drier	๗ มี.ค. ๒๕๔๕
อุปกรณ์ตัดตอนไฟฟ้า	electric isolator	๗ มี.ค. ๒๕๔๕
อุปกณ์กรองฝุ่นด้วยไฟฟ้า	electric precipitator	๗ มี.ค. ๒๕๔๕
jacketing	การหล่อด้วยของเหลว	๗ มี.ค. ๒๕๔๕
kit	ชุดอุปกรณ์	๗ มี.ค. ๒๕๔๕
label diagram	แผนภาพสัญลักษณ์	๗ มี.ค. ๒๕๔๕
lag	ช่วงล่า	๗ มี.ค. ๒๕๔๕
latent heat	ความร้อนแฝง	๗ มี.ค. ๒๕๔๕
latent heat of evaporation	ความร้อนแฝงของการระเหย	๗ มี.ค. ๒๕๔๕
latent heat of fusion	ความร้อนแฝงของการหลอม มีความหมายเหมือนกับ heat of fusion	๗ มี.ค. ๒๕๔๕
latitude	ละติจูด	๗ มี.ค. ๒๕๔๕
leak detector	เครื่องตรวจหารอยรั่ว	๗ มี.ค. ๒๕๔๕
leakage rate	อัตราการรั่ว	๗ มี.ค. ๒๕๔๕
lighting heat	ความร้อนจากไฟส่องสว่าง	๗ มี.ค. ๒๕๔๕
limiting thermostat	เทอร์มอสแตตแบบขีดจำกัด	๗ มี.ค. ๒๕๔๕
line loss	ความดันลดในท่อ	๗ มี.ค. ๒๕๔๕
linear diffuser; slot diffuser	ช่องจ่ายลมแนวยาว	๗ มี.ค. ๒๕๔๕
lining	การบุภายใน	๗ มี.ค. ๒๕๔๕
liquid chiller	เครื่องทำของเหลวเย็น	๗ มี.ค. ๒๕๔๕
liquid distributor; distributor	หัวกระจายของเหลว	๗ มี.ค. ๒๕๔๕
liquid distributor tube	ท่อหัวกระจายของเหลว	๗ มี.ค. ๒๕๔๕
liquid indicator	ช่องตรวจของเหลว	๗ มี.ค. ๒๕๔๕
liquid line	ท่อสารเหลว	๗ มี.ค. ๒๕๔๕
liquefaction	การทำให้เป็นของเหลว	๗ มี.ค. ๒๕๔๕
liquid refrigerant receiver; receiver	ถังพักสารทำความเย็นเหลว	๗ มี.ค. ๒๕๔๕
liquid slugging	สารเหลวคั่ง	๗ มี.ค. ๒๕๔๕
liquor	ลิเคอร์	๗ มี.ค. ๒๕๔๕
louver	เกล็ดช่องลม	๗ มี.ค. ๒๕๔๕
low pressure duct system	ระบบท่อลมความดันต่ำ	๗ มี.ค. ๒๕๔๕
low pressure side; low side	ด้านความดันต่ำ	๗ มี.ค. ๒๕๔๕
low side; low pressure side	ด้านความดันต่ำ	๗ มี.ค. ๒๕๔๕
low-side float valve	วาล์วลูกลอยด้านความดันต่ำ	๗ มี.ค. ๒๕๔๕
lubricant	สารหล่อลื่น	๗ มี.ค. ๒๕๔๕
machine room; machinery room	ห้องเครื่อง	๗ มี.ค. ๒๕๔๕
machinery room; machine room	ห้องเครื่อง	๗ มี.ค. ๒๕๔๕
main	ท่อหลัก	๗ มี.ค. ๒๕๔๕
make-up air	ลมเติม	๗ มี.ค. ๒๕๔๕
make-up water	น้ำเติม	๗ มี.ค. ๒๕๔๕
manometer	แมนอมิเตอร์	๗ มี.ค. ๒๕๔๕
manifold	ท่อร่วม	๗ มี.ค. ๒๕๔๕
manual control	การควบคุมด้วยมือ	๗ มี.ค. ๒๕๔๕
manual damper	ชุดแผ่นปรับลมด้วยมือ	๗ มี.ค. ๒๕๔๕
manual defrost	การละลายน้ำแข็งปรับด้วยมือ	๗ มี.ค. ๒๕๔๕
mean temperature difference	ผลต่างอุณหภูมิเฉลี่ย	๗ มี.ค. ๒๕๔๕
mechanical-draft cooling tower	หอทำความเย็นใช้พัดลม	๗ มี.ค. ๒๕๔๕
mechanically bonded	-ติดกันโดยวิธีกล	๗ มี.ค. ๒๕๔๕
mechanical control	การควบคุมเชิงกล	๗ มี.ค. ๒๕๔๕
mechanical efficiency	ประสิทธิภาพเชิงกล	๗ มี.ค. ๒๕๔๕
mechanical joint	รอยต่อเชิงกล	๗ มี.ค. ๒๕๔๕
mechanical refrigerating system	ระบบทำความเย็นเชิงกล	๗ มี.ค. ๒๕๔๕
mechanical seal	กันรั่วเชิงกล	๗ มี.ค. ๒๕๔๕
micron	ไมครอน	๗ มี.ค. ๒๕๔๕
miscibility	สภาพผสมเข้ากันได้	๗ มี.ค. ๒๕๔๕
miter elbow	ท่อเลี้ยวหักฉาก	๗ มี.ค. ๒๕๔๕
mixed air	ลมผสม	๗ มี.ค. ๒๕๔๕
mixing box	กล่องผสมลม	๗ มี.ค. ๒๕๔๕
mixture	สารผสม	๗ มี.ค. ๒๕๔๕
modulating control	การควบคุมแบบต่อเนื่อง	๗ มี.ค. ๒๕๔๕
modulating motor	มอเตอร์หมุนปรับแบบต่อเนื่อง	๗ มี.ค. ๒๕๔๕
modulating thermostat	เทอร์มอสแตตแบบต่อเนื่อง มีความหมายเหมือนกับ proportional thermostat	๗ มี.ค. ๒๕๔๕
modulating valve	วาล์วแบบต่อเนื่อง	๗ มี.ค. ๒๕๔๕
moist air	อากาศชื้น	๗ มี.ค. ๒๕๔๕
moisture	ความชื้น	๗ มี.ค. ๒๕๔๕
moisture carry-over	ความชื้นลอดผ่าน	๗ มี.ค. ๒๕๔๕
moisture gain	ความชื้นรับ	๗ มี.ค. ๒๕๔๕
moisture regain	ความชื้นรับเพิ่ม	๗ มี.ค. ๒๕๔๕
monitor	๑. ตัวจอภาพ๒. เครื่องเฝ้าสังเกต, มอนิเตอร์	๗ มี.ค. ๒๕๔๕
motorised valve	วาล์วขับด้วยมอเตอร์	๗ มี.ค. ๒๕๔๕
motor protector	อุปกรณ์ปกป้องมอเตอร์	๗ มี.ค. ๒๕๔๕
muffler	กระบอกลดเสียง	๗ มี.ค. ๒๕๔๕
multiple refrigeration system	ระบบทำความเย็นแบบพหุคูณ	๗ มี.ค. ๒๕๔๕
multistage compression	การอัดแบบหลายชั้น	๗ มี.ค. ๒๕๔๕
multistage expansion	การระเหยสารทำความเย็นแบบหลายขั้น	๗ มี.ค. ๒๕๔๕
nameplate	ป้ายประจำเครื่อง	๗ มี.ค. ๒๕๔๕
natural draft	ลมธรรมชาติ	๗ มี.ค. ๒๕๔๕
natural-draft cooling tower	หอทำความเย็นด้วยลมธรรมชาติ	๗ มี.ค. ๒๕๔๕
night setback	การปรับคืนช่วยกลางคืน	๗ มี.ค. ๒๕๔๕
noise	๑. สัญญาณรบกวน๒. เสียงรบกวน	๗ มี.ค. ๒๕๔๕
non-CFC refrigerant	สารทำความเย็นไร้ซีเอฟซี	๗ มี.ค. ๒๕๔๕
non-conductive duct	ท่อลมไม่นำไฟฟ้า	๗ มี.ค. ๒๕๔๕
non-overloading type fan	พัดลมแบบไร้ภาระเกิน	๗ มี.ค. ๒๕๔๕
noncondensable gas; foul gas	แก๊สไม่ควบแน่น	๗ มี.ค. ๒๕๔๕
normally closed	ปรกติปิด	๗ มี.ค. ๒๕๔๕
normally open	ปรกติเปิด	๗ มี.ค. ๒๕๔๕
off peak period	ช่วงเวลาความต้องการกำลังไฟฟ้าต่ำ	๗ มี.ค. ๒๕๔๕
oil charge	ปริมาณน้ำมันประจุ	๗ มี.ค. ๒๕๔๕
oil cooler	อุปกรณ์ระบายความร้อนน้ำมันหล่อลื่น	๗ มี.ค. ๒๕๔๕
oil separator	อุปกรณ์แยกน้ำมันหล่อลื่น	๗ มี.ค. ๒๕๔๕
oil still	อุปกรณ์กลั่นแยกน้ำมันหล่อลื่น	๗ มี.ค. ๒๕๔๕
oil trap	กับดักน้ำมันหล่อลื่น	๗ มี.ค. ๒๕๔๕
on peak period	ช่วงเวลาความต้องการกำลังไฟฟ้าสูง	๗ มี.ค. ๒๕๔๕
on-off control	การควบคุมแบบปิด-เปิด	๗ มี.ค. ๒๕๔๕
opaque area	พื้นที่ทึบแสง	๗ มี.ค. ๒๕๔๕
open expansion tank	ถังรับน้ำขยายตัวแบบเปิด	๗ มี.ค. ๒๕๔๕
open-shell-and-tube condenser	เครื่องควบแน่นแบบเปลือกและท่อเปิด	๗ มี.ค. ๒๕๔๕
open-type compressor	เครื่องอัดแก๊สทำความเย็นแบบเปิด, คอมเพรสเซอร์แบบเปิด	๗ มี.ค. ๒๕๔๕
operating pressure	ความดันขณะทำงาน	๗ มี.ค. ๒๕๔๕
operating weight	น้ำหนักเครื่องใช้งาน	๗ มี.ค. ๒๕๔๕
orifice	ช่อง	๗ มี.ค. ๒๕๔๕
orifice plate	แผ่นช่อง	๗ มี.ค. ๒๕๔๕
OTTV (overall termal transfer value)	โอทีทีวี (ค่าการถ่ายโอนความร้อนรวบยอด)	๗ มี.ค. ๒๕๔๕
output	ปริมาณออก	๗ มี.ค. ๒๕๔๕
outlet pressure	ความดันทางออก	๗ มี.ค. ๒๕๔๕
outdoor	ภายนอกอาคาร	๗ มี.ค. ๒๕๔๕
outdoor air; fresh air	อากาศใหม่	๗ มี.ค. ๒๕๔๕
outdoor thermostat	เทอร์มอสแตตนอกอาคาร	๗ มี.ค. ๒๕๔๕
outside air	อากาศภายนอก	๗ มี.ค. ๒๕๔๕
outside air opening	ช่องลมภายนอก	๗ มี.ค. ๒๕๔๕
overall thermal transfer value (OTTV)	ค่าการถ่ายโอนความร้อนรวบยอด (โอทีทีวี)	๗ มี.ค. ๒๕๔๕
overhang	กันสาด	๗ มี.ค. ๒๕๔๕
overload	ภาระเกิน	๗ มี.ค. ๒๕๔๕
overload protection	การกันภาระเกิน	๗ มี.ค. ๒๕๔๕
overload relay	รีเลย์กันภาระเกิน	๗ มี.ค. ๒๕๔๕
overriding	การรับช่วงคุมแทน	๗ มี.ค. ๒๕๔๕
packaged type air conditioner; self-contained air conditioner	เครื่องปรับอากาศแบบรวมส่วน	๗ มี.ค. ๒๕๔๕
packaged unit	ชุดอุปกรณ์แบบรวมส่วน	๗ มี.ค. ๒๕๔๕
packing	วัสดุอัด	๗ มี.ค. ๒๕๔๕
packing seal	กันรั่วแบบอัด	๗ มี.ค. ๒๕๔๕
packless valve	วาล์วไร้วัสดุอัด	๗ มี.ค. ๒๕๔๕
pan	ถาด	๗ มี.ค. ๒๕๔๕
panel board	แผงไฟ	๗ มี.ค. ๒๕๔๕
parallel flow	การไหลแบบขนาน	๗ มี.ค. ๒๕๔๕
partial peak period	ช่วงเวลาความต้องการกำลังไฟฟ้าสูงบางส่วน	๗ มี.ค. ๒๕๔๕
partial pressure	ความดันย่อย	๗ มี.ค. ๒๕๔๕
particulate filtration	การกรองละอองธุลี	๗ มี.ค. ๒๕๔๕
people heat	ความร้อนจากคน	๗ มี.ค. ๒๕๔๕
percentage humidity	ความชื้นเป็นร้อยละ	๗ มี.ค. ๒๕๔๕
perforated grille; stamped grille	ช่องลมแบบหน้าพรุน	๗ มี.ค. ๒๕๔๕
performance	สมรรถนะ	๗ มี.ค. ๒๕๔๕
pH	พีเอช	๗ มี.ค. ๒๕๔๕
phase	เฟส	๗ มี.ค. ๒๕๔๕
pipe shaft	ช่องท่อ	๗ มี.ค. ๒๕๔๕
pipe support	ที่รองรับท่อ	๗ มี.ค. ๒๕๔๕
piping	ท่อและอุปกรณ์ท่อ	๗ มี.ค. ๒๕๔๕
piston displacement	ความจุกระบอกสูบ	๗ มี.ค. ๒๕๔๕
pitot tube anemometer	มาตรความเร็วลมแบบพิโทต์ทิวบ์	๗ มี.ค. ๒๕๔๕
pitting corrosions	การกัดกร่อนเป็นหลุม	๗ มี.ค. ๒๕๔๕
pitch	ความลาดเอียง	๗ มี.ค. ๒๕๔๕
plate heat exchanger	เครื่องแลกเปลี่ยนความร้อนแบบแผ่น	๗ มี.ค. ๒๕๔๕
plate-finned coil	คอยล์ครีบแผ่น	๗ มี.ค. ๒๕๔๕
plenum ceiling	เพดานกล่องลม	๗ มี.ค. ๒๕๔๕
plenum chamber	กล่องลม	๗ มี.ค. ๒๕๔๕
pneumatic control	การควบคุมแบบลมอัด	๗ มี.ค. ๒๕๔๕
positive displacement compressor	เครื่องอัดแก๊สทำความเย็นแบบเปลี่ยนปริมาตร, คอมเพรสเซอร์แบบเปลี่ยนปริมาตร	๗ มี.ค. ๒๕๔๕
potentiometer	โพเทนชิออมิเตอร์	๗ มี.ค. ๒๕๔๕
power capacitor	ตัวเก็บประจุกำลัง	๗ มี.ค. ๒๕๔๕
power consumption	กำลังที่ใช้ไป	๗ มี.ค. ๒๕๔๕
power	กำลัง	๗ มี.ค. ๒๕๔๕
precooler	ชุดทำให้เย็นล่วงหน้า	๗ มี.ค. ๒๕๔๕
preheat coil	คอยล์อุ่นอากาศล่วงหน้า มีความหมายเหมือนกับ preheater	๗ มี.ค. ๒๕๔๕
preheater	ชุดทำให้อุ่นล่วงหน้า	๗ มี.ค. ๒๕๔๕
pressure	ความดัน	๗ มี.ค. ๒๕๔๕
pressure change of expansion valve	การเปลี่ยนความดันทางออกของวาล์วระเหยสารทำความเย็น	๗ มี.ค. ๒๕๔๕
pressure drop	ความดันลด มีความหมายเหมือนกับ pressure loss	๗ มี.ค. ๒๕๔๕
pressure imposing element	อุปกรณ์เพิ่มความดัน	๗ มี.ค. ๒๕๔๕
pressure limiting device	อุปกรณ์จำกัดความดัน	๗ มี.ค. ๒๕๔๕
pressure loss	ความดันสูญเสีย	๗ มี.ค. ๒๕๔๕
pressure reducing valve	วาล์วลดความดัน	๗ มี.ค. ๒๕๔๕
pressure regulator	ตัวคุมค่าความดัน	๗ มี.ค. ๒๕๔๕
pressure relief device	อุปกรณ์ระบายความดัน	๗ มี.ค. ๒๕๔๕
pressure switch; pressurestat	สวิตช์ความดัน	๗ มี.ค. ๒๕๔๕
pressurestat; pressure switch	สวิตช์ความดัน	๗ มี.ค. ๒๕๔๕
primary air	ลมปฐมภูมิ	๗ มี.ค. ๒๕๔๕
primary fluid	ของไหลปฐมภูมิ	๗ มี.ค. ๒๕๔๕
primary refrigerant	สารทำความเย็นปฐมภูมิ	๗ มี.ค. ๒๕๔๕
propeller fan	พัดลมใบแฉก	๗ มี.ค. ๒๕๔๕
proportional thermostat	เทอร์มอสแตตแบบสัดส่วน	๗ มี.ค. ๒๕๔๕
proportional action	การกระทำแบบสัดส่วน มีความหมายเหมือนกับ proportional control	๗ มี.ค. ๒๕๔๕
proportional control	การควบคุมแบบสัดส่วน	๗ มี.ค. ๒๕๔๕
protecting grille	ตะแกรงคุ้มภัย	๗ มี.ค. ๒๕๔๕
psychrometer	มาตรความชื้นสัมพัทธ์แบบกระเปาะเปียก-แห้ง, ไซโครมิเตอร์	๗ มี.ค. ๒๕๔๕
psychrometric chart	แผนภูมิไซโครเมตรี	๗ มี.ค. ๒๕๔๕
psychrometry	ไซโครเมตรี	๗ มี.ค. ๒๕๔๕
published rating	ค่าประเมินรับรอง	๗ มี.ค. ๒๕๔๕
pump down	การสูบถ่าย (สารทำความเย็น)	๗ มี.ค. ๒๕๔๕
pump out	การสูบไล่ (สารทำความเย็น)	๗ มี.ค. ๒๕๔๕
purge valve	วาล์วไล่แก๊ส	๗ มี.ค. ๒๕๔๕
purger	อุปกรณ์ไล่แก๊ส	๗ มี.ค. ๒๕๔๕
purging	การไล่แก๊ส	๗ มี.ค. ๒๕๔๕
quality of wet vapour	คุณภาพของไอชื้น	๗ มี.ค. ๒๕๔๕
R-123	อาร์-๑๒๓ 123	๗ มี.ค. ๒๕๔๕
R-134a	อาร์-๑๓๔เอ	๗ มี.ค. ๒๕๔๕
R-22	อาร์-๒๒	๗ มี.ค. ๒๕๔๕
radial blade fan	พัดลมใบตรง	๗ มี.ค. ๒๕๔๕
rain shield	ครอบกันฝน	๗ มี.ค. ๒๕๔๕
rated capacity	วิสัยสามารถประเมิน	๗ มี.ค. ๒๕๔๕
rating	๑. อัตรา๒. ค่าประเมิน	๗ มี.ค. ๒๕๔๕
ratio of compression; compression ratio	อัตราส่วนการอัด	๗ มี.ค. ๒๕๔๕
raw water	น้ำดิบ	๗ มี.ค. ๒๕๔๕
reach-in refrigerator	ตู้เย็นแบบหยิบถึง มีความหมายเหมือนกับ service refrigerator	๗ มี.ค. ๒๕๔๕
receiver; liquid refrigerant receive	ถังพักสารทำความเย็นเหลว	๗ มี.ค. ๒๕๔๕
reciprocating chiller	เครื่องทำของเหลวเย็นแบบลูกสูบ	๗ มี.ค. ๒๕๔๕
reciprocating compressor	เครื่องอัดแก๊สทำความเย็นแบบลูกสูบ, คอมเพรสเซอร์แบบลูกสูบ	๗ มี.ค. ๒๕๔๕
recirculated air	ลมหมุนเวียนกลับ มีความหมายเหมือนกับ return air	๗ มี.ค. ๒๕๔๕
recirculating water	น้ำหมุนเวียนกลับ	๗ มี.ค. ๒๕๔๕
reflectivity	สภาพสะท้อน	๗ มี.ค. ๒๕๔๕
refle tube	ท่อเกลียวใน	๗ มี.ค. ๒๕๔๕
refrigerant	สารทำความเย็น	๗ มี.ค. ๒๕๔๕
refrigerant charge	ปริมาณสารทำความเย็นประจุ	๗ มี.ค. ๒๕๔๕
refrigerant compressor	เครื่องอัดแก๊สทำความเย็น	๗ มี.ค. ๒๕๔๕
refrigerant gas	แก๊สทำความเย็น	๗ มี.ค. ๒๕๔๕
refrigerant liquid	ของเหลวทำความเย็น	๗ มี.ค. ๒๕๔๕
refrigerating capacity	วิสัยสามารถทำความเย็น	๗ มี.ค. ๒๕๔๕
refrigerating circuit	วงจรทำความเย็น	๗ มี.ค. ๒๕๔๕
refrigerating cycle	วัฏจักรทำความเย็น	๗ มี.ค. ๒๕๔๕
refrigerating effect	ผลทำความเย็น	๗ มี.ค. ๒๕๔๕
refrigerating engineering	วิศวกรรมทำความเย็น	๗ มี.ค. ๒๕๔๕
refrigerating machinery	ชุดเครื่องจักรทำความเย็น	๗ มี.ค. ๒๕๔๕
refrigerating plant	โรงทำความเย็น	๗ มี.ค. ๒๕๔๕
refrigerating system	ระบบทำความเย็น	๗ มี.ค. ๒๕๔๕
refrigeration	๑. การทำความเย็น๒. วิชาการทำความเย็น	๗ มี.ค. ๒๕๔๕
refrigerator	ตู้เย็น	๗ มี.ค. ๒๕๔๕
regenerative cooling	การทำความเย็นจากความร้อนปล่อยทิ้ง	๗ มี.ค. ๒๕๔๕
register	ช่องลมปรับปริมาณได้	๗ มี.ค. ๒๕๔๕
reheater	อุปกรณ์อุ่นอากาศ	๗ มี.ค. ๒๕๔๕
reheating coil; tempering coil	คอยล์อุ่นอากาศ	๗ มี.ค. ๒๕๔๕
relative humidity	ความชื้นสัมพัทธ์	๗ มี.ค. ๒๕๔๕
relay	รีเลย์	๗ มี.ค. ๒๕๔๕
relief damper	ชุดแผ่นปรับลมระบายความดัน	๗ มี.ค. ๒๕๔๕
remote bulb thermostat	เทอร์มอสแตตแบบหางกระเปาะ	๗ มี.ค. ๒๕๔๕
resilient mounting	อุปกรณ์รองรับการสั่นสะเทือน	๗ มี.ค. ๒๕๔๕
return air	ลมกลับ	๗ มี.ค. ๒๕๔๕
return gas	แก๊สไหลกลับ	๗ มี.ค. ๒๕๔๕
return grille	ช่องลมกลับ	๗ มี.ค. ๒๕๔๕
reverse-acting diaphragm valve	วาล์วไดอะแฟรมแบบทำงานผันกลับ	๗ มี.ค. ๒๕๔๕
reverse-acting thermostat	เทอร์มอสแตตแบบทำงานผันกลับ	๗ มี.ค. ๒๕๔๕
reversible cycle	วัฏจักรผันกลับ	๗ มี.ค. ๒๕๔๕
revolution per minute (rpm)	รอบต่อนาที (อาร์พีเอ็ม)	๗ มี.ค. ๒๕๔๕
riser	ท่อตั้ง	๗ มี.ค. ๒๕๔๕
room air conditioner	เครื่องปรับอากาศติดห้อง	๗ มี.ค. ๒๕๔๕
room dew point	จุดน้ำค้างห้อง	๗ มี.ค. ๒๕๔๕
room temperature	อุณหภูมิห้อง	๗ มี.ค. ๒๕๔๕
room thermostat	เทอร์มอสแตตในห้อง	๗ มี.ค. ๒๕๔๕
roof thermal transfer value (RTTV)	ค่าการถ่ายโอนความร้อนของหลังคา (อาร์ทีทีวี)	๗ มี.ค. ๒๕๔๕
rooftop air conditioner	เครื่องปรับอากาศติดบนหลังคา	๗ มี.ค. ๒๕๔๕
rotary chiller	เครื่องทำของเหลวเย็นแบบหมุน	๗ มี.ค. ๒๕๔๕
rotary compressor	เครื่องอัดแก๊สทำความเย็นแบบหมุน, คอมเพรสเซอร์แบบหมุน	๗ มี.ค. ๒๕๔๕
rotary heat exchanger	เครื่องแลกเปลี่ยนความร้อนแบบหมุน	๗ มี.ค. ๒๕๔๕
row split coil	คอยล์แยกแถว	๗ มี.ค. ๒๕๔๕
rpm (revolution per minute)	อาร์พีเอ็ม (รอบต่อนาที)	๗ มี.ค. ๒๕๔๕
RTTV (roof thermal transfer value)	อาร์ทีทีวี (ค่าการถ่ายโอนความร้อนของหลังคา)	๗ มี.ค. ๒๕๔๕
run capacitor	ตัวเก็บประจุขณะทำงาน	๗ มี.ค. ๒๕๔๕
runout	ท่อย่อย	๗ มี.ค. ๒๕๔๕
rupture member	อุปกรณ์แตกตามพิกัด	๗ มี.ค. ๒๕๔๕
safety factor	แฟกเตอร์ความปลอดภัย	๗ มี.ค. ๒๕๔๕
safety valve	วาล์วนิรภัย	๗ มี.ค. ๒๕๔๕
salt storage system	ระบบสะสมน้ำเกลือแข็ง	๗ มี.ค. ๒๕๔๕
saturated air	อากาศอิ่มตัว	๗ มี.ค. ๒๕๔๕
saturated vapour	ไออิ่มตัว	๗ มี.ค. ๒๕๔๕
saturation pressure	ความดันอิ่มตัว	๗ มี.ค. ๒๕๔๕
saturation ratio	อัตราส่วนการอิ่มตัว	๗ มี.ค. ๒๕๔๕
saturation temperature	อุณหภูมิอิ่มตัว	๗ มี.ค. ๒๕๔๕
screw chiller	เครื่องทำของเหลวเย็นแบบเกลียว	๗ มี.ค. ๒๕๔๕
screw compressor	เครื่องอัดแก๊สทำความเย็นแบบเกลียว, คอมเพรสเซอร์แบบเกลีย มีความหมายเหมือนกับ helical rotary compressor	๗ มี.ค. ๒๕๔๕
scroll compressor	เครื่องอัดแก๊สทำความเย็นแบบก้นหอย, คอมเพรสเซอร์แบบก้นหอย	๗ มี.ค. ๒๕๔๕
sealed unit compressor; hermetic compressor	เครื่องอัดแก๊สทำความเย็นแบบหุ้มปิด, คอมเพรสเซอร์แบบหุ้มปิด	๗ มี.ค. ๒๕๔๕
seamless tube	ท่อไร้ตะเข็บ	๗ มี.ค. ๒๕๔๕
secondary fluid	ของไหลทุติยภูมิ	๗ มี.ค. ๒๕๔๕
secondary air	ลมทุติยภูมิ	๗ มี.ค. ๒๕๔๕
secondary refrigerant	สารทำความเย็นทุติยภูมิ	๗ มี.ค. ๒๕๔๕
self-contained air conditioner; packaged type air conditioner	เครื่องปรับอากาศแบบรวมส่วน	๗ มี.ค. ๒๕๔๕
self-service refrigerator	ตู้เย็นแบบบริการตัวเอง	๗ มี.ค. ๒๕๔๕
semi-automatic defrost	การละลายน้ำแข็งกึ่งอัตโนมัติ	๗ มี.ค. ๒๕๔๕
semi-hermetic compressor	เครื่องอัดแก๊สทำความเย็นแบบประกอบปิด, คอมเพรสเซอร์แบบประกอบปิด	๗ มี.ค. ๒๕๔๕
sensible heat	ความร้อนสัมผัส	๗ มี.ค. ๒๕๔๕
sequence control	การควบคุมลำดับขั้นตอน	๗ มี.ค. ๒๕๔๕
service refrigerator	ตู้เย็นแบบบริการ	๗ มี.ค. ๒๕๔๕
service valve	วาล์วบริการ	๗ มี.ค. ๒๕๔๕
shading device	อุปกรณ์บังแดด	๗ มี.ค. ๒๕๔๕
shaft seal	กันรั่วเพลา	๗ มี.ค. ๒๕๔๕
shell and tube heat exchanger	เครื่องแลกเปลี่ยนความร้อนแบบเปลือกและท่อ	๗ มี.ค. ๒๕๔๕
shell-and-tube condenser	เครื่องควบแน่นแบบเปลือกและท่อ	๗ มี.ค. ๒๕๔๕
short cycling	การทำงานเป็นรอบถี่	๗ มี.ค. ๒๕๔๕
sight glass	ช่องตรวจใส	๗ มี.ค. ๒๕๔๕
silica gel	ซิลิกาเจล	๗ มี.ค. ๒๕๔๕
sleep mode control	การควบคุมภาวะหลับ	๗ มี.ค. ๒๕๔๕
sleeve	ช่องผ่าน	๗ มี.ค. ๒๕๔๕
slot diffuser; linear diffuser	ช่องจ่ายลมแนวยาว	๗ มี.ค. ๒๕๔๕
solar altitude; solar altitude angle	มุมทางสูงดวงอาทิตย์	๗ มี.ค. ๒๕๔๕
solar altitude angle; solar altitude	มุมทางสูงดวงอาทิตย์	๗ มี.ค. ๒๕๔๕
solar azimuth; solar azimuth angle	มุมภาคทิศดวงอาทิตย์	๗ มี.ค. ๒๕๔๕
solar azimuth angle; solar azimuth	มุมภาคทิศดวงอาทิตย์	๗ มี.ค. ๒๕๔๕
solar constant	ค่าคงตัวแสงอาทิตย์	๗ มี.ค. ๒๕๔๕
solar factor	แฟกเตอร์แสงอาทิตย์	๗ มี.ค. ๒๕๔๕
solar heat gain	ความร้อนรับจากดวงอาทิตย์	๗ มี.ค. ๒๕๔๕
solenoid coil	ขดลวดโซเลนอยด์	๗ มี.ค. ๒๕๔๕
solenoid valve	วาล์วโซเลนอยด์	๗ มี.ค. ๒๕๔๕
solubility	สภาพละลายได้	๗ มี.ค. ๒๕๔๕
sound attenuator; attenuator	กล่องลดเสียง	๗ มี.ค. ๒๕๔๕
sound insulation	ฉนวนกันเสียง	๗ มี.ค. ๒๕๔๕
sound trap	กับดักเสียง	๗ มี.ค. ๒๕๔๕
specific heat	ความร้อนจำเพาะ	๗ มี.ค. ๒๕๔๕
specific humidity	ความชื้นจำเพา	๗ มี.ค. ๒๕๔๕
split type air conditioner	เครื่องปรับอากาศแบบแยกส่วน	๗ มี.ค. ๒๕๔๕
splitter damper	ชุดแผ่นปรับแบ่งลม	๗ มี.ค. ๒๕๔๕
spread	มุมแผ่กระจาย	๗ มี.ค. ๒๕๔๕
square elbow	ท่อเหลี่ยมหักฉาก	๗ มี.ค. ๒๕๔๕
stack effect; chimney effect	ปรากฏการณ์ลมลอยตัว	๗ มี.ค. ๒๕๔๕
stamped grille; perforated grille	ช่องลมแบบหน้าพรุน	๗ มี.ค. ๒๕๔๕
standard air	อากาศมาตรฐาน	๗ มี.ค. ๒๕๔๕
standard conditions	ภาวะมาตรฐาน	๗ มี.ค. ๒๕๔๕
standard rating conditions	ภาวะค่าประเมินมาตรฐาน	๗ มี.ค. ๒๕๔๕
standard rating	ค่าประเมินมาตรฐาน	๗ มี.ค. ๒๕๔๕
start capacitor	ตัวเก็บประจุเมื่อเริ่มทำงาน	๗ มี.ค. ๒๕๔๕
static head	ลำความดันสถิต	๗ มี.ค. ๒๕๔๕
static pressure	ความดันสถิต	๗ มี.ค. ๒๕๔๕
static regain	ความดันสถิตกลับคืน	๗ มี.ค. ๒๕๔๕
steady state condition	ภาวะสถานะคงตัว	๗ มี.ค. ๒๕๔๕
step control	การควบคุมขั้นตอน	๗ มี.ค. ๒๕๔๕
stepping motor	มอเตอร์แบบขั้น	๗ มี.ค. ๒๕๔๕
stop valve	วาล์วปิดเปิด	๗ มี.ค. ๒๕๔๕
strainer	ชุดดักผง	๗ มี.ค. ๒๕๔๕
stuffing box	ชุดกันรั่ว	๗ มี.ค. ๒๕๔๕
subcooling	การทำให้เย็นยิ่ง	๗ มี.ค. ๒๕๔๕
suction accumulator	ถังพักด้านดูด	๗ มี.ค. ๒๕๔๕
suction head	ลำความดันด้านดูด	๗ มี.ค. ๒๕๔๕
suction inlet	ทางดูดเข้า	๗ มี.ค. ๒๕๔๕
suction line; suction tube	ท่อดูดแก๊สเย็น	๗ มี.ค. ๒๕๔๕
suction pressure	ความดันด้านดูด	๗ มี.ค. ๒๕๔๕
suction temperature	อุณหภูมิด้านดูด	๗ มี.ค. ๒๕๔๕
suction tube; suction line	ท่อดูดแก๊สเย็น	๗ มี.ค. ๒๕๔๕
suction valve	วาล์วด้านดูด	๗ มี.ค. ๒๕๔๕
superheat	ความร้อนยวดยิ่ง	๗ มี.ค. ๒๕๔๕
superheated gas	แก๊สร้อนยวดยิ่ง	๗ มี.ค. ๒๕๔๕
superheated vapour	ไอร้อนยวดยิ่ง	๗ มี.ค. ๒๕๔๕
supply air	ลมจ่าย	๗ มี.ค. ๒๕๔๕
supply fan	พัดลมจ่าย	๗ มี.ค. ๒๕๔๕
supply grille	ช่องลมจ่าย	๗ มี.ค. ๒๕๔๕
surface cooling	การทำความเย็นด้วยผิวเย็น	๗ มี.ค. ๒๕๔๕
surface dehumidifier	อุปกรณ์ลดความชื้นด้วยผิวเย็น	๗ มี.ค. ๒๕๔๕
surface film conductance	ความนำความร้อนแผ่นบางที่ผิว	๗ มี.ค. ๒๕๔๕
surge drum	หม้อลดจังหวะความดัน	๗ มี.ค. ๒๕๔๕
sweating	การเกิดหยาดน้ำ	๗ มี.ค. ๒๕๔๕
swash plate rotary compressor	เครื่องอัดแก๊สทำความเย็นแบบหมุนกวาด, คอมเพรสเซอร์แบบหมุนกวาด	๗ มี.ค. ๒๕๔๕
swing motor	มอเตอร์ส่ายลม	๗ มี.ค. ๒๕๔๕
synchronous motor	มอเตอร์สมวาร, ซิงโครนัสมอเตอร์	๗ มี.ค. ๒๕๔๕
synchronous speed	อัตราเร็วสมวาร	๗ มี.ค. ๒๕๔๕
system refrigerating effect	ผลทำความเย็นของระบบ	๗ มี.ค. ๒๕๔๕
temperature drop	อุณหภูมิลด	๗ มี.ค. ๒๕๔๕
tempering coil; reheating coil	คอยล์อุ่นอากาศ	๗ มี.ค. ๒๕๔๕
temperature rise	อุณหภูมิเพิ่ม	๗ มี.ค. ๒๕๔๕
temperature swing	อุณหภูมิแกว่ง	๗ มี.ค. ๒๕๔๕
terminal unit	ชุดจ่ายลมปลายทาง	๗ มี.ค. ๒๕๔๕
theoretical displacement	ปริมาตรกระจัดทางทฤษฎี	๗ มี.ค. ๒๕๔๕
thermal bulb	กระเปาะวัดความร้อน	๗ มี.ค. ๒๕๔๕
thermal conductance	ความนำความร้อน	๗ มี.ค. ๒๕๔๕
thermal conduction	การนำความร้อน	๗ มี.ค. ๒๕๔๕
thermal conductivity	สภาพนำความร้อน	๗ มี.ค. ๒๕๔๕
thermal conductor	ตัวนำความร้อน	๗ มี.ค. ๒๕๔๕
thermal convection	การพาความร้อน	๗ มี.ค. ๒๕๔๕
thermal insulation	ฉนวนความร้อน	๗ มี.ค. ๒๕๔๕
thermal radiation	การแผ่รังสีความร้อน	๗ มี.ค. ๒๕๔๕
thermal resistance	ความต้านทานความร้อน	๗ มี.ค. ๒๕๔๕
thermal resistivity	สภาพต้านทานความร้อน	๗ มี.ค. ๒๕๔๕
thermal valve	วาล์วความร้อน	๗ มี.ค. ๒๕๔๕
thermostat	เทอร์มอสแตต	๗ มี.ค. ๒๕๔๕
thermostatic expansion valve	วาล์วระเหยสารทำความเย็นแบบทำงานด้วยอุณหภูมิ	๗ มี.ค. ๒๕๔๕
throw	ระยะพุ่ง (ของลม)	๗ มี.ค. ๒๕๔๕
timer motor	มอเตอร์เวลา	๗ มี.ค. ๒๕๔๕
ton of refrigeration (TR)	ตันความเย็น	๗ มี.ค. ๒๕๔๕
total cooling effect	ผลทำความเย็นรวม	๗ มี.ค. ๒๕๔๕
total dynamic head	ลำความดันพลวัตรวม	๗ มี.ค. ๒๕๔๕
total head	ลำความดันรวม	๗ มี.ค. ๒๕๔๕
total pressure	ความดันรวม	๗ มี.ค. ๒๕๔๕
total volumetric efficiency	ประสิทธิภาพเชิงปริมาตรรวม	๗ มี.ค. ๒๕๔๕
total heat gain	ความร้อนรับรวม	๗ มี.ค. ๒๕๔๕
TR (ton of refrigeration)	ตันความเย็น	๗ มี.ค. ๒๕๔๕
transmission heat gain	ความร้อนรับผ่านมวล	๗ มี.ค. ๒๕๔๕
treated water	น้ำปรับคุณภาพ	๗ มี.ค. ๒๕๔๕
tube insulation	ฉนวนรูปท่อ	๗ มี.ค. ๒๕๔๕
tube-in-tube condenser	เครื่องควบแน่นแบบท่อสวมซ้อน	๗ มี.ค. ๒๕๔๕
tubeaxial fan	พัดลมติดตั้งในท่อกลม	๗ มี.ค. ๒๕๔๕
turbo fan; booster fan	พัดลมเสริมกำลัง	๗ มี.ค. ๒๕๔๕
two position control	การควบคุมแบบสองตำแหน่ง	๗ มี.ค. ๒๕๔๕
u-bend	ข้องอรูปตัวยู	๗ มี.ค. ๒๕๔๕
uncased coil	คอยล์เปลือย	๗ มี.ค. ๒๕๔๕
uniform corrosion	การกัดกร่อนทั่วไป	๗ มี.ค. ๒๕๔๕
unitary air conditioner	เครื่องปรับอากาศรวมหน่วย	๗ มี.ค. ๒๕๔๕
unloader	อุปกรณ์ลดการอัดคอมเพรสเซอร์	๗ มี.ค. ๒๕๔๕
unsaturated air	อากาศไม่อิ่มตัว	๗ มี.ค. ๒๕๔๕
vacuum pump	ปั๊มสุญญากาศ	๗ มี.ค. ๒๕๔๕
vane rotary compressor	เครื่องอัดแก๊สทำความเย็นแบบใบหมุน, คอมเพรสเซอร์แบบใบหมุน	๗ มี.ค. ๒๕๔๕
vaneaxial fan	พัดลมมีใบนำร่องติดตั้งในท่อกลม	๗ มี.ค. ๒๕๔๕
vapour barrier	แผ่นกั้นไอ	๗ มี.ค. ๒๕๔๕
vapour lock	การปิดกั้นด้วยไอ	๗ มี.ค. ๒๕๔๕
vapour pressure	ความดันไอ	๗ มี.ค. ๒๕๔๕
variable air volume system; VAV system	ระบบลมจ่ายแปรเปลี่ยน, ระบบวีเอวี	๗ มี.ค. ๒๕๔๕
VAV system; variable air volume system	ระบบวีเอวี, ระบบลมจ่ายแปรเปลี่ยน	๗ มี.ค. ๒๕๔๕
velocity head	ลำความดันความเร็ว	๗ มี.ค. ๒๕๔๕
velocity pressure	ความดันความเร็ว	๗ มี.ค. ๒๕๔๕
velometer	มาตรความเร็วลม	๗ มี.ค. ๒๕๔๕
ventilation	การระบายอากาศ	๗ มี.ค. ๒๕๔๕
ventilation air	ลมถ่ายเท	๗ มี.ค. ๒๕๔๕
vibration isolator	อุปกรณ์ลดการสั่นสะเทือน	๗ มี.ค. ๒๕๔๕
walk-in refrigerator	ตู้เย็นแบบเดินเข้าได้	๗ มี.ค. ๒๕๔๕
wall mounted	-ติดผนัง	๗ มี.ค. ๒๕๔๕
wall section	หน้าตัดผนัง	๗ มี.ค. ๒๕๔๕
wall solar azimuth angle	มุมภาคทิศดวงอาทิตย์ของผนัง	๗ มี.ค. ๒๕๔๕
water chiller	เครื่องทำน้ำเย็น	๗ มี.ค. ๒๕๔๕
water conditioning; water treatment	การปรับคุณภาพน้ำ	๗ มี.ค. ๒๕๔๕
water cooler	ตู้น้ำเย็น	๗ มี.ค. ๒๕๔๕
water regulator valve	วาล์วควบคุมน้ำ	๗ มี.ค. ๒๕๔๕
water treatment; water conditioning	การปรับคุณภาพน้ำ	๗ มี.ค. ๒๕๔๕
water vapour	ไอน้ำแฝง	๗ มี.ค. ๒๕๔๕
water vapour pressure	ความดันไอน้ำแฝง	๗ มี.ค. ๒๕๔๕
water-cooled condenser	เครื่องควบแน่นระบายความร้อนด้วยน้ำ	๗ มี.ค. ๒๕๔๕
water-cooled condensing unit	ชุดควบแน่นระบายความร้อนด้วยน้ำ	๗ มี.ค. ๒๕๔๕
water-cooling tower	หอทำความเย็นด้วยน้ำ	๗ มี.ค. ๒๕๔๕
wax	ไข	๗ มี.ค. ๒๕๔๕
welded hermetic compressor	เครื่องอัดแก๊สทำความเย็นแบบเชื่อมปิด, คอมเพรสเซอร์แบบเชื่อมปิด	๗ มี.ค. ๒๕๔๕
welded joint	รอยต่อเชื่อม	๗ มี.ค. ๒๕๔๕
wet coil; wetted coil	คอยล์เปียก	๗ มี.ค. ๒๕๔๕
wet-bulb depression temperature	อุณหภูมิลดกระเปาะเปียก	๗ มี.ค. ๒๕๔๕
wet-bulb temperature	อุณหภูมิกระเปาะเปียก	๗ มี.ค. ๒๕๔๕
wetted coil; wet coil	คอยล์เปียก	๗ มี.ค. ๒๕๔๕
windage loss	น้ำสูญตามลม	๗ มี.ค. ๒๕๔๕
wire duct	ท่อใหญ่ร้อยสายไฟ	๗ มี.ค. ๒๕๔๕
wiredrawing	การไหลรีด	๗ มี.ค. ๒๕๔๕
wiring diagram; wiring schematics	แผนภาพระบบไฟฟ้า	๗ มี.ค. ๒๕๔๕
wiring schematics; wiring diagram	แผนภาพระบบไฟฟ้า	๗ มี.ค. ๒๕๔๕
wye delta starter; y-delta starter	สตาร์ตเตอร์แบบวาย-เดลตา	๗ มี.ค. ๒๕๔๕
wye strainer; y-strainer	ชุดดักผงแบบวาย	๗ มี.ค. ๒๕๔๕
x-section; cross section	ภาคตัดขวาง	๗ มี.ค. ๒๕๔๕
y-delta starter; wye-delta starter	สตาร์ตเตอร์แบบวาย-เดลตา	๗ มี.ค. ๒๕๔๕
y-strainer; wye strainer	ชุดดักผงแบบวาย	๗ มี.ค. ๒๕๔๕
zone damper	ชุดแผ่นปรับลมแบ่งเขต	๗ มี.ค. ๒๕๔๕
zone of maximum crystal formation	เขตก่อเกิดผลึกสูงสุด	๗ มี.ค. ๒๕๔๕
ลม, อากาศ	air	๗ มี.ค. ๒๕๔๕
ลมเหนี่ยวนำ	induced air	๗ มี.ค. ๒๕๔๕
ลมรั่วเข้าห้อง	infiltration	๗ มี.ค. ๒๕๔๕
ลมรั่วจากห้อง	exfiltration	๗ มี.ค. ๒๕๔๕
ลมเลี่ยง	bypass air	๗ มี.ค. ๒๕๔๕
ลมเติม	make-up air	๗ มี.ค. ๒๕๔๕
ลมเป่าเข้า	forced draft	๗ มี.ค. ๒๕๔๕
ลมหมุนเวียน	circulating air	๗ มี.ค. ๒๕๔๕
ลมหมุนเวียนกลับ	recirculated air	๗ มี.ค. ๒๕๔๕
ลมกลับ	return air	๗ มี.ค. ๒๕๔๕
ลมจ่าย	supply air	๗ มี.ค. ๒๕๔๕
ลมดูด, ลมเป่า	draft	๗ มี.ค. ๒๕๔๕
ลมดูดออก	induced draft	๗ มี.ค. ๒๕๔๕
ลมถ่ายเท	ventilation air	๗ มี.ค. ๒๕๔๕
ลมถ่ายออก	exhaust air	๗ มี.ค. ๒๕๔๕
ลมธรรมชาติ	natural draft	๗ มี.ค. ๒๕๔๕
ลมปล่อย	discharge air	๗ มี.ค. ๒๕๔๕
ลมปฐมภูมิ	primary air	๗ มี.ค. ๒๕๔๕
ลมผสม	mixed air	๗ มี.ค. ๒๕๔๕
ละอองลอย	aerosol	๗ มี.ค. ๒๕๔๕
ละติจูด	latitude	๗ มี.ค. ๒๕๔๕
ล้อเครื่องเป่าลม	blower wheel	๗ มี.ค. ๒๕๔๕
ล้อพัดลม	fan wheel	๗ มี.ค. ๒๕๔๕
ลักษณะเฉพาะ	characteristic	๗ มี.ค. ๒๕๔๕
ลิเคอร์	liquor	๗ มี.ค. ๒๕๔๕
ลำความดัน [ของของไหล]	head	๗ มี.ค. ๒๕๔๕
ลำความดันรวม	total head	๗ มี.ค. ๒๕๔๕
ลำความดันเสียดทาน	friction head	๗ มี.ค. ๒๕๔๕
ลำความดันสถิต	static head	๗ มี.ค. ๒๕๔๕
ลำความดันความเร็ว	velocity head	๗ มี.ค. ๒๕๔๕
ลำความดันด้านดูด	suction head	๗ มี.ค. ๒๕๔๕
ลำความดันพลวัต	dynamic head	๗ มี.ค. ๒๕๔๕
ลำความดันพลวัตรวม	total dynamic head	๗ มี.ค. ๒๕๔๕
ไมครอน	micron	๗ มี.ค. ๒๕๔๕
ไฮโดรคาร์บอน	hydrocarbon	๗ มี.ค. ๒๕๔๕
ไฮโดรคลอโรฟลูออโรคาร์บอน (เอชซีเอฟซี)	hydrochlorofluorocarbon (HCFC)	๗ มี.ค. ๒๕๔๕
ไฮโดรฟลูออโรคาร์บอน (เอชเอฟซี)	hydrofluorocarbon (HFC)	๗ มี.ค. ๒๕๔๕
ไออิ่มตัว	saturated vapout	๗ มี.ค. ๒๕๔๕
ไอน้ำยวดยิ่ง	superheated vapour	๗ มี.ค. ๒๕๔๕
ไอน้ำแฝง	water vapour	๗ มี.ค. ๒๕๔๕
ไกลคอล	glycol	๗ มี.ค. ๒๕๔๕
ไข	wax	๗ มี.ค. ๒๕๔๕
ไครโอไฮเดรต	cryhydrate	๗ มี.ค. ๒๕๔๕
ไซโครเมตรี	psychrometry	๗ มี.ค. ๒๕๔๕
ไซโครมิเตอร์, มาตรความชื้นสัมพัทธ์แบบกระเปาะเปียก-แห้ง	psychrometer	๗ มี.ค. ๒๕๔๕
กระแสลม	air stream	๗ มี.ค. ๒๕๔๕
กระเปาะวัดความร้อน	thermal bulb	๗ มี.ค. ๒๕๔๕
กระบวนการแอเดียแบติก	adiabatic process	๗ มี.ค. ๒๕๔๕
กระบอกลดเสียง	muffler	๗ มี.ค. ๒๕๔๕
กะบังพัดลม	fan shroud	๗ มี.ค. ๒๕๔๕
ก้านสูบ	connecting rod	๗ มี.ค. ๒๕๔๕
-กัดกร่อน	corrosive	๗ มี.ค. ๒๕๔๕
กันรั่วเชิงกล	mechanical seal	๗ มี.ค. ๒๕๔๕
กันรั่วแบบอัด	packing seal	๗ มี.ค. ๒๕๔๕
กันรั่วเพลา	shaft seal	๗ มี.ค. ๒๕๔๕
กันสาด	overhang	๗ มี.ค. ๒๕๔๕
กับดักเสียง	sound trap	๗ มี.ค. ๒๕๔๕
กับดักน้ำมันหล่อลื่น	oil trap	๗ มี.ค. ๒๕๔๕
การแยกสลายด้วยน้ำ	hydrolysis	๗ มี.ค. ๒๕๔๕
การระเหย	evaporation	๗ มี.ค. ๒๕๔๕
การระเหยสารทำความเย็นโดยตรง	direct expansion	๗ มี.ค. ๒๕๔๕
การระเหยสารทำความเย็นแบบหลายขั้น	multistage expansion	๗ มี.ค. ๒๕๔๕
การระเหยสารทำความเย็นหมดพอดี	dry expansion	๗ มี.ค. ๒๕๔๕
การระบายอากาศ	ventilation	๗ มี.ค. ๒๕๔๕
การระบุพัดลม	fan designation	๗ มี.ค. ๒๕๔๕
การรับช่วงคุมแทน	overriding	๗ มี.ค. ๒๕๔๕
การแล่นประสาน	brazing	๗ มี.ค. ๒๕๔๕
การเก็บเย็น; ห้องเย็น	cold storage	๗ มี.ค. ๒๕๔๕
การเกิดโพรง (ในของเหลว)	cavitation	๗ มี.ค. ๒๕๔๕
การเกิดหยาดน้ำ	sweating	๗ มี.ค. ๒๕๔๕
การเกิดฟอง	foaming	๗ มี.ค. ๒๕๔๕
การใช้แผ่นกระจกกับอาคาร	glazing	๗ มี.ค. ๒๕๔๕
การใช้ประโยชน์คืนจากความร้อน	heat reclaim	๗ มี.ค. ๒๕๔๕
การเทียบมาตรฐาน	calibration	๗ มี.ค. ๒๕๔๕
การเปลี่ยนความดันทางออกของวาล์วระเหยสารทำความเย็น	pressure change of expansion valve	๗ มี.ค. ๒๕๔๕
การเปลี่ยนค่าความร้อนยวดยิ่งของวาล์วระเหยสารทำความเย็น	expansion valve superheat change	๗ มี.ค. ๒๕๔๕
การเพิ่มจุดน้ำค้า	dew-point rise	๗ มี.ค. ๒๕๔๕
การหมุนเวียนลม	air circulation	๗ มี.ค. ๒๕๔๕
การส่งผ่านความร้อน	heat transmission	๗ มี.ค. ๒๕๔๕
การสูบไล่ (สารทำความเย็น)	pump out	๗ มี.ค. ๒๕๔๕
การสูบถ่าย (สารทำความเย็น)	pump down	๗ มี.ค. ๒๕๔๕
การหล่อด้วยของเหลว	jacketing	๗ มี.ค. ๒๕๔๕
การอัด	compression	๗ มี.ค. ๒๕๔๕
การอัดแบบหลายขั้น	multistage compression	๗ มี.ค. ๒๕๔๕
การอัดประกอบ	compound compression	๗ มี.ค. ๒๕๔๕
การละลายน้ำแข็งอัตโนมัติ	automatic defrost	๗ มี.ค. ๒๕๔๕
การละลายน้ำแข็งด้วยแก๊สร้อน	hot gas defrosting	๗ มี.ค. ๒๕๔๕
การละลายน้ำแข็งด้วยกึ่งอัตโนมัติ	semi-automatic defrost	๗ มี.ค. ๒๕๔๕
การละลายน้ำแข็งปรับด้วยมือ	manual defrost	๗ มี.ค. ๒๕๔๕
การลดความชื้น	dehumidification	๗ มี.ค. ๒๕๔๕
การไหลรีด	wiredrawing	๗ มี.ค. ๒๕๔๕
การไหลแบบขนาน	parallel flow	๗ มี.ค. ๒๕๔๕
การไหลสวนทาง	counterflow	๗ มี.ค. ๒๕๔๕
การไหลข้ามข้าง	cross-flow	๗ มี.ค. ๒๕๔๕
การไหลของลม	air flow	๗ มี.ค. ๒๕๔๕
การไล่แก๊ส	purging	๗ มี.ค. ๒๕๔๕
การกระทำแบบสัดส่วน	proportional action	๗ มี.ค. ๒๕๔๕
การกระทำแบบอินทิกรับ	integral action	๗ มี.ค. ๒๕๔๕
การกระทำแบบอนุพันธ์	derivative action	๗ มี.ค. ๒๕๔๕
การกรองละอองธุลี	particulate filtration	๗ มี.ค. ๒๕๔๕
การกัดกร่อนทั่วไป	uniform corrosion	๗ มี.ค. ๒๕๔๕
การกัดกร่อนทั่วไป	uniform corrosion	๗ มี.ค. ๒๕๔๕
การกันภาระเกิน	overload protection	๗ มี.ค. ๒๕๔๕
การกัดกร่อน	corrosion	๗ มี.ค. ๒๕๔๕
การกัดกร่อนแกลแวนิก	galvanic corrosion	๗ มี.ค. ๒๕๔๕
การกัดกร่อนแบบเซาะลึก	erosion corrosion	๗ มี.ค. ๒๕๔๕
การกัดกร่อนเป็นหลุม	pitting corrosing	๗ มี.ค. ๒๕๔๕
การขับตรง	direct drive	๗ มี.ค. ๒๕๔๕
การขจัดตะกรัน	descaling	๗ มี.ค. ๒๕๔๕
การขจัดน้ำ	dehydration	๗ มี.ค. ๒๕๔๕
การควบแน่น	condensation	๗ มี.ค. ๒๕๔๕
การควบคุม	control	๗ มี.ค. ๒๕๔๕
การควบคุมภาวะหลับ	sleep mode control	๗ มี.ค. ๒๕๔๕
การควบคุมเชิงอเล็กอรานิกส์	electronic control	๗ มี.ค. ๒๕๔๕
การควบคุมเชิงไฟฟ้า	electric control	๗ มี.ค. ๒๕๔๕
การควบคุมแบบสองตำแหน่ง	two position control	๗ มี.ค. ๒๕๔๕
การควบคุมแบบสัดส่วน	proportional control	๗ มี.ค. ๒๕๔๕
การควบคุมแบบอินทิกรัล	integral control	๗ มี.ค. ๒๕๔๕
การควบคุมแบบอนุพันธ์	derivative control	๗ มี.ค. ๒๕๔๕
การควบคุมแบบลมอัด	pneumatic control	๗ มี.ค. ๒๕๔๕
การควบคุมแบบต่อเนื่อง	modulating control	๗ มี.ค. ๒๕๔๕
การควบคุมแบบปิด-เปิด	on-off contrlo	๗ มี.ค. ๒๕๔๕
การควบคุมวิสัยสามารถ	capacity control	๗ มี.ค. ๒๕๔๕
การควบคุมลำดับขั้นตอน	sequence control	๗ มี.ค. ๒๕๔๕
การควบคุมขั้นตอน	step control	๗ มี.ค. ๒๕๔๕
การควบคุมความชื้น	humidity control	๗ มี.ค. ๒๕๔๕
การควบคุมด้วยมือ	manual control	๗ มี.ค. ๒๕๔๕
การควบคุมทวิภาวะ	dual effect control	๗ มี.ค. ๒๕๔๕
การควบคุมปริมาณลม	air volume control	๗ มี.ค. ๒๕๔๕
การจัดวงจรในคอยล์	coil circuiting	๗ มี.ค. ๒๕๔๕
การจัดตำแหน่งขับพัดลม	fan arrangement; fan drive arrangement	๗ มี.ค. ๒๕๔๕
การดูดกลืน	absorption	๗ มี.ค. ๒๕๔๕
การดูดความชั้น	desication	๗ มี.ค. ๒๕๔๕
การดูดซับ	adsorption	๗ มี.ค. ๒๕๔๕
การต่อแบบปลายบาน	flare connection	๗ มี.ค. ๒๕๔๕
การต่อข้าม	cross connection	๗ มี.ค. ๒๕๔๕
การถ่ายโอนความร้อน	heat transfer	๗ มี.ค. ๒๕๔๕
การทำให้เย็นยิ่ง	subcooling	๗ มี.ค. ๒๕๔๕
การทำให้เยือกแข็ง	freezing	๗ มี.ค. ๒๕๔๕
การทำให้เป็นของเหลว	liquefaction	๗ มี.ค. ๒๕๔๕
การทำละออง	atomisation; atomization	๗ มี.ค. ๒๕๔๕
การทำความเย็น; วิชาการทำความเย็น	refrigeration	๗ มี.ค. ๒๕๔๕
การทำความเย็นแบบระเหย	evaporative cooling	๗ มี.ค. ๒๕๔๕
การทำความเย็นสบาย	comfort cooling	๗ มี.ค. ๒๕๔๕
การทำความเย็นจากความร้อนปล่อยทิ้ง	regenerative cooling	๗ มี.ค. ๒๕๔๕
การทำความเย็นด้วยผิวเย็น	surface cooling	๗ มี.ค. ๒๕๔๕
การทำงานเป็นรอบ	cycling	๗ มี.ค. ๒๕๔๕
การทำงานเป็นรอบถี่	short cycling	๗ มี.ค. ๒๕๔๕
การนำความร้อน	thermal conduction	๗ มี.ค. ๒๕๔๕
การบ่ายเบนของดวงอาทิตย์	declination of sun	๗ มี.ค. ๒๕๔๕
การบุภายใน	lining	๗ มี.ค. ๒๕๔๕
การประจุ	charging	๗ มี.ค. ๒๕๔๕
การปรับแนว	alibnment	๗ มี.ค. ๒๕๔๕
การปรับอากาศ	air conditioning	๗ มี.ค. ๒๕๔๕
การปรับอากาศเชิงอุตสาหกรรม	industrial air conditioning	๗ มี.ค. ๒๕๔๕
การปรับอากาศเพื่อความสบาย	comfort air conditioning	๗ มี.ค. ๒๕๔๕
การปรับคืนช่วงกลางคืน	night setback	๗ มี.ค. ๒๕๔๕
การปรับคุณภาพน้ำ	water conditioning; water treatment	๗ มี.ค. ๒๕๔๕
การปรับดุล	balancing	๗ มี.ค. ๒๕๔๕
การปิดกั้นด้วยไอ	vapour lock	๗ มี.ค. ๒๕๔๕
การผลัดเปลี่ยนลม	air change	๗ มี.ค. ๒๕๔๕
การผึ่งลม	aeration	๗ มี.ค. ๒๕๔๕
กำลัง	power	๗ มี.ค. ๒๕๔๕
กำลังที่ใช้ไป	power consumption	๗ มี.ค. ๒๕๔๕
กล่องลม	plenum chamber	๗ มี.ค. ๒๕๔๕
กล่องลดเสียง	attenuator; sound attenuator	๗ มี.ค. ๒๕๔๕
กล่องควบคุม	control box	๗ มี.ค. ๒๕๔๕
กล่องจ่ายลม	discharge plenum	๗ มี.ค. ๒๕๔๕
กล่องผสมลม	maixing box	๗ มี.ค. ๒๕๔๕
กฎสัมพรรคภาพ	affinity laws	๗ มี.ค. ๒๕๔๕
กฎความดันย่อยของดอลตัน	Dalton’s law of partial pressure	๗ มี.ค. ๒๕๔๕
กฎพัดลม	fan laws	๗ มี.ค. ๒๕๔๕
ข้อรัด	clamp	๗ มี.ค. ๒๕๔๕
ข้อลดแบบเยื้องศูนย์กลาง	eccentric reducer	๗ มี.ค. ๒๕๔๕
ข้อลดแบบร่วมศูนย์กลาง	concentric reducer	๗ มี.ค. ๒๕๔๕
ข้องอรูปตัวยู	u-bend	๗ มี.ค. ๒๕๔๕
ข้อต่ออ่อน	flexible connector	๗ มี.ค. ๒๕๔๕
ขอลวด; คอยล์, ท่อขด	coil	๗ มี.ค. ๒๕๔๕
ของเหลวทำความเย็น	refrigerant liquid	๗ มี.ค. ๒๕๔๕
ของเหลวผลควบแน่น	condensate	๗ มี.ค. ๒๕๔๕
ของไหลรับถ่ายโอนความร้อน	heat transfer fluid	๗ มี.ค. ๒๕๔๕
ของไหลทุติยภูมิ	secondary fluid	๗ มี.ค. ๒๕๔๕
ของไหลปฐมภูมิ	primary fluid	๗ มี.ค. ๒๕๔๕
ขดลวดโซเลนอยด์	solenoid coil	๗ มี.ค. ๒๕๔๕
ครอบกันฝน	rain shield	๗ มี.ค. ๒๕๔๕
ครีบ	fin	๗ มี.ค. ๒๕๔๕
ความเร็ววิกฤต	critical velocity	๗ มี.ค. ๒๕๔๕
ความเร็วลมหน้าคอยล์	face velocity	๗ มี.ค. ๒๕๔๕
ความร้อน	heat	๗ มี.ค. ๒๕๔๕
ความร้อนรับ	heat gain	๗ มี.ค. ๒๕๔๕
ความร้อนรับรวม	total heat gain	๗ มี.ค. ๒๕๔๕
ความร้อนรับภายใน	internal heat gain	๗ มี.ค. ๒๕๔๕
ความร้อนรับจากดวงอาทิตย์	solar heat gain	๗ มี.ค. ๒๕๔๕
ความร้อนรับผ่านมวล	transmission heat gain	๗ มี.ค. ๒๕๔๕
ความร้อนภายใน	internal heat	๗ มี.ค. ๒๕๔๕
ความร้อนแฝง	latent heat	๗ มี.ค. ๒๕๔๕
ความร้อนแฝงของการระเหย	latent heat of evaporation	๗ มี.ค. ๒๕๔๕
ความร้อนแฝงของการหลอม	latent heat of fusion	๗ มี.ค. ๒๕๔๕
ความร้อนสัมผัส	sensible heat	๗ มี.ค. ๒๕๔๕
ความร้อนสูญเสีย	heat loss	๗ มี.ค. ๒๕๔๕
ความร้อนของเครื่องใช้	appliances heat	๗ มี.ค. ๒๕๔๕
ความร้อนของการหลอม	heat of fusion	๗ มี.ค. ๒๕๔๕
ความร้อนจำเพาะ	specific heat	๗ มี.ค. ๒๕๔๕
ความร้อนจากไฟส่องสว่าง	lighting heat	๗ มี.ค. ๒๕๔๕
ความร้อนจากคน	people heat	๗ มี.ค. ๒๕๔๕
ความยาวสมมูล	equivalent length	๗ มี.ค. ๒๕๔๕
ความเปล่งรังสี	emittance	๗ มี.ค. ๒๕๔๕
ความสูงคอยล์	coil height	๗ มี.ค. ๒๕๔๕
ความลาดเอียง	pitch	๗ มี.ค. ๒๕๔๕
ความลึกคอยล์	coil depth	๗ มี.ค. ๒๕๔๕
ความจุกระบอกสูบ	piston displancement	๗ มี.ค. ๒๕๔๕
ความชื้น	humidity	๗ มี.ค. ๒๕๔๕
ความชื้น	moisture	๗ มี.ค. ๒๕๔๕
ความชื้นรับ	moisture gain	๗ มี.ค. ๒๕๔๕
ความชื้นรับเพิ่ม	moisture regain	๗ มี.ค. ๒๕๔๕
ความชื้นเป็นร้อยละ	percentage humidity	๗ มี.ค. ๒๕๔๕
ความชื้นสัมบูรณ์	absolute humidity	๗ มี.ค. ๒๕๔๕
ความชื้นสัมพัทธ์	relative humidity	๗ มี.ค. ๒๕๔๕
ความชื้นลอดผ่าน	moisture carry-over	๗ มี.ค. ๒๕๔๕
ความชื้นจำเพาะ	specificd humidity	๗ มี.ค. ๒๕๔๕
ความดัน	pressure	๗ มี.ค. ๒๕๔๕
ความดันรวม	total pressure	๗ มี.ค. ๒๕๔๕
ความดันย่อย	partial pressure	๗ มี.ค. ๒๕๔๕
ความดันเกจ	gauge pressure	๗ มี.ค. ๒๕๔๕
ความดันวัดได้	developed pressure	๗ มี.ค. ๒๕๔๕
ความดันวิกฤต	critical pressure	๗ มี.ค. ๒๕๔๕
ความดันสมดุล	eauilibrium pressure	๗ มี.ค. ๒๕๔๕
ความดันส่วนต่าง	differential pressure	๗ มี.ค. ๒๕๔๕
ความดันสัมบูรณ์	absolute pressure	๗ มี.ค. ๒๕๔๕
ความดันสูญเสีย	pressure loss	๗ มี.ค. ๒๕๔๕
ความดันสถิต	static pressure	๗ มี.ค. ๒๕๔๕
ความดันสถิตกลับคืน	static regain	๗ มี.ค. ๒๕๔๕
ความดันเกจ	gauge pressure	๗ มี.ค. ๒๕๔๕
ความดันเครื่องควบแน่น	condensing pressure	๗ มี.ค. ๒๕๔๕
ความดันเความเร็ว	velocity pressure	๗ มี.ค. ๒๕๔๕
ความดันอิ่มตัว	saturation pressure	๗ มี.ค. ๒๕๔๕
ความดันอุทกสถิต	hydrostatic pressure	๗ มี.ค. ๒๕๔๕
ความดันลด	pressure drop	๗ มี.ค. ๒๕๔๕
ความดันลด [จากความเสียดทาน]	friction drop; friction loss	๗ มี.ค. ๒๕๔๕
ความดันลดในท่อ	line loss	๗ มี.ค. ๒๕๔๕
ความดันไอ	vapour presure	๗ มี.ค. ๒๕๔๕
ความดันไอน้ำแฝง	water vapour pressure	๗ มี.ค. ๒๕๔๕
ความดันกำหนดใช้งาน	design working pressure	๗ มี.ค. ๒๕๔๕
ความดันกำหนดใช้งาน	design working pressure	๗ มี.ค. ๒๕๔๕
ความดันขณะทำงาน	operating pressure	๗ มี.ค. ๒๕๔๕
ความดันด้านจ่าย	discharge pressure	๗ มี.ค. ๒๕๔๕
ความดันด้านดูด	suction pressure	๗ มี.ค. ๒๕๔๕
ความดันดุล	balance pressure	๗ มี.ค. ๒๕๔๕
ความดันต้านกลับ	back pressure	๗ มี.ค. ๒๕๔๕
ความดันทางออก	outlet pressure	๗ มี.ค. ๒๕๔๕
ความดันบรรยากาศ	atmospheric pressure	๗ มี.ค. ๒๕๔๕
ความต้านทานความร้อน	thermal resistance	๗ มี.ค. ๒๕๔๕
ความนำความร้อน	thermal conductance	๗ มี.ค. ๒๕๔๕
ความนำความร้อนแผ่นบางที่ผิว	surface film conductance	๗ มี.ค. ๒๕๔๕
ค่าส่วนต่าง	differential	๗ มี.ค. ๒๕๔๕
ค่าอุปสงค์	demand charge	๗ มี.ค. ๒๕๔๕
ค่าการถ่ายโอนความร้อนของหลังคา (อาร์ทีทีวี)	roof thermal transfer value (RTTV)	๗ มี.ค. ๒๕๔๕
ค่าการถ่ายดอนความรอ้นรวบยอด (โอทีทีวี)	overall thermal transfer value (OTTV)	๗ มี.ค. ๒๕๔๕
ค่าความร้อนยวดยิ่งของวาล์วระเหยสารทำความเย็น	expansion valve superheat	๗ มี.ค. ๒๕๔๕
ค่าคงตัวแสงอาทิตย์	solar constan	๗ มี.ค. ๒๕๔๕
ค่าประเมิน; อัตรา	rating	๗ มี.ค. ๒๕๔๕
ค่าประเมินรับรอง	published rating	๗ มี.ค. ๒๕๔๕
ค่าประเมินมาตรฐาน	standard rating	๗ มี.ค. ๒๕๔๕
ค่าประเมินใช้งานจริง	application rating	๗ มี.ค. ๒๕๔๕
ค่าประเมินวิสัยสามารถ	capacity rating	๗ มี.ค. ๒๕๔๕
คอมเพรสเซอร์, เครื่องอัดแก๊สทำความเย็น; เครื่องอัดแก๊ส	compressor	๗ มี.ค. ๒๕๔๕
คอมเพรสเซอร์เบบเกลียว, เครื่องอัดแก๊สทำความเย็นแบบเกลียว	screw compressor	๗ มี.ค. ๒๕๔๕
คอมเพรสเซอร์แบบเกลียวหมุน, เครื่องอัดแก๊สทำความเย็นแบบเกลียวหมุน	helical rotary compressor	๗ มี.ค. ๒๕๔๕
คอมเพรสเซอร์แบบเชื่อมปิด, เครื่ออัดแก๊สทำความเย็นแบบเชื่อมปิด	welded hermetic compressor	๗ มี.ค. ๒๕๔๕
คอมเพรสเซอร์แบบใบหมุน, เครื่องอัดแก๊สทำความเย็นแบบใบหมุน	vane rotary compressor	๗ มี.ค. ๒๕๔๕
คอมเพรสเซอร์แบบเปิด, เครื่องอัดแก๊สทำความเย็นแบบเปิด	open-type compressor	๗ มี.ค. ๒๕๔๕
คอมเพรสเซอร์แบบเปลี่ยนปริมาตร, เครื่องอัดแก๊สทำความเย็นแบบเปลี่ยนปริมาตร	positive displacement compressor	๗ มี.ค. ๒๕๔๕
คอมเพรสเซอร์แบบหมุน, เครื่องอัดแก๊สทำความเย็นแบบหมุน	rotary compressor	๗ มี.ค. ๒๕๔๕
คอมเพรสเซอร์แบบหมุนกวาด, เครื่องอัดแก๊สทำความเย็นแบบหมุนกวาด	swash plate rotary compressor	๗ มี.ค. ๒๕๔๕
คอมเพรสเซอร์แบบหอยโข่ง, เครื่องอัดแก๊สทำความเย็นแบบหอยโข่ง	centrifugal compressor	๗ มี.ค. ๒๕๔๕
คอมเพรสเซอร์แบบหุ้มปิด, เครื่องอัดแก๊สทำความเย็นแบบหุ้มปิด	hermetic compressor; sealed unit compressor	๗ มี.ค. ๒๕๔๕
คอมเพรสเซอร์แบบลูกสูบ, เครื่องอัดแก๊สทำความเย็นแบบลูกสูบ	reciprocating compressor	๗ มี.ค. ๒๕๔๕
คอมเพรสเซอร์แบบก้นหอย, เครื่องอัดแก๊สทำความเย็นแบบก้นหอย	scroll compressor	๗ มี.ค. ๒๕๔๕
คอมเพรสเซอร์แบบทวิภาวะ, เครื่องอัดแก๊สทำความเย็นแบบทวิภาวะ	dual compression compressor	๗ มี.ค. ๒๕๔๕
คอมเพรสเซอร์แบบประกอบปิด, เครื่องอัดแก๊สทำความเย็นแบบประกอบปิด	semi-hermetic compressor	๗ มี.ค. ๒๕๔๕
คอยล์, ท่อขด; ขดลวด	coil	๗ มี.ค. ๒๕๔๕
คอยล์แยกแถว	row split coil	๗ มี.ค. ๒๕๔๕
คอยล์แยกผิวหน้า	face split coil	๗ มี.ค. ๒๕๔๕
คอยล์ระเหยสารทำความเย็น	expansion coil	๗ มี.ค. ๒๕๔๕
คอยล์ระเหยสารทำความเย็นโดยตรง	direct expansion coil	๗ มี.ค. ๒๕๔๕
คอยล์แห้ง	dry coil	๗ มี.ค. ๒๕๔๕
คอยล์มีครีบ	finned coil	๗ มี.ค. ๒๕๔๕
คอยล์มีครีบในตัว	integral-finned coil	๗ มี.ค. ๒๕๔๕
คอยล์เครื่องระเหย	evaporator coil	๗ มี.ค. ๒๕๔๕
คอยล์เปียก	wet coil; wetted coil	๗ มี.ค. ๒๕๔๕
คอยล์เปลือย	uncased coil	๗ มี.ค. ๒๕๔๕
คอยล์วงจรไข้ว	intertwined circuiting coil	๗ มี.ค. ๒๕๔๕
คอยล์อุ่นอากาศ	reheating coil; tempering coil	๗ มี.ค. ๒๕๔๕
คอยล์อุ่นอากาศล่วงหน้า	preheat coil	๗ มี.ค. ๒๕๔๕
คอยล์ครีบแผ่น	plate-finned coil	๗ มี.ค. ๒๕๔๕
คอยล์ทำความเย็น	cooling coil	๗ มี.ค. ๒๕๔๕
คอยล์ทำความร้อน	heating coil	๗ มี.ค. ๒๕๔๕
คอยล์น้ำเย็น	chilled water coil	๗ มี.ค. ๒๕๔๕
คอยล์น้ำร้อน	hot water coil	๗ มี.ค. ๒๕๔๕
คอนเดนเซอร์, เครื่องควบแน่น	condenser	๗ มี.ค. ๒๕๔๕
คาร์บอนกัมมันต์	activated carbon	๗ มี.ค. ๒๕๔๕
คลอโรฟลูออโรคาร์บอน (ซีเอฟซี)	chlorofluorocarbon (CFC)	๗ มี.ค. ๒๕๔๕
คุณภาพของไอชื้น	quality of wet vapour	๗ มี.ค. ๒๕๔๕
งานยังผล	effective work	๗ มี.ค. ๒๕๔๕
งานวัดโดยตรง	indicated work	๗ มี.ค. ๒๕๔๕
งานท่อลม	ductwork	๗ มี.ค. ๒๕๔๕
จานใบพัด	impeller	๗ มี.ค. ๒๕๔๕
จุกอุดหลอมละลาย	fusible plug	๗ มี.ค. ๒๕๔๕
จุดเยือกแข็ง	freezing point	๗ มี.ค. ๒๕๔๕
จุดน้ำค้าง	dew point	๗ มี.ค. ๒๕๔๕
จุดน้ำค้างห้อง	room dew point	๗ มี.ค. ๒๕๔๕
จุดน้ำค้างอุปกรณ์	apparatus dew point	๗ มี.ค. ๒๕๔๕
ฉนวนรูปท่อ	tube insulation	๗ มี.ค. ๒๕๔๕
ฉนวนใช้กรุ	fill insulation	๗ มี.ค. ๒๕๔๕
ฉนวนกันเสียง	sound insulation	๗ มี.ค. ๒๕๔๕
ฉนวนความร้อน	thermal insulation	๗ มี.ค. ๒๕๔๕
ช่วงเวลาความต้องการกำลังไฟฟ้าสูง	on peak period	๗ มี.ค. ๒๕๔๕
ช่วงเวลาความต้องการกำลังไฟฟ้าสูงบางส่วน	partial peak period	๗ มี.ค. ๒๕๔๕
ช่วงเวลาความต้องการกำลังไฟฟ้าต่ำ	off peak period	๗ มี.ค. ๒๕๔๕
ช่วงล่า	lag	๗ มี.ค. ๒๕๔๕
ช่วงทำความเย็น	cooling prage	๗ มี.ค. ๒๕๔๕
ช่อง	orifice	๗ มี.ค. ๒๕๔๕
ช่องห่าง	clearance volume	๗ มี.ค. ๒๕๔๕
ช่องอากาศ	air vent	๗ มี.ค. ๒๕๔๕
ช่องลมเยือกแข็ง	air tunnel	๗ มี.ค. ๒๕๔๕
ช่องลมภายนอก	outside air opening	๗ มี.ค. ๒๕๔๕
ช่องลมเกล็ดตรึง	fixed grille	๗ มี.ค. ๒๕๔๕
ช่องลมเข้า	air intake	๗ มี.ค. ๒๕๔๕
ช่องลมแบบเกล็ด	bar grille	๗ มี.ค. ๒๕๔๕
ช่องลมแบบหน้าพรุน	perforated grille; stamped grille	๗ มี.ค. ๒๕๔๕
ช่องลมกลับ	return grille	๗ มี.ค. ๒๕๔๕
ช่องลมจ่าย	supply grille	๗ มี.ค. ๒๕๔๕
ช่องลมถ่ายออก	exhaust openint	๗ มี.ค. ๒๕๔๕
ช่องลมปรับทิศทางได้	adjustable grille	๗ มี.ค. ๒๕๔๕
ช่องลมปรับปริมาณได้	register	๗ มี.ค. ๒๕๔๕
ช่องจ่ายลมแนวยาว	linear diffuser; slot diffuser	๗ มี.ค. ๒๕๔๕
ช่องจ่ายลมฝ้าเพดาน	ceiling outlet	๗ มี.ค. ๒๕๔๕
ช่องตรวจใส	sight glass	๗ มี.ค. ๒๕๔๕
ช่องตรวจของเหลว [สารทำความเย็น]	liquid indicator	๗ มี.ค. ๒๕๔๕
ช่องท่อ	pipe shaft	๗ มี.ค. ๒๕๔๕
ช่องท่อลม	duct shaft	๗ มี.ค. ๒๕๔๕
ช่องทางเข้า	access door	๗ มี.ค. ๒๕๔๕
ช่องผ่าน	sledve	๗ มี.ค. ๒๕๔๕
ชั้นสร้างพัดลม	fan class of construction	๗ มี.ค. ๒๕๔๕
ชุดรวม, ชุดชิ้นส่วน	assembly	๗ มี.ค. ๒๕๔๕
ชุดแผ่นปรับลม	damper	๗ มี.ค. ๒๕๔๕
ชุดแผ่นปรับลมแบ่งเขต	zone damper	๗ มี.ค. ๒๕๔๕
ชุดแผ่นปรับลมแบบโน้นถ่วง	gravity damper	๗ มี.ค. ๒๕๔๕
ชุดแผ่นปรับลมอัตโนมัติ	automatic damper	๗ มี.ค. ๒๕๔๕
ชุดแผ่นปรับลมกั้นไฟลาม	fire damper	๗ มี.ค. ๒๕๔๕
ชุดเครื่องจักรทำความเย็น	refrigerating machinery	๗ มี.ค. ๒๕๔๕
ชุดส่งลมเหนี่ยวนำ	induction unit	๗ มี.ค. ๒๕๔๕
ชุดกันรั่ว	stufing box	๗ มี.ค. ๒๕๔๕
ชุดอัดแก๊ส; ชุดคอมเพรสเซอร์, ชุดอัดแก๊สทำความเย็น	compressor unit	๗ มี.ค. ๒๕๔๕
ชุดอุปกรณ์	kit	๗ มี.ค. ๒๕๔๕
ชุดอุปกรณ์แบบรวมส่วน	packaged unit	๗ มี.ค. ๒๕๔๕
ชุดขับ	drive	๗ มี.ค. ๒๕๔๕
ชุดขับพัดลม	fan drive	๗ มี.ค. ๒๕๔๕
ชุดควบแน่น	condensing unit	๗ มี.ค. ๒๕๔๕
ชุดควบแน่นระบายความร้อนด้วยอากาศ	air-cooled condensing unit	๗ มี.ค. ๒๕๔๕
ชุดควบแน่นระบายความร้อนด้วยน้ำ	water-cooled condesing unit	๗ มี.ค. ๒๕๔๕
ชุดคอมเพรสเซอร์, ชุดอัดแก๊สทำความเย็น; ชุดอัดแก๊ส	compressor unit	๗ มี.ค. ๒๕๔๕
ชุดจ่ายลมปลายทาง	terminal unit	๗ มี.ค. ๒๕๔๕
ชุดชิ้นส่วน, ชุดรวม	assembly	๗ มี.ค. ๒๕๔๕
ชุดดักผง	strainer	๗ มี.ค. ๒๕๔๕
ชุดดักผงแบบวาย	wye strainer; y-strainer	๗ มี.ค. ๒๕๔๕
ชุดดูดกรอบสารทำความเย็น	filter-dryer	๗ มี.ค. ๒๕๔๕
ชุดทำให้เย็น	cooler	๗ มี.ค. ๒๕๔๕
ชุดทำให้เย็นล่วงหน้า	precooler	๗ มี.ค. ๒๕๔๕
ชุดทำให้อุ่นล่วงหน้า	preheater	๗ มี.ค. ๒๕๔๕
ชุดทำความร้อนด้วยลวดไฟฟ้า	electric heating element	๗ มี.ค. ๒๕๔๕
ชุดทำน้ำเกลือเย็น	brine cooler	๗ มี.ค. ๒๕๔๕
ชุดดูดกลืน	absorber	๗ มี.ค. ๒๕๔๕
ชุดตัวดักไอน้ำพร้อมท่อ; ท่อไอกลั่นตัว; หยดน้ำ	drip	๗ มี.ค. ๒๕๔๕
ซีโอพี (สัมประสิทธิ์สมรรถนะการทำความเย็น)	COPc (coefficent of performance of refrigeration)	๗ มี.ค. ๒๕๔๕
ซีโอพี (สัมประสิทธิ์สมรรถนะฮีตปั๊ม)	COPh (coefficent of performance of heat pump)	๗ มี.ค. ๒๕๔๕
ซีเอฟ (แฟกเตอร์สัมผัส)	CF (contact factor)	๗ มี.ค. ๒๕๔๕
ซีเอฟซี (คลอโรฟลูออโรคาร์บอน)	CFC (chlorofluorocarbon)	๗ มี.ค. ๒๕๔๕
ซิลิกาเจล	silica gel	๗ มี.ค. ๒๕๔๕
ซิงโครนัสมอเตอร์, มอเตอร์สมวาร	synchronous motor	๗ มี.ค. ๒๕๔๕
ด้านความดันสูง	high pressure side; high side	๗ มี.ค. ๒๕๔๕
ด้านความดันต่ำ	low pressure side; low side	๗ มี.ค. ๒๕๔๕
ดีบี (เดซิเบล)	dB (decible)	๗ มี.ค. ๒๕๔๕
ตะแกรงพัดลม	fan guard	๗ มี.ค. ๒๕๔๕
ตะแกรงคุ้มภัย	protecting grille	๗ มี.ค. ๒๕๔๕
-ต่อตรง	direct connected	๗ มี.ค. ๒๕๔๕
ตัวเรือน; ตู้	casing	๗ มี.ค. ๒๕๔๕
ตัวรับรู้ความดันส่วนต่าง	differential pressure sensor	๗ มี.ค. ๒๕๔๕
ตัวเก็บประจุ	capacitor	๗ มี.ค. ๒๕๔๕
ตัวเก็บประจุเมื่อเริ่มทำงาน	start capacitor	๗ มี.ค. ๒๕๔๕
ตัวเก็บประจุกำลัง	power capacitor	๗ มี.ค. ๒๕๔๕
ตัวเก็บประจุขณะทำงาน	run capacitor	๗ มี.ค. ๒๕๔๕
ตัวกำจัด	elimintor	๗ มี.ค. ๒๕๔๕
ตัวกลางทำความเย็น	cooling medium	๗ มี.ค. ๒๕๔๕
ตัวควบคุม	controller	๗ มี.ค. ๒๕๔๕
ตัวควบคุมความชื้น	humidistat; hygrostat	๗ มี.ค. ๒๕๔๕
ตัวคุมค่าความดัน	pressure regulator	๗ มี.ค. ๒๕๔๕
ตัวจอภาพ; เครื่องเฝ้าสังเกต, มอนิเตอร์	monitor	๗ มี.ค. ๒๕๔๕
ตัวดูดกลืน	absorbent	๗ มี.ค. ๒๕๔๕
ตัวดูดซับ	adsorbent	๗ มี.ค. ๒๕๔๕
ตัวตัดวงจร	circuit breaker	๗ มี.ค. ๒๕๔๕
ตัวตัดวงจรปรับพิกัดแล้ว	calibrated circuit breaker	๗ มี.ค. ๒๕๔๕
ตัวทำให้เย็น	coolant	๗ มี.ค. ๒๕๔๕
ตัวนำความร้อน	thermal conductor	๗ มี.ค. ๒๕๔๕
-ตั้งพื้น	floor mounted	๗ มี.ค. ๒๕๔๕
ตันความเย็น	ton of refrigeration (TR)	๗ มี.ค. ๒๕๔๕
-ติดเพดาน	ceiling mounted	๗ มี.ค. ๒๕๔๕
-ติดกันโดยวิธีกล	mechanically bonded	๗ มี.ค. ๒๕๔๕
-ติดผนัง	wall mounted	๗ มี.ค. ๒๕๔๕
ตู้	cabinet	๗ มี.ค. ๒๕๔๕
ตู้; ตัวเรือน	casing	๗ มี.ค. ๒๕๔๕
ตู้เย็น	refrigerator	๗ มี.ค. ๒๕๔๕
ตู้เย็นเชิงพาณิชย์	commercial refrigerator	๗ มี.ค. ๒๕๔๕
ตู้เย็นในบ้าน	domestic refrigerator; household refrigerator	๗ มี.ค. ๒๕๔๕
ตู้เย็นแบบเดินเข้าได้	walk-in refrigerator	๗ มี.ค. ๒๕๔๕
ตู้เย็นแบบหยิบถึง	reach-in refrigerator	๗ มี.ค. ๒๕๔๕
ตู้เย็นแบบบริการ	service refrigerator	๗ มี.ค. ๒๕๔๕
ตู้เย็นแบบบริการตัวเอง	self-service refrigerator	๗ มี.ค. ๒๕๔๕
ตู้น้ำเย็น	water cooler	๗ มี.ค. ๒๕๔๕
ถังรับน้ำขยายตัว	expansion tank	๗ มี.ค. ๒๕๔๕
ถังรับน้ำขยายตัวแบบเปิด	open expansion tank	๗ มี.ค. ๒๕๔๕
ถังอัด	compression tank	๗ มี.ค. ๒๕๔๕
ถังพัก	accumulator	๗ มี.ค. ๒๕๔๕
ถังพักสารทำความเย็นเหลว	liquid refrigerant receiver; receiver	๗ มี.ค. ๒๕๔๕
ถังพักด้านดูด	suction accumulator	๗ มี.ค. ๒๕๔๕
ถาด	pan	๗ มี.ค. ๒๕๔๕
ถาดรับน้ำทิ้ง	condensate pan; drain pan	๗ มี.ค. ๒๕๔๕
ถาดล่าง, ถาดส่วนฐาน	base pan	๗ มี.ค. ๒๕๔๕
ท่อแยก	branch duct	๗ มี.ค. ๒๕๔๕
ท่อแยกขนาน	bleeder	๗ มี.ค. ๒๕๔๕
ท่อรวม	header	๗ มี.ค. ๒๕๔๕
ท่อระบายทิ้ง	drain	๗ มี.ค. ๒๕๔๕
ท่อร่วม	manifold	๗ มี.ค. ๒๕๔๕
ท่อย่อย	runout	๗ มี.ค. ๒๕๔๕
ท่อร้อยสาย; ท่อส่งของไหล	conduit	๗ มี.ค. ๒๕๔๕
ท่อเหลี่ยมหักฉาก	square elbow	๗ มี.ค. ๒๕๔๕
ท่อใหญ่ร้อยสายไฟ	wire duct	๗ มี.ค. ๒๕๔๕
ท่อรักษาสมภาพ	equalizer	๗ มี.ค. ๒๕๔๕
ท่อรักษาสมภาพภายนอก	external equalizer	๗ มี.ค. ๒๕๔๕
ท่อรักาาสมภาพภายใน	internal equalizer	๗ มี.ค. ๒๕๔๕
ท่อมีครีบ	finned tube	๗ มี.ค. ๒๕๔๕
ท่อและอุปกรณ์ท่อ	piping	๗ มี.ค. ๒๕๔๕
ท่อเลี้ยวหักฉาก	miter elbow	๗ มี.ค. ๒๕๔๕
ท่อแลกเปลี่ยนความร้อน	heat pipe	๗ มี.ค. ๒๕๔๕
ท่อแก๊สร้อน	discharge tube; hot gas line	๗ มี.ค. ๒๕๔๕
ท่อเกลียวใน	rifle tube	๗ มี.ค. ๒๕๔๕
ท่อส่งออก	discharge line	๗ มี.ค. ๒๕๔๕
ท่อส่งของไหล; ท่อร้อยสาย	conduit	๗ มี.ค. ๒๕๔๕
ท่อหัวกระจายของเหลว [สารทำความเย็น]	liquid distributor tube	๗ มี.ค. ๒๕๔๕
ท่อลม	air duct	๗ มี.ค. ๒๕๔๕
ท่อลมแยก	duct take-off	๗ มี.ค. ๒๕๔๕
ท่อลมแนวตั้ง	duct riser	๗ มี.ค. ๒๕๔๕
ท่อลมออ่น	flexible duct	๗ มี.ค. ๒๕๔๕
ท่อสารเหลว	liquid line	๗ มี.ค. ๒๕๔๕
ท่อหลัก	main	๗ มี.ค. ๒๕๔๕
ท่ออ่อน	flexible tube	๗ มี.ค. ๒๕๔๕
ท่อลมไม่นำไฟฟ้า	non-conductive duct	๗ มี.ค. ๒๕๔๕
ท่อไร้ตะเข็บ	seamless tube	๗ มี.ค. ๒๕๔๕
ท่อไอกลั่นตัว; ชุดตัวดักไอน้ำพร้อมท่อ; หยดน้ำ	drip	๗ มี.ค. ๒๕๔๕
ท่อขด, คอยล์; ขอลวด	coil	๗ มี.ค. ๒๕๔๕
ท่อคู่ตั้งจ่าย	double discharge riser	๗ มี.ค. ๒๕๔๕
ท่อคู่ตั้งดูด	double suction riser	๗ มี.ค. ๒๕๔๕
ท่อตั้ง	riser	๗ มี.ค. ๒๕๔๕
ท่อดูดแก๊สเย็น	suction line; xuction tube	๗ มี.ค. ๒๕๔๕
ท่อนท่อลมแปลงรูป	duct ryansformer	๗ มี.ค. ๒๕๔๕
ที่รองรับท่อ	pipe support	๗ มี.ค. ๒๕๔๕
ทิศอาคาร	building orientation	๗ มี.ค. ๒๕๔๕
ทางเลี่ยง	bypass	๗ มี.ค. ๒๕๔๕
ทางดูดเข้า	suction inlet	๗ มี.ค. ๒๕๔๕
-ทำงานด้วยลมอัด	air-operated	๗ มี.ค. ๒๕๔๕
น้ำเติม	make-up water	๗ มี.ค. ๒๕๔๕
น้ำหมุนเวียน	circulating water	๗ มี.ค. ๒๕๔๕
น้ำหมุนเวียนกลับ	recirculating water	๗ มี.ค. ๒๕๔๕
น้ำสูญตามลม	windage loss	๗ มี.ค. ๒๕๔๕
น้ำหล่อเย็น	condenser water; cooling water	๗ มี.ค. ๒๕๔๕
น้ำเกลือ	brine	๗ มี.ค. ๒๕๔๕
น้ำแข็งจับ	freeze-up	๗ มี.ค. ๒๕๔๕
น้ำหนักรวบยอด	gross weight	๗ มี.ค. ๒๕๔๕
น้ำหนักเครื่อง	dry weight	๗ มี.ค. ๒๕๔๕
น้ำหนักเครื่องใช้งาน	operting weight	๗ มี.ค. ๒๕๔๕
น้ำดิบ	raw water	๗ มี.ค. ๒๕๔๕
น้ำปรับคุณภาพ	treated water	๗ มี.ค. ๒๕๔๕
น้ำปลิว	drift	๗ มี.ค. ๒๕๔๕
บีเอฟ (แฟกเตอร์เลี่ยง)	BF (bypass factor)	๗ มี.ค. ๒๕๔๕
บีทียู (หน่วยความร้อนระบบอังกฤษ)	BTU (Britixh Thermal Unit)	๗ มี.ค. ๒๕๔๕
ประสิทธิภาพเชิงกล [ของคอมเพรสเซอร์]	mechanical efficiency	๗ มี.ค. ๒๕๔๕
ประสิทธิภาพเชิงปริมาตรรวม	total volumetric efficiency	๗ มี.ค. ๒๕๔๕
ประสิทธิภาพการให้ความเย็น (อีอีอาร์)	energy efficiency ratio (EER)	๗ มี.ค. ๒๕๔๕
ประสิทธิภาพการอัด	compression efficiency	๗ มี.ค. ๒๕๔๕
ปรับควบคุมตามส่วน	graduate acting	๗ มี.ค. ๒๕๔๕
ปริมาณสารทำความเย็นประจุ	refrigerant charge	๗ มี.ค. ๒๕๔๕
ปริมาณออก	output	๗ มี.ค. ๒๕๔๕
ปริมาณน้ำมันประจุ	oil charge	๗ มี.ค. ๒๕๔๕
ปริมาตรกระจัดจริง	actual displacement	๗ มี.ค. ๒๕๔๕
ปริมาตรกระจัดทางทฤษฎี	theoretical displacement	๗ มี.ค. ๒๕๔๕
ปรากฏการณ์ลมลอยตัว	chimney effect; stack effect	๗ มี.ค. ๒๕๔๕
ปรกติเปิด	normally open	๗ มี.ค. ๒๕๔๕
ปรกติปิด	normally colsed	๗ มี.ค. ๒๕๔๕
ป้ายประจำเครื่อง	nameplate	๗ มี.ค. ๒๕๔๕
ปั้มห้อยโข่ง	centrifugal pump	๗ มี.ค. ๒๕๔๕
ปั๊มสุญญากาศ	vacuum pump	๗ มี.ค. ๒๕๔๕
ผ่อนทิ้ง	bleed off	๗ มี.ค. ๒๕๔๕
ผิวทำความเย็น	cooling element	๗ มี.ค. ๒๕๔๕
ผลเพิ่มความชื้น	humidifying effect	๗ มี.ค. ๒๕๔๕
ผลลดความชื้น	dehumidifying effect	๗ มี.ค. ๒๕๔๕
ผลต่างอุณหภูมิยังผล	effective temperature difference	๗ มี.ค. ๒๕๔๕
ผลต่างอุณหภูมิเฉลี่ย	mean temperature difference	๗ มี.ค. ๒๕๔๕
ผลต่างอุณหภูมิแพร่	diffusion tempeature difference	๗ มี.ค. ๒๕๔๕
ผลทำความเย็น	refrigerating effect	๗ มี.ค. ๒๕๔๕
ผลทำความเย็นรวม	total cooling effect	๗ มี.ค. ๒๕๔๕
ผลทำความเย็นของระบบ	system refrigerating effect	๗ มี.ค. ๒๕๔๕
ผลทำความเย็นของคอมเพรสเซอร์, ผลทำความเย็นของเครื่องอัดแก๊สทำความเย็น	compresor refrigerating effect	๗ มี.ค. ๒๕๔๕
ผลทำความเย็นของชุดทำให้เย็น	cooler refrigerating effect	๗ มี.ค. ๒๕๔๕
ผลทำความเย้นของชุดควบแน่น	condensing unit refrigerating effect	๗ มี.ค. ๒๕๔๕
ผนังกระจกสองชั้น	double glazing wall	๗ มี.ค. ๒๕๔๕
ฝุ่นผง	dust	๗ มี.ค. ๒๕๔๕
พัดลม	fan	๗ มี.ค. ๒๕๔๕
พัดลมเสริมกำลัง	booster fan; turbo fan	๗ มี.ค. ๒๕๔๕
พัดลมมีใบนำร่องติดตั้งในท่อกลม	vaneaxial fan	๗ มี.ค. ๒๕๔๕
พัดลมใบโค้งเอียงหลัง	backward-cured blade fan	๗ มี.ค. ๒๕๔๕
พัดลมตามแนวแกน	axial flow fan	๗ มี.ค. ๒๕๔๕
พัดลมติดตั้งในท่อลม	inline fan	๗ มี.ค. ๒๕๔๕
พัดลมติดตั้งในท่อกลม	tubeaxial fan	๗ มี.ค. ๒๕๔๕
พัดลมใบโค้งเอียงหน้า	forward curved blade fan	๗ มี.ค. ๒๕๔๕
พัดลมใบแฉก	propeller fan	๗ มี.ค. ๒๕๔๕
พัดลมใบแพนอากาศ	airfoil fan	๗ มี.ค. ๒๕๔๕
พัดลมใบตรง	radial blade fan	๗ มี.ค. ๒๕๔๕
พัดลมใบตรงเอียงหลัง	backward-inclined blade fan	๗ มี.ค. ๒๕๔๕
พัดลมแบบไร้ภาระเกิน	non-overloading type fan	๗ มี.ค. ๒๕๔๕
พัดลมหอยโข่ง	centrifugal fan	๗ มี.ค. ๒๕๔๕
พัดลมจ่าย	supply fan	๗ มี.ค. ๒๕๔๕
พัดลมดูดออก	exhauster; exhaust fan	๗ มี.ค. ๒๕๔๕
-พับไข้วทแยงมุม	cross broken	๗ มี.ค. ๒๕๔๕
พีเอช	pH	๗ มี.ค. ๒๕๔๕
พื้นที่หน้าคอยล์	coil face area; face area of coil	๗ มี.ค. ๒๕๔๕
พื้นที่สุทธิช่องลม	free area	๗ มี.ค. ๒๕๔๕
พื้นที่เพิ่มถ่ายโอนความร้อน	extended surface	๗ มี.ค. ๒๕๔๕
พื้นที่ท่อสวมต่อ	core area	๗ มี.ค. ๒๕๔๕
พื้นที่ทึบแสง	opaque area	๗ มี.ค. ๒๕๔๕
พื้นที่ผิวคอยล์	coil surface area	๗ มี.ค. ๒๕๔๕
ฟิล์มอากาศ	air film	๗ มี.ค. ๒๕๔๕
