a posteriori knowledge	ความรู้หลังประสบการณ์	๒ มี.ค. ๒๕๔๕
a priori knowledge	ความรู้ก่อนประสบการณ์	๒ มี.ค. ๒๕๔๕
แม่แบบ	archetype	๒ มี.ค. ๒๕๔๕
แรงจูงใจ	motivation	๒ มี.ค. ๒๕๔๕
มโนภาพ	Idea; idea	๒ มี.ค. ๒๕๔๕
มโนภาพ	concept	๒ มี.ค. ๒๕๔๕
มโนภาพแต่กำเนิด	innate idea	๒ มี.ค. ๒๕๔๕
โมนาด	monad	๒ มี.ค. ๒๕๔๕
มโนคติ	Idea; idea	๒ มี.ค. ๒๕๔๕
มโนทัศน์	concept	๒ มี.ค. ๒๕๔๕
มโนธรรม	conscience	๒ มี.ค. ๒๕๔๕
มโนนิยม	mentalism	๒ มี.ค. ๒๕๔๕
เรื่องปรัมปรา	myth	๒ มี.ค. ๒๕๔๕
absolute	สัมบูรณ์	๒ มี.ค. ๒๕๔๕
Absolute, the	สิ่งสัมบูรณ์, องค์สัมบูรณ์	๒ มี.ค. ๒๕๔๕
absolutism	สัมบูรณนิยม	๒ มี.ค. ๒๕๔๕
absolute idealism	จิตนิยมสัมบูรณ์	๒ มี.ค. ๒๕๔๕
absolute mind	จิตสัมบูรณ์	๒ มี.ค. ๒๕๔๕
abstraction	ภาวะนามธรรม	๒ มี.ค. ๒๕๔๕
abstract	นามธรรม	๒ มี.ค. ๒๕๔๕
academy	บัณฑิตยสถาน, วิทยาสถาน	๒ มี.ค. ๒๕๔๕
ภววิทยา	ontology	๒ มี.ค. ๒๕๔๕
acquaintance, knowledge by	ความรู้โดยประจักษ์	๒ มี.ค. ๒๕๔๕
acosmism	อจักรวาลนิยม	๒ มี.ค. ๒๕๔๕
action	กัตตุภาวะ	๒ มี.ค. ๒๕๔๕
active	กัมมันต์	๒ มี.ค. ๒๕๔๕
actuality	ภาวะจริง	๒ มี.ค. ๒๕๔๕
actualization	การกลายเป็นภาวะจริง	๒ มี.ค. ๒๕๔๕
activity	กัมมันตภาพ	๒ มี.ค. ๒๕๔๕
adventitious idea	พาหิรกมโนภาพ	๒ มี.ค. ๒๕๔๕
เสรีภาพ	freedom	๒ มี.ค. ๒๕๔๕
เสรีธรรม	liberty	๒ มี.ค. ๒๕๔๕
เสรีนิยม	liberalism	๒ มี.ค. ๒๕๔๕
รหัสยิก	mystic	๒ มี.ค. ๒๕๔๕
รหัสยลัทธิ	mysticism	๒ มี.ค. ๒๕๔๕
aesthetic attitude	สุนทรียเจตคติ	๒ มี.ค. ๒๕๔๕
aesthetic judgment	การตัดสินเชิงสุนทรียภาพ	๒ มี.ค. ๒๕๔๕
aesthetic value	คุณค่าทางสุนทรียภาพ	๒ มี.ค. ๒๕๔๕
aesthetics	สุนทรียศาสตร์	๒ มี.ค. ๒๕๔๕
เหตุ	cause	๒ มี.ค. ๒๕๔๕
เหตุกรรม	causation	๒ มี.ค. ๒๕๔๕
เหตุภาพ	causality	๒ มี.ค. ๒๕๔๕
เหตุผลวิบัติ	fallacy	๒ มี.ค. ๒๕๔๕
เหตุผลนิยม	rationalism	๒ มี.ค. ๒๕๔๕
เหตุของอาริสโตเติล	Aristotle’s cause	๒ มี.ค. ๒๕๔๕
เหตุจูงใจ	motive	๒ มี.ค. ๒๕๔๕
เหนือธรรมชาติ	supernatural	๒ มี.ค. ๒๕๔๕
affection	วิภาพ	๒ มี.ค. ๒๕๔๕
agent	ตัวกระทำ	๒ มี.ค. ๒๕๔๕
aggregate	๑. กลุ่มกอง<br/>๒. ขันธ์	๒ มี.ค. ๒๕๔๕
agnosticism	อไญยนิยม	๒ มี.ค. ๒๕๔๕
รอยประทับ	impression	๒ มี.ค. ๒๕๔๕
เอกเทวนิยม	monotheism	๒ มี.ค. ๒๕๔๕
เอกภพ	universe	๒ มี.ค. ๒๕๔๕
เอกัตนิยม	solipsism	๒ มี.ค. ๒๕๔๕
โอกาสนิยม	occasionaslism	๒ มี.ค. ๒๕๔๕
เอกลักษณ์	identity	๒ มี.ค. ๒๕๔๕
เอกนิยม	monism	๒ มี.ค. ๒๕๔๕
alienation	อัญภาวะ	๒ มี.ค. ๒๕๔๕
altruism	ปรัตถนิยม	๒ มี.ค. ๒๕๔๕
amoral	อศีลธรรม	๒ มี.ค. ๒๕๔๕
analogy, argument by	การให้เหตุผลโดยอาศัยแนวเทียบ	๒ มี.ค. ๒๕๔๕
analytic statement	ข้อความวิเคราะห์	๒ มี.ค. ๒๕๔๕
anarchism	อนาธิปไตย	๒ มี.ค. ๒๕๔๕
anihilism	อุจเฉทนิยม, อุจเฉททิฐิ	๒ มี.ค. ๒๕๔๕
animism	วิญญาณนิยม	๒ มี.ค. ๒๕๔๕
antecedent	บรรพบท, ข้อนำ	๒ มี.ค. ๒๕๔๕
anthropocentrism	มานุษยประมาณนิยม	๒ มี.ค. ๒๕๔๕
anthropomorphism	มานุษยรูปนิยม	๒ มี.ค. ๒๕๔๕
antithesis	ภาวะแย้ง	๒ มี.ค. ๒๕๔๕
มัชฌิมาปฏิปทา	middle way	๒ มี.ค. ๒๕๔๕
มัชฌิม	mean	๒ มี.ค. ๒๕๔๕
รับรู้	perceive	๒ มี.ค. ๒๕๔๕
มายา	illusion	๒ มี.ค. ๒๕๔๕
ภาวะแย้ง	antithesis	๒ มี.ค. ๒๕๔๕
ภาวะ	being	๒ มี.ค. ๒๕๔๕
ภาวะเอกพรรณ	homogeneity	๒ มี.ค. ๒๕๔๕
ภาวะเอกพันธ์	homogeneity	๒ มี.ค. ๒๕๔๕
ภาวะเอกรูปแห่งธรรมชาติ	uniformity of nature	๒ มี.ค. ๒๕๔๕
ภาวะแนบนัย	consistency	๒ มี.ค. ๒๕๔๕
ภาวะวิวิธพรรณ	heterogeneity	๒ มี.ค. ๒๕๔๕
ภาวะวิวิธพันธุ์	heterogeneity	๒ มี.ค. ๒๕๔๕
ภาวะยุ่งเหยิง	chaos	๒ มี.ค. ๒๕๔๕
ภาวะแฝง	latency; potentiality	๒ มี.ค. ๒๕๔๕
ภาวะสังเคราะห์	synthesis	๒ มี.ค. ๒๕๔๕
ภาวะอิสระ	autonomy	๒ มี.ค. ๒๕๔๕
ภาวะจริง	actuality	๒ มี.ค. ๒๕๔๕
ภาวะนามธรรม	abstraction	๒ มี.ค. ๒๕๔๕
ภาวะบรรสาน	harmony	๒ มี.ค. ๒๕๔๕
ภาวะพื้นฐาน	thesis	๒ มี.ค. ๒๕๔๕
มิจฉาทิฐิ	heresy	๒ มี.ค. ๒๕๔๕
มีดโกนอ็อกคัม	Occam’s razor; Ockam’s razor; Ockham’s razor	๒ มี.ค. ๒๕๔๕
มานุษยรูปนิยม	anthropomorphism	๒ มี.ค. ๒๕๔๕
มานุษยประมาณนิยม	anthropocentrism	๒ มี.ค. ๒๕๔๕
apparent	ที่ปรากฏ, ที่ประจักษ์ชัด	๒ มี.ค. ๒๕๔๕
appearance	สภาพปรากฏ	๒ มี.ค. ๒๕๔๕
apperception	วิสัญชาน	๒ มี.ค. ๒๕๔๕
apperception, empirical	ประจักษวิสัญชาน	๒ มี.ค. ๒๕๔๕
apperception, transcendental	อุตรวิสัญชาน, วิสัญชานอุตรวิสัย	๒ มี.ค. ๒๕๔๕
apperception, transcendental ego of	อุตรอัตตาแห่งวิสัญชาน	๒ มี.ค. ๒๕๔๕
apperception, transcendental unity of	อุตรเอกภาพแห่งวิสัญชาน	๒ มี.ค. ๒๕๔๕
appetite	อภิจฉา, ความทะยานอยาก	๒ มี.ค. ๒๕๔๕
apprehension	การรับรู้ขั้นต้น	๒ มี.ค. ๒๕๔๕
archetype	แม่แบบ	๒ มี.ค. ๒๕๔๕
argument	การให้เหตุผล, การถกเถียง, ข้อโต้แย้ง	๒ มี.ค. ๒๕๔๕
argument by analogy	การให้เหตุผลโดยอาศัยแนวเทียบ	๒ มี.ค. ๒๕๔๕
argument, ontological	การให้เหตุผลทางภววิทยา, ข้อพิสูจน์ทางภววิทยา	๒ มี.ค. ๒๕๔๕
argumentation	วิธีการให้เหตุผล	๒ มี.ค. ๒๕๔๕
aristocracy	อภิชนาธิปไตย	๒ มี.ค. ๒๕๔๕
Aristotle’s cause	เหตุของอาริสโตเติล, ปัจจัยของอาริสโตเติล	๒ มี.ค. ๒๕๔๕
asceticism	พรตนิยม	๒ มี.ค. ๒๕๔๕
association	สนธิการ	๒ มี.ค. ๒๕๔๕
association, laws of	กฎสนธิการ	๒ มี.ค. ๒๕๔๕
associationism	สนธิการนิยม	๒ มี.ค. ๒๕๔๕
assumption	ข้อสมมุติพื้นฐาน, มูลบท	๒ มี.ค. ๒๕๔๕
atheism	อเทวนิยม	๒ มี.ค. ๒๕๔๕
atman	อาตมัน	๒ มี.ค. ๒๕๔๕
atomism	ปรมาณูนิยม	๒ มี.ค. ๒๕๔๕
atta	อัตตา	๒ มี.ค. ๒๕๔๕
attitude, aesthetic	สุนทรียเจตคติ	๒ มี.ค. ๒๕๔๕
attribute	คุณลักษณะ	๒ มี.ค. ๒๕๔๕
automatism	ชีวยนตนิยม	๒ มี.ค. ๒๕๔๕
autonomy	อัตตาณัติ, ภาวะอิสระ	๒ มี.ค. ๒๕๔๕
มูลบท	assumption; postulate	๒ มี.ค. ๒๕๔๕
รูปเหตุ	formal cause	๒ มี.ค. ๒๕๔๕
รูปเคารพ	idol	๒ มี.ค. ๒๕๔๕
รูปแบบ	form	๒ มี.ค. ๒๕๔๕
รูปปัจจัย	formal cause	๒ มี.ค. ๒๕๔๕
รูปธรรม	concrete	๒ มี.ค. ๒๕๔๕
awareness	ความตระหนัก	๒ มี.ค. ๒๕๔๕
axiom	ฐานบท, สัจพจน์	๒ มี.ค. ๒๕๔๕
axiology	อรรฆวิทยา, คุณวิทยา	๒ มี.ค. ๒๕๔๕
แก่น	substance	๒ มี.ค. ๒๕๔๕
แก่นสาร	essence	๒ มี.ค. ๒๕๔๕
เกณฑ์	criterion; criterium (L.)	๒ มี.ค. ๒๕๔๕
เจตจำนง	will	๒ มี.ค. ๒๕๔๕
เจตจำนงเสรี	free will	๒ มี.ค. ๒๕๔๕
เจตนิยม	spiritualism	๒ มี.ค. ๒๕๔๕
เฉพาะราย	particular	๒ มี.ค. ๒๕๔๕
เฉพาะส่วน	particular	๒ มี.ค. ๒๕๔๕
เชิงอาเวค	emotive	๒ มี.ค. ๒๕๔๕
เชิงรหัสยะ	mystical	๒ มี.ค. ๒๕๔๕
เชิงเลือก	disjunctive	๒ มี.ค. ๒๕๔๕
เชิงปทัฏฐาน	normative	๒ มี.ค. ๒๕๔๕
เชิงผสม	complex	๒ มี.ค. ๒๕๔๕
เชิงบรรทัดฐาน	normative	๒ มี.ค. ๒๕๔๕
เชิงประสบการณ์	empirical	๒ มี.ค. ๒๕๔๕
เชิงประจักษ์	empirical	๒ มี.ค. ๒๕๔๕
เชิงปทัสถาน	normative	๒ มี.ค. ๒๕๔๕
เซต	set	๒ มี.ค. ๒๕๔๕
แต่กำเนิด	innate	๒ มี.ค. ๒๕๔๕
รตินิยม	hedonism	๒ มี.ค. ๒๕๔๕
เทวภาพ	deity; godhead; godhood; godness	๒ มี.ค. ๒๕๔๕
เทวรูป	idol	๒ มี.ค. ๒๕๔๕
เทววิทยา	theology	๒ มี.ค. ๒๕๔๕
เทวัสนิยม	deism	๒ มี.ค. ๒๕๔๕
เทวลิขิต	destiny; predestination	๒ มี.ค. ๒๕๔๕
เทวดา	deity	๒ มี.ค. ๒๕๔๕
เทห์	body	๒ มี.ค. ๒๕๔๕
เทวนิยม	theism	๒ มี.ค. ๒๕๔๕
เทพเจ้า	god	๒ มี.ค. ๒๕๔๕
มนุษยชาติ	humanity	๒ มี.ค. ๒๕๔๕
มนุษยธรรม	humanity	๒ มี.ค. ๒๕๔๕
มนุษยธรรมนิยม	humanitarianism	๒ มี.ค. ๒๕๔๕
มนุษยนิยม	humanism	๒ มี.ค. ๒๕๔๕
แบบ	From; form	๒ มี.ค. ๒๕๔๕
เป็นจริง	real	๒ มี.ค. ๒๕๔๕
เพทนาการ	sensation	๒ มี.ค. ๒๕๔๕
ยุคสว่าง	Enlightenment, the	๒ มี.ค. ๒๕๔๕
belief	ความเชื่อ	๒ มี.ค. ๒๕๔๕
behaviourism	พฤติกรรมนิยม	๒ มี.ค. ๒๕๔๕
Being	สัต	๒ มี.ค. ๒๕๔๕
being	๑. สัต<br/>๒. ภาวะ	๒ มี.ค. ๒๕๔๕
Being-in-Itself	พระเป็นเจ้า	๒ มี.ค. ๒๕๔๕
body	๑. กาย<br/>๒. เทห์	๒ มี.ค. ๒๕๔๕
bondage	พันธนาการ, การติดข้อง	๒ มี.ค. ๒๕๔๕
bourgeois	กระฎุมพี, ชนชั้นกลาง	๒ มี.ค. ๒๕๔๕
Brahma	พระพรหม	๒ มี.ค. ๒๕๔๕
Brahman	พรหมัน	๒ มี.ค. ๒๕๔๕
วรรณะ	caste	๒ มี.ค. ๒๕๔๕
cardinal virtue	คุณธรรมหลัก	๒ มี.ค. ๒๕๔๕
caste	วรรณะ	๒ มี.ค. ๒๕๔๕
categorical imperative	คำสั่งเด็ดขาด	๒ มี.ค. ๒๕๔๕
categorical statement	ข้อความเด็ดขาด	๒ มี.ค. ๒๕๔๕
categorical syllogism	ตรรกบทเด็ดขาด, ปรัตถานุมานเด็ดขาด	๒ มี.ค. ๒๕๔๕
category	ประเภท, ปทารถะ	๒ มี.ค. ๒๕๔๕
cause, Aristotle’s	เหตุของอาริสโตเติล, ปัจจัยของอาริสโตเติล	๒ มี.ค. ๒๕๔๕
cause, efficient	สัมฤทธิเหตุ, สัมฤทธิปัจจัย	๒ มี.ค. ๒๕๔๕
cause, final	อันตเหตุ, อันตปัจจัย	๒ มี.ค. ๒๕๔๕
cause, formal	รูปเหตุ, รูปปัจจัย	๒ มี.ค. ๒๕๔๕
cause, material	วัสดุเหตุ, วัสดุปัจจัย	๒ มี.ค. ๒๕๔๕
Causa Sui	สยัมภู	๒ มี.ค. ๒๕๔๕
causal theory of perception	ทฤษฎีสัญชานเชิงสาเหตุ	๒ มี.ค. ๒๕๔๕
causality	เหตุภาพ, ปัจจัยภาพ	๒ มี.ค. ๒๕๔๕
causation	เหตุกรรม, ปัจจยาการ	๒ มี.ค. ๒๕๔๕
cause	เหตุ, ปัจจัย	๒ มี.ค. ๒๕๔๕
วรนิยม	meliorism	๒ มี.ค. ๒๕๔๕
change	ความเปลี่ยนแปลง	๒ มี.ค. ๒๕๔๕
chance	ความบังเอิญ	๒ มี.ค. ๒๕๔๕
chaos	ภาวะยุ่งเหยิง	๒ มี.ค. ๒๕๔๕
class	ชั้นชน	๒ มี.ค. ๒๕๔๕
class consciousness	ความสำนึกเรื่องชั้นชน	๒ มี.ค. ๒๕๔๕
class struggle	การต่อสู้ระหว่างชนชั้น	๒ มี.ค. ๒๕๔๕
วัสดุเหตุ	material cause	๒ มี.ค. ๒๕๔๕
วัสดุปัจจัย	material cause	๒ มี.ค. ๒๕๔๕
วัตถุวิสัย	objective	๒ มี.ค. ๒๕๔๕
วัตถุนิยมทางประวัติศาสตร์	historical materialism	๒ มี.ค. ๒๕๔๕
วัตถุนิยมปฏิพัฒนาการ	dialectical materialism	๒ มี.ค. ๒๕๔๕
วัตถุนิยม	materialism	๒ มี.ค. ๒๕๔๕
วิภาษวิธี	dialectic	๒ มี.ค. ๒๕๔๕
วิภาพ	affection	๒ มี.ค. ๒๕๔๕
วิมตินิยม	scepticism; skepticism	๒ มี.ค. ๒๕๔๕
วิวรณ์	revelation	๒ มี.ค. ๒๕๔๕
cogito ergo sum	ฉันคิด เพราะฉะนั้น ฉันจึงมีอยู่จริง	๒ มี.ค. ๒๕๔๕
วิสัญชาน	apperception	๒ มี.ค. ๒๕๔๕
วิสัญชานอุตรวิสัย	transcendental apperception	๒ มี.ค. ๒๕๔๕
cognition	ประชาน	๒ มี.ค. ๒๕๔๕
coherence	สหนัย	๒ มี.ค. ๒๕๔๕
coherence theory of truth	ทฤษฎีความจริงแบบสหนัย	๒ มี.ค. ๒๕๔๕
communism	ลัทธิคอมมิวนิสต์	๒ มี.ค. ๒๕๔๕
complex	เชิงผสม	๒ มี.ค. ๒๕๔๕
composite	สังขตภาพ	๒ มี.ค. ๒๕๔๕
comprehension	ความเข้าใจซึ้ง	๒ มี.ค. ๒๕๔๕
conatus	พลังวิริยะ	๒ มี.ค. ๒๕๔๕
concept	มโนทัศน์, มโนภาพ	๒ มี.ค. ๒๕๔๕
conclusion	ข้อสรุป	๒ มี.ค. ๒๕๔๕
concrete	รูปธรรม	๒ มี.ค. ๒๕๔๕
conditional imperative	คำสั่งมีเงื่อนไข	๒ มี.ค. ๒๕๔๕
conditioning	การปรับสภาวะ	๒ มี.ค. ๒๕๔๕
conduct	ความประพฤติ	๒ มี.ค. ๒๕๔๕
conscience	มโนธรรม	๒ มี.ค. ๒๕๔๕
consciousness	พิชาน	๒ มี.ค. ๒๕๔๕
consciousness, class	ความสำนึกเรื่องชั้นชน	๒ มี.ค. ๒๕๔๕
consciousness, object of	สิ่งที่ถูกรู้, อารมณ์	๒ มี.ค. ๒๕๔๕
consistency	๑. ความกลมกลืน, ภาวะแนบนัย<br/>๒. ความคงเส้นคงวา, ความอยู่กับร่องกับรอย	๒ มี.ค. ๒๕๔๕
consequent	อนุบท, ข้อตาม	๒ มี.ค. ๒๕๔๕
constitution	๑. การปรุงแต่ง<br/>๒. สิ่งที่ปรุงแต่ง, สังขาร	๒ มี.ค. ๒๕๔๕
contemplation	การเข้าฌาน, การเพ่งพินิจ	๒ มี.ค. ๒๕๔๕
continence	ความยับยั้ง	๒ มี.ค. ๒๕๔๕
continuity	สันตติ	๒ มี.ค. ๒๕๔๕
contradiction	๑. ความขัดแย้งกัน<br/>๒. ข้อความขัดแย้งในตัว	๒ มี.ค. ๒๕๔๕
contradiction, self-	ความขัดแย้งในตัว	๒ มี.ค. ๒๕๔๕
contradictory	ขัดแย้งกัน	๒ มี.ค. ๒๕๔๕
contrariety	ความขัดกัน	๒ มี.ค. ๒๕๔๕
contrary	ขัดกัน	๒ มี.ค. ๒๕๔๕
copula	ตัวเชื่อม	๒ มี.ค. ๒๕๔๕
corrective justice	ความยุติธรรมเพื่อแก้ไขความประพฤติ	๒ มี.ค. ๒๕๔๕
correspondence	ความสมนัย	๒ มี.ค. ๒๕๔๕
correspondence theory of truth	ทฤษฎีความจริงแบบสมนัย	๒ มี.ค. ๒๕๔๕
cosmism	จักรวาลนิยม	๒ มี.ค. ๒๕๔๕
cosmology	จักรวาลวิทยา	๒ มี.ค. ๒๕๔๕
cosmos	จักรวาล	๒ มี.ค. ๒๕๔๕
วิญญาณ	soul	๒ มี.ค. ๒๕๔๕
วิญญาณโลก	soul, world	๒ มี.ค. ๒๕๔๕
วิญญาณโลก	world soul	๒ มี.ค. ๒๕๔๕
วิญญาณนิยม	animism	๒ มี.ค. ๒๕๔๕
วิถีทาง	means	๒ มี.ค. ๒๕๔๕
วิทยาสถาน	academy	๒ มี.ค. ๒๕๔๕
วิธิเอกัตนิยม	methodological solipsism; solipsistic methodology	๒ มี.ค. ๒๕๔๕
วิธีวิทยา	methodology	๒ มี.ค. ๒๕๔๕
วิธีการ	means	๒ มี.ค. ๒๕๔๕
วิธีการให้เหตุผล	argumentation	๒ มี.ค. ๒๕๔๕
วิธิปัจเจกนิยม	methodological individualism	๒ มี.ค. ๒๕๔๕
creation	การสร้าง, การเนรมิต	๒ มี.ค. ๒๕๔๕
creative theory of perception	ทฤษฎีสัญชานเชิงสร้างสรรค์	๒ มี.ค. ๒๕๔๕
criterion; criterium (L.)	เกณฑ์	๒ มี.ค. ๒๕๔๕
cynic	ซีนิก	๒ มี.ค. ๒๕๔๕
cynicism	ลัทธิซีนิก	๒ มี.ค. ๒๕๔๕
deductive	นิรนัย	๒ มี.ค. ๒๕๔๕
definition, ostensive	การนิยามโดยยกตัวอย่าง	๒ มี.ค. ๒๕๔๕
deism	เทวัสนิยม	๒ มี.ค. ๒๕๔๕
deity	๑. เทวภาพ<br/>๒. เทวดา	๒ มี.ค. ๒๕๔๕
deontological theory	ทฤษฎีกรณียธรรม	๒ มี.ค. ๒๕๔๕
deontology	กรณียธรรม	๒ มี.ค. ๒๕๔๕
description, knowledge by	ความรู้โดยบอกเล่า	๒ มี.ค. ๒๕๔๕
destiny	พรหมลิขิต, เทวลิขิต	๒ มี.ค. ๒๕๔๕
determination	การพิจารณากำหนด	๒ มี.ค. ๒๕๔๕
determinism	นิยัตินิยม	๒ มี.ค. ๒๕๔๕
determinism, economic	นิยัตินิยมทางเศรษฐกิจ	๒ มี.ค. ๒๕๔๕
dialectic	๑. วิภาษวิธี<br/>๒. ปฏิพัฒนาการ<br/>๓. ตรรกศาสตร์	๒ มี.ค. ๒๕๔๕
dialectical materialism	วัตถุนิยมปฏิพัฒนาการ	๒ มี.ค. ๒๕๔๕
direct realist theory of perception	ทฤษฎีสัญชานเชิงสัจนิยมโดยตรง	๒ มี.ค. ๒๕๔๕
disjunctive	เชิงเลือก	๒ มี.ค. ๒๕๔๕
distribution	การกระจาย	๒ มี.ค. ๒๕๔๕
distributive justice	ความยุติธรรมในการจัดสรร	๒ มี.ค. ๒๕๔๕
doctrine of the mean	หลักมัชฌิม	๒ มี.ค. ๒๕๔๕
dogma	สิทธันต์, คำสอนต้องเชื่อ	๒ มี.ค. ๒๕๔๕
dogmatism	สิทธันตนิยม	๒ มี.ค. ๒๕๔๕
dualism	ทวินิยม	๒ มี.ค. ๒๕๔๕
สรรพจิตนิยม	panpsychism	๒ มี.ค. ๒๕๔๕
สมรรถพล	faculty	๒ มี.ค. ๒๕๔๕
สรรพเทวนิยม	pantheism	๒ มี.ค. ๒๕๔๕
สยัมภู	Causa Sui	๒ มี.ค. ๒๕๔๕
สมาธิ	meditation	๒ มี.ค. ๒๕๔๕
สภาพปรากฏ	appearance	๒ มี.ค. ๒๕๔๕
economic determinism	นิยัตินิยมทางเศรษฐกิจ	๒ มี.ค. ๒๕๔๕
ecstasy	ปีติสานติ์	๒ มี.ค. ๒๕๔๕
ส่อความ	imply	๒ มี.ค. ๒๕๔๕
สสาร	matter	๒ มี.ค. ๒๕๔๕
สสารรูปนิยม	hylomorphism	๒ มี.ค. ๒๕๔๕
สสารนิยม	materialism	๒ มี.ค. ๒๕๔๕
สสารนิยมทางประวัติศาสตร์	historical materialism	๒ มี.ค. ๒๕๔๕
สหนัย	coherence	๒ มี.ค. ๒๕๔๕
effect	ผล	๒ มี.ค. ๒๕๔๕
efficient cause	สัมฤทธิเหตุ, สัมฤทธิปัจจัย	๒ มี.ค. ๒๕๔๕
ego	อัตตา	๒ มี.ค. ๒๕๔๕
egoism	๑. อัตตานิยม<br/>๒. อัตตัตถนิยม	๒ มี.ค. ๒๕๔๕
egotism	อติมานะ	๒ มี.ค. ๒๕๔๕
element	ธาตุ	๒ มี.ค. ๒๕๔๕
emergent evolution	อุบัติวิวัฒนาการ	๒ มี.ค. ๒๕๔๕
emergence	การอุบัติ	๒ มี.ค. ๒๕๔๕
emotion	อาเวค	๒ มี.ค. ๒๕๔๕
emotive	เชิงอาเวค	๒ มี.ค. ๒๕๔๕
emotive theory of ethics	อาเวคนิยม	๒ มี.ค. ๒๕๔๕
emotivism	อาเวคนิยม	๒ มี.ค. ๒๕๔๕
empirical	เชิงประจักษ์, เชิงประสบการณ์	๒ มี.ค. ๒๕๔๕
empirical apperception	ประจักษวิสัญชาน	๒ มี.ค. ๒๕๔๕
empirical knowledge	ความรู้เชิงประจักษ์, ความรู้เชิงประสบการณ์	๒ มี.ค. ๒๕๔๕
empirical truth	ความจริงเชิงประจักษ์, ความจริงเชิงประสบการณ์	๒ มี.ค. ๒๕๔๕
empiricism	ประสบการณ์นิยม	๒ มี.ค. ๒๕๔๕
empiricism, logical	ประสบการณ์นิยมเชิงตรรก	๒ มี.ค. ๒๕๔๕
สัมฤทธิเหตุ	efficient cause	๒ มี.ค. ๒๕๔๕
สัมฤทธิภาวะ	entelechy	๒ มี.ค. ๒๕๔๕
สัมฤทธิปัจจัย	cause, efficient	๒ มี.ค. ๒๕๔๕
สัมฤทธิปัจจัย	efficient cause	๒ มี.ค. ๒๕๔๕
สัมบูรณ์	absolute	๒ มี.ค. ๒๕๔๕
สัมบูรณนิยม	absolutism	๒ มี.ค. ๒๕๔๕
สัมพัทธ์	relative	๒ มี.ค. ๒๕๔๕
สัมพัทธนิยม	relativism	๒ มี.ค. ๒๕๔๕
สัมพฤตินิยม	holism	๒ มี.ค. ๒๕๔๕
end	จุดหมายปลายทาง	๒ มี.ค. ๒๕๔๕
enlightenment	การตรัสรู้, การรู้แจ้ง	๒ มี.ค. ๒๕๔๕
Enlightenment, the	ยุคสว่าง	๒ มี.ค. ๒๕๔๕
entelechy	สัมฤทธิภาวะ	๒ มี.ค. ๒๕๔๕
entity	สิ่ง	๒ มี.ค. ๒๕๔๕
enthymeme	ตรรกบทย่อ, ปรัตถานุมานย่อ	๒ มี.ค. ๒๕๔๕
ศักยะ	potential	๒ มี.ค. ๒๕๔๕
ศักยภาวะ	potency	๒ มี.ค. ๒๕๔๕
ศักยภาพ	potentiality	๒ มี.ค. ๒๕๔๕
สังขาร	constitution	๒ มี.ค. ๒๕๔๕
สังขตภาพ	composite	๒ มี.ค. ๒๕๔๕
สังคมนิยม	socialism	๒ มี.ค. ๒๕๔๕
ศักดิ์สิทธิ์	holy	๒ มี.ค. ๒๕๔๕
สัจนิยม	realism	๒ มี.ค. ๒๕๔๕
สัจนิยมสามัญ	naive realism	๒ มี.ค. ๒๕๔๕
สัจพจน์	axiom	๒ มี.ค. ๒๕๔๕
สัญชาน	perception	๒ มี.ค. ๒๕๔๕
สัต	Being; being	๒ มี.ค. ๒๕๔๕
สันตติ	continuity	๒ มี.ค. ๒๕๔๕
สัพพัญญู	omniscient	๒ มี.ค. ๒๕๔๕
สัพพัญญุตา	omniscience	๒ มี.ค. ๒๕๔๕
สาระ	essence; substance	๒ มี.ค. ๒๕๔๕
สามัญการ	generalization	๒ มี.ค. ๒๕๔๕
สารัตถะ	essence	๒ มี.ค. ๒๕๔๕
สิ่ง	entity	๒ มี.ค. ๒๕๔๕
สิ่งเฉพาะ	particular	๒ มี.ค. ๒๕๔๕
สิ่งสัมบูรณ์	Absolute, the	๒ มี.ค. ๒๕๔๕
สิ่งสากล	universal	๒ มี.ค. ๒๕๔๕
สิ่งเป็นจริง	reality	๒ มี.ค. ๒๕๔๕
สิ่งดี	good	๒ มี.ค. ๒๕๔๕
สิ่งที่รู้ได้ทางประสาทสัมผัส	sensibile (L.)	๒ มี.ค. ๒๕๔๕
สิ่งที่ถูกรู้	known; object of consciousness; object of knowledge; sense-objects	๒ มี.ค. ๒๕๔๕
สิ่งที่ปรุงแต่ง	constitution	๒ มี.ค. ๒๕๔๕
สิ่งประเสริฐสุด	summum bonum	๒ มี.ค. ๒๕๔๕
ศีลธรรม	morality	๒ มี.ค. ๒๕๔๕
สิทธันต์	dogma	๒ มี.ค. ๒๕๔๕
สิทธันตนิยม	dogmatism	๒ มี.ค. ๒๕๔๕
epiphenomenalism	อนุปรากฏการณ์นิยม	๒ มี.ค. ๒๕๔๕
epistemology	ญาณวิทยา	๒ มี.ค. ๒๕๔๕
error	ความเคลื่อนคลาด	๒ มี.ค. ๒๕๔๕
essence	สาระ, สารัตถะ, แก่นสาร	๒ มี.ค. ๒๕๔๕
ethical naturalism	ธรรมชาตินิยมทางจริยศาสตร์	๒ มี.ค. ๒๕๔๕
ethics	จริยศาสตร์	๒ มี.ค. ๒๕๔๕
ethics, emotive theory of	อาเวคนิยม	๒ มี.ค. ๒๕๔๕
ethics, naturalistic	จริยศาสตร์แบบธรรมชาตินิยม	๒ มี.ค. ๒๕๔๕
evil	ชั่วร้าย, ความชั่วร้าย	๒ มี.ค. ๒๕๔๕
evolution, emergent	อุบัติวิวัฒนาการ	๒ มี.ค. ๒๕๔๕
excluded middle, law of	กฎนิรมัชฌิม	๒ มี.ค. ๒๕๔๕
existence	ความมีอยู่, การดำรงอยู่	๒ มี.ค. ๒๕๔๕
existentialism	อัตถิภาวนิยม	๒ มี.ค. ๒๕๔๕
explication	อรรถวิภาค	๒ มี.ค. ๒๕๔๕
extrinsic value	ค่านอกตัว	๒ มี.ค. ๒๕๔๕
หลักมัชฌิม	doctrine of the mean	๒ มี.ค. ๒๕๔๕
หลักศีลธรรม	moralities	๒ มี.ค. ๒๕๔๕
หลักการ	principle	๒ มี.ค. ๒๕๔๕
หลักจริยธรรม	morals	๒ มี.ค. ๒๕๔๕
หลักพิสูจน์ว่าเป็นเท็จ	falsifiability principle	๒ มี.ค. ๒๕๔๕
หลักพิสูจน์ว่าเป็นจริง	verifiability principle	๒ มี.ค. ๒๕๔๕
สกุล	genus	๒ มี.ค. ๒๕๔๕
สชาติกมโนภาพ	innate idea	๒ มี.ค. ๒๕๔๕
สชาติกะ	innate	๒ มี.ค. ๒๕๔๕
สนธิการ	association	๒ มี.ค. ๒๕๔๕
สนธิการนิยม	associationism	๒ มี.ค. ๒๕๔๕
สุขารมณ์	pleasure	๒ มี.ค. ๒๕๔๕
สุขารมณ์นิยม	hedonism	๒ มี.ค. ๒๕๔๕
สุทรรศนนิยม	optimism	๒ มี.ค. ๒๕๔๕
สุนิยม	optimism	๒ มี.ค. ๒๕๔๕
สุนทรียเจตคติ	aesthetic attitude	๒ มี.ค. ๒๕๔๕
สุนทรียศาสตร์	aesthetics	๒ มี.ค. ๒๕๔๕
สุญนิยม	nihilism	๒ มี.ค. ๒๕๔๕
fact	ข้อเท็จจริง	๒ มี.ค. ๒๕๔๕
faculty	สมรรถพล, อินทรีย์	๒ มี.ค. ๒๕๔๕
fallacy	เหตุผลวิบัติ	๒ มี.ค. ๒๕๔๕
fallacy, naturalistic	ความผิดพลาดของธรรมชาตินิยม	๒ มี.ค. ๒๕๔๕
falsification	การพิสูจน์ว่าเป็นเท็จ	๒ มี.ค. ๒๕๔๕
falsifiability principle	หลักพิสูจน์ว่าเป็นเท็จ	๒ มี.ค. ๒๕๔๕
falsifiable	ซึ่งอาจพิสูจน์ว่าเป็นเท็จ	๒ มี.ค. ๒๕๔๕
fatalism	ชะตานิยม	๒ มี.ค. ๒๕๔๕
fatalistic	ตามชะตากรรม	๒ มี.ค. ๒๕๔๕
final cause	อันตเหตุ, อันตปัจจัย	๒ มี.ค. ๒๕๔๕
finite	อันตะ	๒ มี.ค. ๒๕๔๕
first principle	ปฐมธาตุ	๒ มี.ค. ๒๕๔๕
First Mover	องค์ปฐมกร	๒ มี.ค. ๒๕๔๕
formal cause	รูปเหตุ, รูปปัจจัย	๒ มี.ค. ๒๕๔๕
form	แบบ, รูปแบบ	๒ มี.ค. ๒๕๔๕
freedom	เสรีภาพ	๒ มี.ค. ๒๕๔๕
free will	เจตจำนงเสรี	๒ มี.ค. ๒๕๔๕
From	แบบ	๒ มี.ค. ๒๕๔๕
generalization	สามัญการ	๒ มี.ค. ๒๕๔๕
genus	สกุล	๒ มี.ค. ๒๕๔๕
God	พระเป็นเจ้า	๒ มี.ค. ๒๕๔๕
god	เทพเจ้า	๒ มี.ค. ๒๕๔๕
godhead	๑. เทวภาพ<br/>๒. พระเป็นเจ้า	๒ มี.ค. ๒๕๔๕
godhood	๑. เทวภาพ<br/>๒. พระเป็นเจ้า	๒ มี.ค. ๒๕๔๕
godness	๑. เทวภาพ<br/>๒. พระเป็นเจ้า	๒ มี.ค. ๒๕๔๕
good	สิ่งดี, ดี	๒ มี.ค. ๒๕๔๕
happiness	ความสุข	๒ มี.ค. ๒๕๔๕
harmony	ความบรรสาน, ภาวะบรรสาน	๒ มี.ค. ๒๕๔๕
hedonism	สุขารมณ์นิยม, รตินิยม	๒ มี.ค. ๒๕๔๕
heresy	มิจฉาทิฐิ, นอกรีต	๒ มี.ค. ๒๕๔๕
hermeneutics	อรรถปริวรรตศาสตร์	๒ มี.ค. ๒๕๔๕
heterodox	นาสติกะ, ลัทธิอื่น	๒ มี.ค. ๒๕๔๕
heterogeneity	ภาวะวิวิธพรรณ, ภาวะวิวิธพันธุ์	๒ มี.ค. ๒๕๔๕
heteronomy	อัญญาณัติ	๒ มี.ค. ๒๕๔๕
historical materialism	วัตถุนิยมทางประวัติศาสตร์, สสารนิยมทางประวัติศาสตร์	๒ มี.ค. ๒๕๔๕
historicism	ประวัติศาสตรนิยม	๒ มี.ค. ๒๕๔๕
holism	๑. สัมพฤตินิยม<br/>๒. ลัทธิองค์รวม	๒ มี.ค. ๒๕๔๕
holy	ศักดิ์สิทธิ์	๒ มี.ค. ๒๕๔๕
homogeneity	ภาวะเอกพรรณ, ภาวะเอกพันธ์	๒ มี.ค. ๒๕๔๕
humanism	มนุษยนิยม	๒ มี.ค. ๒๕๔๕
humanitarianism	มนุษยธรรมนิยม	๒ มี.ค. ๒๕๔๕
humanity	๑. มนุษยธรรม<br/>๒. มนุษยชาติ	๒ มี.ค. ๒๕๔๕
hylomorphism	สสารรูปนิยม	๒ มี.ค. ๒๕๔๕
hypothetical imperative	คำสั่งมีเงื่อนไข	๒ มี.ค. ๒๕๔๕
อรรฆวิทยา	axiology	๒ มี.ค. ๒๕๔๕
อรรถวิภาค	explication	๒ มี.ค. ๒๕๔๕
อรรถศาสตร์	semantics	๒ มี.ค. ๒๕๔๕
อรรถปริวรรตศาสตร์	hermeneutics	๒ มี.ค. ๒๕๔๕
อภิภาษา	metalanguage	๒ มี.ค. ๒๕๔๕
อภาวะ	non-Being: non-being	๒ มี.ค. ๒๕๔๕
อภิคณิตศาสตร์	metamathematics	๒ มี.ค. ๒๕๔๕
อภิจริยศาสตร์	metaethics	๒ มี.ค. ๒๕๔๕
อภิจฉา	appetite	๒ มี.ค. ๒๕๔๕
อภิชนาธิปไตย	aristocracy	๒ มี.ค. ๒๕๔๕
อภิตรรกวิทยา	metalogic	๒ มี.ค. ๒๕๔๕
อภิตรรกศาสตร์	metalogic	๒ มี.ค. ๒๕๔๕
อภิปรัชญา	metaphysics	๒ มี.ค. ๒๕๔๕
อมตภาพ	immortality	๒ มี.ค. ๒๕๔๕
อเทวนิยม	atheism	๒ มี.ค. ๒๕๔๕
Idea; idea	มโนภาพ, มโนคติ	๒ มี.ค. ๒๕๔๕
idea, adventitious	พาหิรกมโนภาพ	๒ มี.ค. ๒๕๔๕
idea, innate	สหชาติกมโนภาพ, มโนภาพแต่กำเนิด	๒ มี.ค. ๒๕๔๕
อวกาศ	space	๒ มี.ค. ๒๕๔๕
ideal	อุดมคติ	๒ มี.ค. ๒๕๔๕
idealism	จิตนิยม	๒ มี.ค. ๒๕๔๕
idealism, absolute	จิตนิยมสัมบูรณ์	๒ มี.ค. ๒๕๔๕
identity	เอกลักษณ์	๒ มี.ค. ๒๕๔๕
idealism, objective	จิตนิยมวัตถุวิสัย, จิตนิยมปรวิสัย	๒ มี.ค. ๒๕๔๕
idealism, Platonic	จิตนิยมแบบเพลโต	๒ มี.ค. ๒๕๔๕
idealism, subjective	จิตนิยมอัตวิสัย	๒ มี.ค. ๒๕๔๕
idealism, transcendental	จิตนิยมอุตรวิสัย	๒ มี.ค. ๒๕๔๕
idealistic theory of perception	ทฤษฎีสัญชานเชิงจิตนิยม	๒ มี.ค. ๒๕๔๕
ideology	คตินิยม	๒ มี.ค. ๒๕๔๕
identity, law of	กฎเอกลักษณ์	๒ มี.ค. ๒๕๔๕
idol	รูปเคารพ, เทวรูป	๒ มี.ค. ๒๕๔๕
อสสารนิยม	immaterialism	๒ มี.ค. ๒๕๔๕
อสัต	non-Being: non-being	๒ มี.ค. ๒๕๔๕
อศีลธรรม	amoral	๒ มี.ค. ๒๕๔๕
illusion	มายา	๒ มี.ค. ๒๕๔๕
image	จินตภาพ	๒ มี.ค. ๒๕๔๕
imagination	จินตนาการ	๒ มี.ค. ๒๕๔๕
immanence	อัพภันตรภาพ	๒ มี.ค. ๒๕๔๕
immaterialism	อสสารนิยม	๒ มี.ค. ๒๕๔๕
immediate knowledge	ความรู้โดยตรง	๒ มี.ค. ๒๕๔๕
immoral	ผิดศีลธรรม	๒ มี.ค. ๒๕๔๕
immortality	อมตภาพ	๒ มี.ค. ๒๕๔๕
imperative, categorical	คำสั่งเด็ดขาด	๒ มี.ค. ๒๕๔๕
imperative, conditional	คำสั่งมีเงื่อนไข	๒ มี.ค. ๒๕๔๕
imperative, hypothetical	คำสั่งมีเงื่อนไข	๒ มี.ค. ๒๕๔๕
implication	การส่อความ	๒ มี.ค. ๒๕๔๕
imply	ส่อความ	๒ มี.ค. ๒๕๔๕
impression	ความประทับ, รอยประทับ	๒ มี.ค. ๒๕๔๕
incontinence	ความไม่ยับยั้ง	๒ มี.ค. ๒๕๔๕
indeterminism	อนิยัตินิยม	๒ มี.ค. ๒๕๔๕
inductive	อุปนัย	๒ มี.ค. ๒๕๔๕
individual	ปัจเจก, ปัจเจกบุคล	๒ มี.ค. ๒๕๔๕
induction	การอุปนัย	๒ มี.ค. ๒๕๔๕
individualism	ปัจเจกนิยม	๒ มี.ค. ๒๕๔๕
individualism, methodological	วิธิปัจเจกนิยม	๒ มี.ค. ๒๕๔๕
inference	การอนุมาน	๒ มี.ค. ๒๕๔๕
infinite	อนันต์	๒ มี.ค. ๒๕๔๕
infinity	อนันตภาพ	๒ มี.ค. ๒๕๔๕
innate	สชาติกะ, แต่กำเนิด	๒ มี.ค. ๒๕๔๕
innate idea	สชาติกมโนภาพ, มโนภาพแต่กำเนิด	๒ มี.ค. ๒๕๔๕
instrumentalism	อุปกรณ์นิยม	๒ มี.ค. ๒๕๔๕
intellect	ปัญญา, พุทธิปัญญา	๒ มี.ค. ๒๕๔๕
intellectualism	พุทธิปัญญานิยม	๒ มี.ค. ๒๕๔๕
interactionism	อันตรกิริยานิยม	๒ มี.ค. ๒๕๔๕
intrinsic value	ค่าในตัว	๒ มี.ค. ๒๕๔๕
invalidity	ความไม่สมเหตุสมผล	๒ มี.ค. ๒๕๔๕
introspection	อันตรวินิจ, การพินิจภายใน	๒ มี.ค. ๒๕๔๕
intuition	อัชฌัตติกญาณ, การรู้เอง	๒ มี.ค. ๒๕๔๕
intuitionism	อัชฌัตติกญาณนิยม	๒ มี.ค. ๒๕๔๕
อัชฌัตติกญาณ	intuition	๒ มี.ค. ๒๕๔๕
อัชฌัตติกญาณนิยม	intuitionism	๒ มี.ค. ๒๕๔๕
อัญภาวะ	alienation	๒ มี.ค. ๒๕๔๕
อัญรูป	mode	๒ มี.ค. ๒๕๔๕
อัญญาณัติ	heteronomy	๒ มี.ค. ๒๕๔๕
อัตวิสัย	subjective	๒ มี.ค. ๒๕๔๕
อัตตัตถนิยม	egoism	๒ มี.ค. ๒๕๔๕
อัตตา	atta; ego; self	๒ มี.ค. ๒๕๔๕
อัตตาณัติ	autonomy	๒ มี.ค. ๒๕๔๕
อัตตานิยม	egoism	๒ มี.ค. ๒๕๔๕
อัตถิภาวนิยม	existentialism	๒ มี.ค. ๒๕๔๕
อัตนัย	subjective	๒ มี.ค. ๒๕๔๕
อัตพิชาน	self-consciousness	๒ มี.ค. ๒๕๔๕
อันติมะ	ultimate	๒ มี.ค. ๒๕๔๕
อันติมสัจ	ultimate truth	๒ มี.ค. ๒๕๔๕
อันตปัจจัย	final cause	๒ มี.ค. ๒๕๔๕
อันตรวินิจ	introspection	๒ มี.ค. ๒๕๔๕
อันตเหตุ	final cause	๒ มี.ค. ๒๕๔๕
อันตรกิริยานิยม	interactionism	๒ มี.ค. ๒๕๔๕
อันตวิทยา	teleology	๒ มี.ค. ๒๕๔๕
อันตะ	finite	๒ มี.ค. ๒๕๔๕
อัพภันตรภาพ	immanence	๒ มี.ค. ๒๕๔๕
อารมณ์	object of consciousness; object of knowledge; sense-objects	๒ มี.ค. ๒๕๔๕
อาเวค	emotion	๒ มี.ค. ๒๕๔๕
อาเวคนิยม	emotive theory of ethics; emotivism	๒ มี.ค. ๒๕๔๕
อิสรเสรีนิยม	libertarianism	๒ มี.ค. ๒๕๔๕
อาตมัน	atman	๒ มี.ค. ๒๕๔๕
อินทรียภาพ	organism	๒ มี.ค. ๒๕๔๕
อินทรีย์	faculty	๒ มี.ค. ๒๕๔๕
อไญยนิยม	agnosticism	๒ มี.ค. ๒๕๔๕
อกัมมันตภาพ	passivity	๒ มี.ค. ๒๕๔๕
อกัมมันต์	passive	๒ มี.ค. ๒๕๔๕
องค์สัมบูรณ์	Absolute, the	๒ มี.ค. ๒๕๔๕
องค์ปฐมกร	First Mover	๒ มี.ค. ๒๕๔๕
องคาพยพ	organism	๒ มี.ค. ๒๕๔๕
อจักรวาลนิยม	acosmism	๒ มี.ค. ๒๕๔๕
อติมานะ	egotism	๒ มี.ค. ๒๕๔๕
อนิยัตินิยม	indeterminism	๒ มี.ค. ๒๕๔๕
อนาธิปไตย	anarchism	๒ มี.ค. ๒๕๔๕
อนัตตา	non-ego: non-self	๒ มี.ค. ๒๕๔๕
อนันตภาพ	infinity	๒ มี.ค. ๒๕๔๕
อนันต์	infinite	๒ มี.ค. ๒๕๔๕
อนุตรจิต	nous (Gk.)	๒ มี.ค. ๒๕๔๕
อนุบท	consequent	๒ มี.ค. ๒๕๔๕
อนุปรากฏการณ์นิยม	epiphenomenalism	๒ มี.ค. ๒๕๔๕
อุจเฉททิฐิ	anihilism	๒ มี.ค. ๒๕๔๕
อุจเฉทนิยม	anihilism	๒ มี.ค. ๒๕๔๕
อุตรเอกภาพแห่งวิสัญชาน	transcendental unity of apperception	๒ มี.ค. ๒๕๔๕
อุตมรัฐ	utopia	๒ มี.ค. ๒๕๔๕
อุตมรัฐนิยม	utopianism	๒ มี.ค. ๒๕๔๕
อุตรภาพ	transcendence	๒ มี.ค. ๒๕๔๕
อุตรวิสัญชาน	transcendental apperception	๒ มี.ค. ๒๕๔๕
อุดมคติ	ideal	๒ มี.ค. ๒๕๔๕
อุตรอัตตาแห่งวิสัญชาน	transcendental ego of apperception	๒ มี.ค. ๒๕๔๕
อุบัติวิวัฒนาการ	emergent evolution	๒ มี.ค. ๒๕๔๕
อุปกรณ์นิยม	instrumentalism	๒ มี.ค. ๒๕๔๕
อุปนัย	inductive	๒ มี.ค. ๒๕๔๕
judgement; judgment	พินิศจัย, การตัดสิน	๒ มี.ค. ๒๕๔๕
judgement, aesthetic; judgment, aesthetic	การตัดสินเชิงสุนทรียภาพ	๒ มี.ค. ๒๕๔๕
judgment; judgement	พินิศจัย, การตัดสิน	๒ มี.ค. ๒๕๔๕
judgment, aesthetic; judgement, aesthetic	การตัดสินเชิงสุนทรียภาพ	๒ มี.ค. ๒๕๔๕
justice	ความยุติธรรม	๒ มี.ค. ๒๕๔๕
justification	การให้เหตุผล	๒ มี.ค. ๒๕๔๕
justice, corrective	ความยุติธรรมเพื่อแก้ไขความประพฤติ	๒ มี.ค. ๒๕๔๕
justice, distributive	ความยุติธรรมในการจัดสรร	๒ มี.ค. ๒๕๔๕
justice, retributive	ความยุติธรรมเพื่อสนองตอบ	๒ มี.ค. ๒๕๔๕
justice, utilitarian	ความยุติธรรมทางประโยชน์นิยม	๒ มี.ค. ๒๕๔๕
knower	ผู้รู้	๒ มี.ค. ๒๕๔๕
knowledge	ความรู้	๒ มี.ค. ๒๕๔๕
knowledge by acquaintance	ความรู้โดยประจักษ์	๒ มี.ค. ๒๕๔๕
knowledge by description	ความรู้โดยบอกเล่า	๒ มี.ค. ๒๕๔๕
knowledge, a posteriori	ความรู้หลังประสบการณ์	๒ มี.ค. ๒๕๔๕
knowledge, a priori	ความรู้ก่อนประสบการณ์	๒ มี.ค. ๒๕๔๕
knowledge, empirical	ความรู้เชิงประจักษ์, ความรู้เชิงประสบการณ์	๒ มี.ค. ๒๕๔๕
knowledge, immediate	ความรู้โดยตรง	๒ มี.ค. ๒๕๔๕
knowledge, object of	สิ่งที่ถูกรู้, อารมณ์	๒ มี.ค. ๒๕๔๕
knowledge, objective	ความรู้เชิงปรวิสัย, ความรู้เชิงวัตถุวิสัย	๒ มี.ค. ๒๕๔๕
knowledge, subjective	ความรู้เชิงอัตวิสัย, ความรู้เชิงจิตวิสัย	๒ มี.ค. ๒๕๔๕
knowledge, theory of	ญาณวิทยา	๒ มี.ค. ๒๕๔๕
known	สิ่งที่ถูกรู้	๒ มี.ค. ๒๕๔๕
language, object	กรรมภาษา	๒ มี.ค. ๒๕๔๕
latency	ภาวะแฝง	๒ มี.ค. ๒๕๔๕
law of excluded middle	กฎนิรมัชฌิม	๒ มี.ค. ๒๕๔๕
law of identity	กฎเอกลักษณ์	๒ มี.ค. ๒๕๔๕
law	๑. กฎ<br/>๒. กฎหมาย	๒ มี.ค. ๒๕๔๕
law of parsimony	กฎการประหยัด	๒ มี.ค. ๒๕๔๕
law, natural	กฎธรรมชาติ	๒ มี.ค. ๒๕๔๕
laws of association	กฎสนธิการ	๒ มี.ค. ๒๕๔๕
liberalism	เสรีนิยม	๒ มี.ค. ๒๕๔๕
liberation	การหลุดพ้น	๒ มี.ค. ๒๕๔๕
libertarianism	อิสรเสรีนิยม	๒ มี.ค. ๒๕๔๕
liberty	เสรีธรรม	๒ มี.ค. ๒๕๔๕
logic	ตรรกศาสตร์, ตรรกวิทยา	๒ มี.ค. ๒๕๔๕
logic, mathematical	คณิตตรรกศาสตร์, คณิตตรรกวิทยา	๒ มี.ค. ๒๕๔๕
logic, modal	ตรรกศาสตร์อัญรูป, ตรรกวิทยาอัญรูป	๒ มี.ค. ๒๕๔๕
logic, symbolic	ตรรกศาสตร์สัญลักษณ์, ตรรกวิทยาสัญลักษณ์	๒ มี.ค. ๒๕๔๕
logical empiricism	ประสบการณ์นิยมเชิงตรรก	๒ มี.ค. ๒๕๔๕
Logos	๑. กฎจักรวาล<br/>๒. พระวจนะ	๒ มี.ค. ๒๕๔๕
logos	คำพูด, ถ้อยคำ	๒ มี.ค. ๒๕๔๕
logomachy	การประคารม	๒ มี.ค. ๒๕๔๕
logical positivism	ปฏิฐานนิยมเชิงตรรก	๒ มี.ค. ๒๕๔๕
logical term	คำตรรก	๒ มี.ค. ๒๕๔๕
logical truth	ตรรกสัจจะ, ความจริงเชิงตรรก	๒ มี.ค. ๒๕๔๕
major premise; major premiss	ข้อตั้งหลัก	๒ มี.ค. ๒๕๔๕
major premiss; major premise	ข้อตั้งหลัก	๒ มี.ค. ๒๕๔๕
major term	คำหลัก, พจน์หลัก	๒ มี.ค. ๒๕๔๕
Marxism	ลัทธิมาร์กซิสต์	๒ มี.ค. ๒๕๔๕
material cause	วัสดุเหตุ, วัสดุปัจจัย	๒ มี.ค. ๒๕๔๕
materialism	วัตถุนิยม, สสารนิยม	๒ มี.ค. ๒๕๔๕
materialism, dialectical	วัตถุนิยมปฏิพัฒนาการ	๒ มี.ค. ๒๕๔๕
materialism, historical	วัตถุนิยมทางประวัติศาสตร์, สสารนิยมทางประวัติศาสตร์	๒ มี.ค. ๒๕๔๕
mathematical logic	คณิตตรรกศาสตร์, คณิตตรรกวิทยา	๒ มี.ค. ๒๕๔๕
matter	สสาร	๒ มี.ค. ๒๕๔๕
maxim	คติบท	๒ มี.ค. ๒๕๔๕
mean	มัชฌิม	๒ มี.ค. ๒๕๔๕
mean, doctrine of the	หลักมัชฌิม	๒ มี.ค. ๒๕๔๕
means	วิธีการ, วิถีทาง	๒ มี.ค. ๒๕๔๕
mechanism	จักรกลนิยม	๒ มี.ค. ๒๕๔๕
meditation	๑. สมาธิ, การเข้าสมาธิ<br/>๒. การรำพึงธรรม	๒ มี.ค. ๒๕๔๕
meliorism	วรนิยม	๒ มี.ค. ๒๕๔๕
mental phenomena	ปรากฏการณ์ทางจิต	๒ มี.ค. ๒๕๔๕
mentalism	มโนนิยม	๒ มี.ค. ๒๕๔๕
metaethics	อภิจริยศาสตร์	๒ มี.ค. ๒๕๔๕
metaphysics	อภิปรัชญา	๒ มี.ค. ๒๕๔๕
metalanguage	อภิภาษา	๒ มี.ค. ๒๕๔๕
metalogic	อภิตรรกศาสตร์, อภิตรรกวิทยา	๒ มี.ค. ๒๕๔๕
metamathematics	อภิคณิตศาสตร์	๒ มี.ค. ๒๕๔๕
metempsychosis	การเวียนว่ายตายเกิด	๒ มี.ค. ๒๕๔๕
methodological individualism	วิธิปัจเจกนิยม	๒ มี.ค. ๒๕๔๕
methodological solipsism	วิธิเอกัตนิยม	๒ มี.ค. ๒๕๔๕
methodology	วิธีวิทยา	๒ มี.ค. ๒๕๔๕
methodology, solipsistic	วิธิเอกัตนิยม	๒ มี.ค. ๒๕๔๕
middle term	คำกลาง, พจน์กลาง	๒ มี.ค. ๒๕๔๕
middle way	ทางสายกลาง, มัชฌิมาปฏิปทา	๒ มี.ค. ๒๕๔๕
mind	จิต	๒ มี.ค. ๒๕๔๕
mind, absolute	จิตสัมบูรณ์	๒ มี.ค. ๒๕๔๕
mind-body relation	ความสัมพันธ์ระหว่างกายกับจิต	๒ มี.ค. ๒๕๔๕
minor premise; minor premiss	ข้อตั้งรอง	๒ มี.ค. ๒๕๔๕
minor term	คำรอง, พจน์รอง	๒ มี.ค. ๒๕๔๕
mode	อัญรูป	๒ มี.ค. ๒๕๔๕
modal logic	ตรรกศาสตร์อัญรูป, ตรรกวิทยาอัญรูป	๒ มี.ค. ๒๕๔๕
monad	โมนาด	๒ มี.ค. ๒๕๔๕
monism	เอกนิยม	๒ มี.ค. ๒๕๔๕
monotheism	เอกเทวนิยม	๒ มี.ค. ๒๕๔๕
moral	ทางศีลธรรม	๒ มี.ค. ๒๕๔๕
moralities	หลักศีลธรรม	๒ มี.ค. ๒๕๔๕
morality	ศีลธรรม	๒ มี.ค. ๒๕๔๕
morals	หลักจริยธรรม	๒ มี.ค. ๒๕๔๕
mores	จารีต	๒ มี.ค. ๒๕๔๕
motivation	การจูงใจ, แรงจูงใจ	๒ มี.ค. ๒๕๔๕
motive	เหตุจูงใจ	๒ มี.ค. ๒๕๔๕
mythology	๑. ประมวลเรื่องปรัมปรา<br/>๒. ปรัมปราวิทยา, ปุราณวิทยา	๒ มี.ค. ๒๕๔๕
mystic	รหัสยิก	๒ มี.ค. ๒๕๔๕
mystical	เชิงรหัสยะ	๒ มี.ค. ๒๕๔๕
mysticism	รหัสยลัทธิ	๒ มี.ค. ๒๕๔๕
myth	เรื่องปรัมปรา	๒ มี.ค. ๒๕๔๕
naive realism	สัจนิยมสามัญ	๒ มี.ค. ๒๕๔๕
natural law	กฎธรรมชาติ	๒ มี.ค. ๒๕๔๕
naturalistic fallacy	ความผิดพลาดของธรรมชาตินิยม	๒ มี.ค. ๒๕๔๕
naturalism	ธรรมชาตินิยม	๒ มี.ค. ๒๕๔๕
naturalism, ethical	ธรรมชาตินิยมทางจริยศาสตร์	๒ มี.ค. ๒๕๔๕
naturalistic ethics	จริยศาสตร์แบบธรรมชาตินิยม	๒ มี.ค. ๒๕๔๕
nature, uniformity of	ภาวะเอกรูปแห่งธรรมชาติ	๒ มี.ค. ๒๕๔๕
nescience	ความไม่อาจรู้ได้	๒ มี.ค. ๒๕๔๕
nihilism	สุญนิยม	๒ มี.ค. ๒๕๔๕
nominalism	นามนิยม	๒ มี.ค. ๒๕๔๕
non-Being; non-being	อสัต, อภาวะ	๒ มี.ค. ๒๕๔๕
non-ego; non-self	อนัตตา	๒ มี.ค. ๒๕๔๕
non-self; non-ego	อนัตตา	๒ มี.ค. ๒๕๔๕
norm	ปทัฏฐาน, ปทัสถาน, บรรทัดฐาน	๒ มี.ค. ๒๕๔๕
normative	เชิงปทัฏฐาน, เชิงปทัสถาน, เชิงบรรทัดฐาน	๒ มี.ค. ๒๕๔๕
noumena (pl.); noumenon	นูเมนอน	๒ มี.ค. ๒๕๔๕
noumenon; noumena (pl.)	นูเมนอน	๒ มี.ค. ๒๕๔๕
nous (Gk.)	อนุตรจิต	๒ มี.ค. ๒๕๔๕
object language	กรรมภาษา	๒ มี.ค. ๒๕๔๕
object of consciousness; object of knowledge	สิ่งที่ถูกรู้, อารมณ์	๒ มี.ค. ๒๕๔๕
object of knowledge; object of consciousness	สิ่งที่ถูกรู้, อารมณ์	๒ มี.ค. ๒๕๔๕
objective	วัตถุวิสัย, ปรวิสัย, ปรนัย	๒ มี.ค. ๒๕๔๕
objective idealism	จิตนิยมวัตถุวิสัย, จิตนิยมปรวิสัย	๒ มี.ค. ๒๕๔๕
objective knowledge	ความรู้เชิงปรวิสัย ความรู้เชิงวัตถุวิสัย	๒ มี.ค. ๒๕๔๕
obligation	พันธะ, ข้อผูกพัน	๒ มี.ค. ๒๕๔๕
occasionaslism	โอกาสนิยม	๒ มี.ค. ๒๕๔๕
Occam’s razor; Ockam’s razor; Ockham’s razor	มีดโกนอ็อกคัม	๒ มี.ค. ๒๕๔๕
Ockam’s razor; Occam’s razor; Ockham’s razor	มีดโกนอ็อกคัม	๒ มี.ค. ๒๕๔๕
Ockham’s razor; Occam’s razor; Ockam’s razor	มีดโกนอ็อกคัม	๒ มี.ค. ๒๕๔๕
omniscience	สัพพัญญุตา	๒ มี.ค. ๒๕๔๕
omniscient	สัพพัญญู	๒ มี.ค. ๒๕๔๕
ontological argument; ontological proof	การให้เหตุผลทางภววิทยา, ข้อพิสูจน์ทางภววิทยา	๒ มี.ค. ๒๕๔๕
ontological proof; ontological argument	การให้เหตุผลทางภววิทยา, ข้อพิสูจน์ทางภววิทยา	๒ มี.ค. ๒๕๔๕
ontology	ภววิทยา	๒ มี.ค. ๒๕๔๕
optimism	สุทรรศนนิยม, สุนิยม	๒ มี.ค. ๒๕๔๕
organism	องคาพยพ, อินทรียภาพ	๒ มี.ค. ๒๕๔๕
orthodox	ทรรศนะดั้งเดิม	๒ มี.ค. ๒๕๔๕
ostensive definition	การนิยามโดยยกตัวอย่าง	๒ มี.ค. ๒๕๔๕
pain	ทุกขารมณ์	๒ มี.ค. ๒๕๔๕
pantheism	สรรพเทวนิยม	๒ มี.ค. ๒๕๔๕
panpsychism	สรรพจิตนิยม	๒ มี.ค. ๒๕๔๕
paradoxes, Zeno’s	ปฏิทรรศน์ของซีโน	๒ มี.ค. ๒๕๔๕
paradox	ปฏิทรรศน์	๒ มี.ค. ๒๕๔๕
paradox, Russell’s	ปฏิทรรศน์ของรัสเซลล์	๒ มี.ค. ๒๕๔๕
parallelism	ลัทธิขนาน	๒ มี.ค. ๒๕๔๕
parallelism, psycho-physical	ลัทธิขนานระหว่างกายกับจิต	๒ มี.ค. ๒๕๔๕
parsimony, law of	กฎการประหยัด	๒ มี.ค. ๒๕๔๕
particular	เฉพาะราย, เฉพาะส่วน, สิ่งเฉพาะ	๒ มี.ค. ๒๕๔๕
particular proposition	ประพจน์เฉพาะ, ญัตติเฉพาะ	๒ มี.ค. ๒๕๔๕
passion	กัมมภาวะ	๒ มี.ค. ๒๕๔๕
passive	อกัมมันต์	๒ มี.ค. ๒๕๔๕
passivity	อกัมมันตภาพ	๒ มี.ค. ๒๕๔๕
perceive	กำหนดรู้, รับรู้	๒ มี.ค. ๒๕๔๕
perception	สัญชาน	๒ มี.ค. ๒๕๔๕
perception, theories of	ทฤษฎีสัญชาน	๒ มี.ค. ๒๕๔๕
personality	บุคลิกภาพ	๒ มี.ค. ๒๕๔๕
personalism	บุคคลลักษณนิยม	๒ มี.ค. ๒๕๔๕
pessimism	ทุทรรศนนิยม, ทุนิยม	๒ มี.ค. ๒๕๔๕
phenomena (pl.); phenomenon	ปรากฏการณ์	๒ มี.ค. ๒๕๔๕
phenomena, mental	ปรากฏการณ์ทางจิต	๒ มี.ค. ๒๕๔๕
phenomenalism	ปรากฏการณ์นิยม	๒ มี.ค. ๒๕๔๕
phenomenology	ปรากฏการณ์วิทยา	๒ มี.ค. ๒๕๔๕
phenomenon; phenomena (pl.)	ปรากฏการณ์	๒ มี.ค. ๒๕๔๕
philosophy, political	ปรัชญาการเมือง	๒ มี.ค. ๒๕๔๕
philosophy, process	ปรัชญากระบวนการ	๒ มี.ค. ๒๕๔๕
philosophy, social	ปรัชญาสังคม	๒ มี.ค. ๒๕๔๕
Platonic idealism	จิตนิยมแบบเพลโต	๒ มี.ค. ๒๕๔๕
pleasure	สุขารมณ์	๒ มี.ค. ๒๕๔๕
pluralism	พหุนิยม	๒ มี.ค. ๒๕๔๕
political philosophy	ปรัชญาการเมือง	๒ มี.ค. ๒๕๔๕
polytheism	พหุเทวนิยม	๒ มี.ค. ๒๕๔๕
positivism	ปฏิฐานนิยม	๒ มี.ค. ๒๕๔๕
positivism, logical	ปฏิฐานนิยมเชิงตรรก	๒ มี.ค. ๒๕๔๕
postulate	มูลบท	๒ มี.ค. ๒๕๔๕
potency	ศักยภาวะ, พลัง	๒ มี.ค. ๒๕๔๕
potential	ศักยะ	๒ มี.ค. ๒๕๔๕
potentiality	ศักยภาพ, ภาวะแฝง	๒ มี.ค. ๒๕๔๕
pragmatic theory of truth	ทฤษฎีความจริงแบบปฏิบัตินิยม	๒ มี.ค. ๒๕๔๕
pragmatism	ปฏิบัตินิยม	๒ มี.ค. ๒๕๔๕
predestination	พรหมลิขิต, เทวลิขิต	๒ มี.ค. ๒๕๔๕
premise; premiss	ข้อตั้ง	๒ มี.ค. ๒๕๔๕
premise, major; premiss, major	ข้อตั้งหลัก	๒ มี.ค. ๒๕๔๕
premise, minor; premiss, minor	ข้อตั้งรอง	๒ มี.ค. ๒๕๔๕
premiss; premise	ข้อตั้ง	๒ มี.ค. ๒๕๔๕
premiss, major; premise, major	ข้อตั้งหลัก	๒ มี.ค. ๒๕๔๕
premiss, minor; premise, minor	ข้อตั้งรอง	๒ มี.ค. ๒๕๔๕
primary quality	คุณสมบัติปฐมภูมิ	๒ มี.ค. ๒๕๔๕
principle, falsifiability	หลักพิสูจน์ว่าเป็นเท็จ	๒ มี.ค. ๒๕๔๕
principle, first	ปฐมธาตุ	๒ มี.ค. ๒๕๔๕
principle, verifiability	หลักพิสูจน์ว่าเป็นจริง	๒ มี.ค. ๒๕๔๕
principle	หลักการ	๒ มี.ค. ๒๕๔๕
process philosophy	ปรัชญากระบวนการ	๒ มี.ค. ๒๕๔๕
proof, ontological	การให้เหตุผลทางภววิทยา, ข้อพิสูจน์ทางภววิทยา	๒ มี.ค. ๒๕๔๕
proposition	ประพจน์, ญัตติ	๒ มี.ค. ๒๕๔๕
proposition, particular	ประพจน์เฉพาะ, ญัตติเฉพาะ	๒ มี.ค. ๒๕๔๕
proposition, universal	ประพจน์สากล, ญัตติสากล	๒ มี.ค. ๒๕๔๕
pseudo-statement	ข้อความเทียม	๒ มี.ค. ๒๕๔๕
psycho-physical parallelism	ลัทธิขนานระหว่างกายกับจิต	๒ มี.ค. ๒๕๔๕
psychologism	จิตวิทยานิยม	๒ มี.ค. ๒๕๔๕
Pure Act	กิริยภาพบริสุทธิ์	๒ มี.ค. ๒๕๔๕
quality	๑. คุณภาพ<br/>๒. คุณสมบัติ	๒ มี.ค. ๒๕๔๕
quality, primary	คุณสมบัติปฐมภูมิ	๒ มี.ค. ๒๕๔๕
quality, secondary	คุณสมบัติทุติยภูมิ	๒ มี.ค. ๒๕๔๕
quantification	การกำหนดปริมาณ	๒ มี.ค. ๒๕๔๕
quantity	ปริมาณ	๒ มี.ค. ๒๕๔๕
rationalism	เหตุผลนิยม	๒ มี.ค. ๒๕๔๕
rationalization	การหาเหตุผลเข้าข้างตนเอง	๒ มี.ค. ๒๕๔๕
razor, Occam’s; razor, Ockam’s; razor, Ockham’s	มีดโกนอ็อกคัม	๒ มี.ค. ๒๕๔๕
razor, Ockam’s; razor, Occam’s; razor, Ockham’s	มีดโกนอ็อกคัม	๒ มี.ค. ๒๕๔๕
razor, Ockham’s; razor, Occam’s; razor, Ockam’s	มีดโกนอ็อกคัม	๒ มี.ค. ๒๕๔๕
reactionary	พวกปฏิกิริยา	๒ มี.ค. ๒๕๔๕
real	เป็นจริง	๒ มี.ค. ๒๕๔๕
realism	สัจนิยม	๒ มี.ค. ๒๕๔๕
realism, naive	สัจนิยมสามัญ	๒ มี.ค. ๒๕๔๕
reality	๑. ความเป็นจริง<br/>๒. สิ่งเป็นจริง	๒ มี.ค. ๒๕๔๕
reality, ultimate	ความเป็นจริงอันติมะ	๒ มี.ค. ๒๕๔๕
reductionism; reductivism	คตินิยมลดทอน	๒ มี.ค. ๒๕๔๕
reflection	การไตร่ตรอง	๒ มี.ค. ๒๕๔๕
relation, mind-body	ความสัมพันธ์ระหว่างกายกับจิต	๒ มี.ค. ๒๕๔๕
relative	สัมพัทธ์	๒ มี.ค. ๒๕๔๕
relativism	สัมพัทธนิยม	๒ มี.ค. ๒๕๔๕
representative theory	ทฤษฎีตัวแทน	๒ มี.ค. ๒๕๔๕
retributive justice	ความยุติธรรมเพื่อสนองตอบ	๒ มี.ค. ๒๕๔๕
revelation	วิวรณ์	๒ มี.ค. ๒๕๔๕
romanticism	จินตนิยม, ลัทธิโรแมนติก	๒ มี.ค. ๒๕๔๕
Russell’s paradox	ปฏิทรรศน์ของรัสเซลล์	๒ มี.ค. ๒๕๔๕
sceptic; skeptic	นักวิมตินิยม, นักกังขาคติ	๒ มี.ค. ๒๕๔๕
scepticism; skepticism	วิมตินิยม, กังขาคติ	๒ มี.ค. ๒๕๔๕
secondary quality	คุณสมบัติทุติยภูมิ	๒ มี.ค. ๒๕๔๕
selective theory of perception	ทฤษฎีสัญชานเชิงเลือกสรร	๒ มี.ค. ๒๕๔๕
self-evident	ประจักษ์ชัดในตัว	๒ มี.ค. ๒๕๔๕
self	อัตตา, ตัวตน	๒ มี.ค. ๒๕๔๕
self-consciousness	อัตพิชาน, ความสำนึกตน	๒ มี.ค. ๒๕๔๕
self-contradiction	ความขัดแย้งในตัว	๒ มี.ค. ๒๕๔๕
semantics	อรรถศาสตร์	๒ มี.ค. ๒๕๔๕
sensation	ผัสสาการ, เพทนาการ	๒ มี.ค. ๒๕๔๕
sensationalism; sensationism	ผัสสาการนิยม	๒ มี.ค. ๒๕๔๕
sensationism; sensationalism	ผัสสาการนิยม	๒ มี.ค. ๒๕๔๕
sense	ประสาทสัมผัส	๒ มี.ค. ๒๕๔๕
sense-data	ข้อมูลทางประสาทสัมผัส	๒ มี.ค. ๒๕๔๕
sense-objects	สิ่งที่ถูกรู้, อารมณ์	๒ มี.ค. ๒๕๔๕
sensibile (L.)	สิ่งที่รู้ได้ทางประสาทสัมผัส	๒ มี.ค. ๒๕๔๕
sensible	ที่รู้ได้ทางประสาทสัมผัส	๒ มี.ค. ๒๕๔๕
set	เซต	๒ มี.ค. ๒๕๔๕
set theory	ทฤษฎีเซต	๒ มี.ค. ๒๕๔๕
skeptic; sceptic	นักวิมตินิยม, นักกังขาคติ	๒ มี.ค. ๒๕๔๕
skepticism; scepticism	วิมตินิยม, กังขาคติ	๒ มี.ค. ๒๕๔๕
social philosophy	ปรัชญาสังคม	๒ มี.ค. ๒๕๔๕
socialism	สังคมนิยม	๒ มี.ค. ๒๕๔๕
solipsism	เอกัตนิยม	๒ มี.ค. ๒๕๔๕
solipsism, methodological; solipsistic methodology	วิธิเอกัตนิยม	๒ มี.ค. ๒๕๔๕
solipsistic methodology; solipsism, methodological	วิธิเอกัตนิยม	๒ มี.ค. ๒๕๔๕
soul	วิญญาณ	๒ มี.ค. ๒๕๔๕
soul, world	วิญญาณโลก	๒ มี.ค. ๒๕๔๕
space	อวกาศ	๒ มี.ค. ๒๕๔๕
species	ชนิด	๒ มี.ค. ๒๕๔๕
speculation	การคาดคะเน, การเก็งความจริง	๒ มี.ค. ๒๕๔๕
spirit	จิต	๒ มี.ค. ๒๕๔๕
spiritualism	เจตนิยม	๒ มี.ค. ๒๕๔๕
statement, analytic	ข้อความวิเคราะห์	๒ มี.ค. ๒๕๔๕
statement, categorical	ข้อความเด็ดขาด	๒ มี.ค. ๒๕๔๕
statement, pseudo-	ข้อความเทียม	๒ มี.ค. ๒๕๔๕
statement, statistical	ข้อความสถิติ	๒ มี.ค. ๒๕๔๕
statement, synthetic	ข้อความสังเคราะห์	๒ มี.ค. ๒๕๔๕
statistical statement	ข้อความสถิติ	๒ มี.ค. ๒๕๔๕
statistical syllogism	ตรรกบทสถิติ, ปรัตถานุมานสถิติ	๒ มี.ค. ๒๕๔๕
stoicism	ลัทธิสโตอิก	๒ มี.ค. ๒๕๔๕
struggle, class	การต่อสู้ระหว่างชนชั้น	๒ มี.ค. ๒๕๔๕
subjective	จิตวิสัย, อัตวิสัย, อัตนัย	๒ มี.ค. ๒๕๔๕
subjective idealism	จิตนิยมอัตวิสัย	๒ มี.ค. ๒๕๔๕
subjective knowledge	ความรู้เชิงอัตวิสัย, ความรู้เชิงจิตวิสัย	๒ มี.ค. ๒๕๔๕
substance	สาระ, แก่น	๒ มี.ค. ๒๕๔๕
summum bonum	สิ่งประเสริฐสุด	๒ มี.ค. ๒๕๔๕
supernatural	เหนือธรรมชาติ	๒ มี.ค. ๒๕๔๕
syllogism	ตรรกบท, ปรัตถานุมาน	๒ มี.ค. ๒๕๔๕
syllogism, categorical	ตรรกบทเด็ดขาด, ปรัตถานุมานเด็ดขาด	๒ มี.ค. ๒๕๔๕
syllogism, statistical	ตรรกบทสถิติ, ปรัตถานุมานสถิติ	๒ มี.ค. ๒๕๔๕
symbolic logic	ตรรกศาสตร์สัญลักษณ์, ตรรกวิทยาสัญลักษณ์	๒ มี.ค. ๒๕๔๕
synthesis	ภาวะสังเคราะห์	๒ มี.ค. ๒๕๔๕
synthetic statement	ข้อความสังเคราะห์	๒ มี.ค. ๒๕๔๕
tautology	ประพจน์ซ้ำความ	๒ มี.ค. ๒๕๔๕
teleology	อันตวิทยา	๒ มี.ค. ๒๕๔๕
term	คำ, พจน์	๒ มี.ค. ๒๕๔๕
term, minor	คำรอง, พจน์รอง	๒ มี.ค. ๒๕๔๕
term, logical	คำตรรก	๒ มี.ค. ๒๕๔๕
term, major	คำหลัก, พจน์หลัก	๒ มี.ค. ๒๕๔๕
term, middle	คำกลาง, พจน์กลาง	๒ มี.ค. ๒๕๔๕
theology	เทววิทยา	๒ มี.ค. ๒๕๔๕
theories of perception	ทฤษฎีสัญชาน	๒ มี.ค. ๒๕๔๕
theism	เทวนิยม	๒ มี.ค. ๒๕๔๕
theory, deontological	ทฤษฎีกรณียธรรม	๒ มี.ค. ๒๕๔๕
theory, representative	ทฤษฎีตัวแทน	๒ มี.ค. ๒๕๔๕
theory, set	ทฤษฎีเซต	๒ มี.ค. ๒๕๔๕
theory of knowledge	ญาณวิทยา	๒ มี.ค. ๒๕๔๕
theory of types	ทฤษฎีจัดระดับ	๒ มี.ค. ๒๕๔๕
thesis	ภาวะพื้นฐาน	๒ มี.ค. ๒๕๔๕
time	กาล	๒ มี.ค. ๒๕๔๕
transcendence	อุตรภาพ	๒ มี.ค. ๒๕๔๕
transcendental apperception	อุตรวิสัญชาน, วิสัญชานอุตรวิสัย	๒ มี.ค. ๒๕๔๕
transcendental ego of apperception	อุตรอัตตาแห่งวิสัญชาน	๒ มี.ค. ๒๕๔๕
transcendental idealism	จิตนิยมอุตรวิสัย	๒ มี.ค. ๒๕๔๕
transcendental unity of apperception	อุตรเอกภาพแห่งวิสัญชาน	๒ มี.ค. ๒๕๔๕
transmigration of soul	การเวียนว่ายตายเกิด	๒ มี.ค. ๒๕๔๕
truth	ความจริง	๒ มี.ค. ๒๕๔๕
truth, coherence theory of	ทฤษฎีความจริงแบบสหนัย	๒ มี.ค. ๒๕๔๕
truth, correspondence theory of	ทฤษฎีความจริงแบบสมนัย	๒ มี.ค. ๒๕๔๕
truth, empirical	ความจริงเชิงประจักษ์, ความจริงเชิงประสบการณ์	๒ มี.ค. ๒๕๔๕
truth, logical	ตรรกสัจจะ, ความจริงเชิงตรรก	๒ มี.ค. ๒๕๔๕
truth, pragmatic theory of	ทฤษฎีความจริงแบบปฏิบัตินิยม	๒ มี.ค. ๒๕๔๕
truth, ultimate	ปรมัตถสัจ, อันติมสัจ	๒ มี.ค. ๒๕๔๕
truth-value	ค่าความจริง	๒ มี.ค. ๒๕๔๕
types, theory of	ทฤษฎีจัดระดับ	๒ มี.ค. ๒๕๔๕
ultimate reality	ความเป็นจริงอันติมะ	๒ มี.ค. ๒๕๔๕
ultimate truth	ปรมัตถสัจ, อันติมสัจ	๒ มี.ค. ๒๕๔๕
ultimate	อันติมะ, ปรมัตถะ	๒ มี.ค. ๒๕๔๕
uniformity of nature	ภาวะเอกรูปแห่งธรรมชาติ	๒ มี.ค. ๒๕๔๕
universal	สิ่งสากล	๒ มี.ค. ๒๕๔๕
universe	เอกภพ	๒ มี.ค. ๒๕๔๕
universal proposition	ประพจน์สากล, ญัติสากล	๒ มี.ค. ๒๕๔๕
utilitarian justice	ความยุติธรรมทางประโยชน์นิยม	๒ มี.ค. ๒๕๔๕
utilitarianism	ประโยชน์นิยม	๒ มี.ค. ๒๕๔๕
utopia	อุตมรัฐ	๒ มี.ค. ๒๕๔๕
utopianism	อุตมรัฐนิยม	๒ มี.ค. ๒๕๔๕
validity	ความสมเหตุสมผล	๒ มี.ค. ๒๕๔๕
value	ค่า, คุณค่า	๒ มี.ค. ๒๕๔๕
value, aesthetic	คุณค่าทางสุนทรียภาพ	๒ มี.ค. ๒๕๔๕
value, extrinsic	ค่านอกตัว	๒ มี.ค. ๒๕๔๕
value, intrinsic	ค่าในตัว	๒ มี.ค. ๒๕๔๕
verifiability principle	หลักพิสูจน์ว่าเป็นจริง	๒ มี.ค. ๒๕๔๕
verifiable	ซึ่งอาจพิสูจน์ว่าเป็นจริง	๒ มี.ค. ๒๕๔๕
verification	การพิสูจน์ว่าเป็นจริง	๒ มี.ค. ๒๕๔๕
virtue	คุณธรรม	๒ มี.ค. ๒๕๔๕
virtue, cardinal	คุณธรรมหลัก	๒ มี.ค. ๒๕๔๕
vitalism	ชีวิตนิยม	๒ มี.ค. ๒๕๔๕
voluntarism	ลัทธิเจตจำนง	๒ มี.ค. ๒๕๔๕
way, middle	ทางสายกลาง, มัชฌิมาปฏิปทา	๒ มี.ค. ๒๕๔๕
will	เจตจำนง	๒ มี.ค. ๒๕๔๕
will, free	เจตจำนงเสรี	๒ มี.ค. ๒๕๔๕
world soul	วิญญาณโลก	๒ มี.ค. ๒๕๔๕
Zeno’s paradoxes	ปฏิทรรศน์ของซีโน	๒ มี.ค. ๒๕๔๕
ลัทธิโรแมนติก	romanticism	๒ มี.ค. ๒๕๔๕
ลัทธิมาร์กซิสต์	Marxism	๒ มี.ค. ๒๕๔๕
ลัทธิเจตจำนง	voluntarism	๒ มี.ค. ๒๕๔๕
ลัทธิสโตอิก	stoicism	๒ มี.ค. ๒๕๔๕
ลัทธิองค์รวม	holism	๒ มี.ค. ๒๕๔๕
ลัทธิอื่น	heterodox	๒ มี.ค. ๒๕๔๕
ลัทธิขนาน	parallelism	๒ มี.ค. ๒๕๔๕
ลัทธิขนานระหว่างกายกับจิต	psycho-physical parallelism	๒ มี.ค. ๒๕๔๕
ลัทธิคอมมิวนิสต์	communism	๒ มี.ค. ๒๕๔๕
ลัทธิซีนิก	cynicism	๒ มี.ค. ๒๕๔๕
กรรมภาษา	object language	๒ มี.ค. ๒๕๔๕
กระฎุมพี	bourgeois	๒ มี.ค. ๒๕๔๕
กรณียธรรม	deontology	๒ มี.ค. ๒๕๔๕
กัมมภาวะ	passion	๒ มี.ค. ๒๕๔๕
กัมมันตภาพ	activity	๒ มี.ค. ๒๕๔๕
กัมมันต์	active	๒ มี.ค. ๒๕๔๕
กังขาคติ	scepticism; skepticism	๒ มี.ค. ๒๕๔๕
กัตตุภาวะ	action	๒ มี.ค. ๒๕๔๕
กาย	body	๒ มี.ค. ๒๕๔๕
การเวียนว่ายตายเกิด	metempsychosis; transmigration of soul	๒ มี.ค. ๒๕๔๕
การให้เหตุผล	argument; justification	๒ มี.ค. ๒๕๔๕
การให้เหตุผลโดยอาศัยแนวเทียบ	argument by analogy	๒ มี.ค. ๒๕๔๕
การให้เหตุผลทางภววิทยา	ontological argument; ontological proof	๒ มี.ค. ๒๕๔๕
การรับรู้ขั้นต้น	apprehension	๒ มี.ค. ๒๕๔๕
การรำพึงธรรม	meditation	๒ มี.ค. ๒๕๔๕
การรู้เอง	intuition	๒ มี.ค. ๒๕๔๕
การรู้แจ้ง	enlightenment	๒ มี.ค. ๒๕๔๕
การเก็งความจริง	speculation	๒ มี.ค. ๒๕๔๕
การเข้าสมาธิ	meditation	๒ มี.ค. ๒๕๔๕
การเข้าฌาน	contemplation	๒ มี.ค. ๒๕๔๕
การเนรมิต	creation	๒ มี.ค. ๒๕๔๕
การแปรเปลี่ยน	becoming	๒ มี.ค. ๒๕๔๕
การเพ่งพินิจ	contemplation	๒ มี.ค. ๒๕๔๕
การสร้าง	creation	๒ มี.ค. ๒๕๔๕
การส่อความ	implication	๒ มี.ค. ๒๕๔๕
การหาเหตุผลเข้าข้างตนเอง	rationalization	๒ มี.ค. ๒๕๔๕
การหลุดพ้น	liberation	๒ มี.ค. ๒๕๔๕
การอนุมาน	inference	๒ มี.ค. ๒๕๔๕
การอุบัติ	emergence	๒ มี.ค. ๒๕๔๕
การอุปนัย	induction	๒ มี.ค. ๒๕๔๕
กิริยภาพบริสุทธิ์	Pure Act	๒ มี.ค. ๒๕๔๕
การไตร่ตรอง	reflection	๒ มี.ค. ๒๕๔๕
การกระจาย	distribution	๒ มี.ค. ๒๕๔๕
การกำหนดปริมาณ	quantification	๒ มี.ค. ๒๕๔๕
การกลายเป็นภาวะจริง	actualization	๒ มี.ค. ๒๕๔๕
การคาดคะเน	speculation	๒ มี.ค. ๒๕๔๕
การจูงใจ	motivation	๒ มี.ค. ๒๕๔๕
การดำรงอยู่	existence	๒ มี.ค. ๒๕๔๕
การตรัสรู้	enlightenment	๒ มี.ค. ๒๕๔๕
การต่อสู้ระหว่างชนชั้น	class struggle	๒ มี.ค. ๒๕๔๕
การตัดสิน	judgement; judgment	๒ มี.ค. ๒๕๔๕
การตัดสินเชิงสุนทรียภาพ	aesthetic judgment; aesthetic judgement	๒ มี.ค. ๒๕๔๕
การติดข้อง	bondage	๒ มี.ค. ๒๕๔๕
การถกเถียง	argument	๒ มี.ค. ๒๕๔๕
การนิยามโดยยกตัวอย่าง	ostensive definition	๒ มี.ค. ๒๕๔๕
การนิรนัย	deduction	๒ มี.ค. ๒๕๔๕
การประคารม	logomachy	๒ มี.ค. ๒๕๔๕
การปรับสภาวะ	conditioning	๒ มี.ค. ๒๕๔๕
การปรุงแต่ง	constitution	๒ มี.ค. ๒๕๔๕
การพิสูจน์ว่าเป็นเท็จ	falsification	๒ มี.ค. ๒๕๔๕
การพิสูจน์ว่าเป็นจริง	verification	๒ มี.ค. ๒๕๔๕
การพิจารณากำหนด	determination	๒ มี.ค. ๒๕๔๕
การพินิจภายใน	introspection	๒ มี.ค. ๒๕๔๕
กำหนดรู้	perceive	๒ มี.ค. ๒๕๔๕
กาล	time	๒ มี.ค. ๒๕๔๕
กลุ่มกอง	aggregate	๒ มี.ค. ๒๕๔๕
กฎ	law	๒ มี.ค. ๒๕๔๕
กฎเอกลักษณ์	law of identity	๒ มี.ค. ๒๕๔๕
กฎหมาย	law	๒ มี.ค. ๒๕๔๕
กฎสนธิการ	laws of association	๒ มี.ค. ๒๕๔๕
กฎการประหยัด	law of parsimony	๒ มี.ค. ๒๕๔๕
กฎจักรวาล	Logos	๒ มี.ค. ๒๕๔๕
กฎธรรมชาติ	natural law	๒ มี.ค. ๒๕๔๕
กฎนิรมัชฌิม	law of excluded middle	๒ มี.ค. ๒๕๔๕
ข้อมูลทางประสาทสัมผัส	sense-data	๒ มี.ค. ๒๕๔๕
ข้อโต้แย้ง	argument	๒ มี.ค. ๒๕๔๕
ข้อเท็จจริง	fact	๒ มี.ค. ๒๕๔๕
ข้อสรุป	conclusion	๒ มี.ค. ๒๕๔๕
ข้อสมมุติพื้นฐาน	assumption	๒ มี.ค. ๒๕๔๕
ข้อความเด็ดขาด	categorical statement	๒ มี.ค. ๒๕๔๕
ข้อความเทียม	pseudo-statement	๒ มี.ค. ๒๕๔๕
ข้อความวิเคราะห์	analytic statement	๒ มี.ค. ๒๕๔๕
ข้อความขัดแย้งในตัว	contradiction	๒ มี.ค. ๒๕๔๕
ข้อความสังเคราะห์	synthetic statement	๒ มี.ค. ๒๕๔๕
ข้อความสถิติ	statistical statement	๒ มี.ค. ๒๕๔๕
ข้อตั้ง	premise; premiss	๒ มี.ค. ๒๕๔๕
ข้อตั้งรอง	minor premise; minor premiss	๒ มี.ค. ๒๕๔๕
ข้อตั้งหลัก	major premise; major premiss	๒ มี.ค. ๒๕๔๕
ข้อตาม	consequent	๒ มี.ค. ๒๕๔๕
ข้อนำ	antecedent	๒ มี.ค. ๒๕๔๕
ข้อผูกพัน	obligation	๒ มี.ค. ๒๕๔๕
ข้อพิสูจน์ทางภววิทยา	ontological argument; ontological proof	๒ มี.ค. ๒๕๔๕
ขัดแย้งกัน	contradictory	๒ มี.ค. ๒๕๔๕
ขัดกัน	contrary	๒ มี.ค. ๒๕๔๕
ขันธ์	aggregate	๒ มี.ค. ๒๕๔๕
ความยับยั้ง	continence	๒ มี.ค. ๒๕๔๕
ความมีอยู่	existence	๒ มี.ค. ๒๕๔๕
ความรู้เชิงปรวิสัย	objective knowledge	๒ มี.ค. ๒๕๔๕
ความรู้เชิงประสบการณ์	empirical knowledge	๒ มี.ค. ๒๕๔๕
ความรู้เชิงประจักษ์	empirical knowledge	๒ มี.ค. ๒๕๔๕
ความรู้โดยตรง	immediate knowledge	๒ มี.ค. ๒๕๔๕
ความรู้โดยบอกเล่า	knowledge by description	๒ มี.ค. ๒๕๔๕
ความรู้โดยประจักษ์	knowledge by acquaintance	๒ มี.ค. ๒๕๔๕
ความรู้หลังประสบการณ์	a posteriori knowledge	๒ มี.ค. ๒๕๔๕
ความรู้	knowledge	๒ มี.ค. ๒๕๔๕
ความรู้เชิงวัตถุวิสัย	objective knowledge	๒ มี.ค. ๒๕๔๕
ความรู้เชิงอัตวิสัย	subjective knowledge	๒ มี.ค. ๒๕๔๕
ความรู้เชิงจิตวิสัย	subjective knowledge	๒ มี.ค. ๒๕๔๕
ความรู้ก่อนประสบการณ์	a priori knowledge	๒ มี.ค. ๒๕๔๕
ความเข้าใจซึ้ง	comprehension	๒ มี.ค. ๒๕๔๕
ความเคลื่อนคลาด	error	๒ มี.ค. ๒๕๔๕
ความเชื่อ	belief	๒ มี.ค. ๒๕๔๕
ความเป็นจริง	reality	๒ มี.ค. ๒๕๔๕
ความเป็นจริงอันติมะ	reality, ultimate	๒ มี.ค. ๒๕๔๕
ความเป็นจริงอันติมะ	ultimate reality	๒ มี.ค. ๒๕๔๕
ความเปลี่ยนแปลง	change	๒ มี.ค. ๒๕๔๕
ความยุติธรรม	justice	๒ มี.ค. ๒๕๔๕
ความยุติธรรมในการจัดสรร	distributive justice	๒ มี.ค. ๒๕๔๕
ความยุติธรรมเพื่อแก้ไขความประพฤติ	corrective justice	๒ มี.ค. ๒๕๔๕
ความยุติธรรมเพื่อสนองตอบ	retributive justice	๒ มี.ค. ๒๕๔๕
ความยุติธรรมทางประโยชน์นิยม	utilitarian justice	๒ มี.ค. ๒๕๔๕
ความสมนัย	correspondence	๒ มี.ค. ๒๕๔๕
ความสมเหตุสมผล	validity	๒ มี.ค. ๒๕๔๕
ความสัมพันธ์ระหว่างกายกับจิต	mind-body relation	๒ มี.ค. ๒๕๔๕
ความสัมพันธ์ระหว่างกายกับจิต	relation, mind-body	๒ มี.ค. ๒๕๔๕
ความสำนึกเรื่องชั้นชน	class consciousness	๒ มี.ค. ๒๕๔๕
ความสำนึกตน	self-consciousness	๒ มี.ค. ๒๕๔๕
ความสุข	happiness	๒ มี.ค. ๒๕๔๕
ความอยู่กับร่องกับรอย	consistency	๒ มี.ค. ๒๕๔๕
ความไม่ยับยั้ง	incontinence	๒ มี.ค. ๒๕๔๕
ความไม่สมเหตุสมผล	invalidity	๒ มี.ค. ๒๕๔๕
ความไม่อาจรู้ได้	nescience	๒ มี.ค. ๒๕๔๕
ความขัดแย้ง	contradiction	๒ มี.ค. ๒๕๔๕
ความขัดแย้งในตัว	self-contradiction	๒ มี.ค. ๒๕๔๕
ความขัดกัน	contrariety	๒ มี.ค. ๒๕๔๕
ความกลมกลืน	consistency	๒ มี.ค. ๒๕๔๕
ความจริง	truth	๒ มี.ค. ๒๕๔๕
ความจริงเชิงตรรก	logical truth	๒ มี.ค. ๒๕๔๕
ความจริงเชิงประสบการณ์	empirical truth	๒ มี.ค. ๒๕๔๕
ความคงเส้นคงวา	consistency	๒ มี.ค. ๒๕๔๕
ความจริงเชิงประจักษ์	empirical truth	๒ มี.ค. ๒๕๔๕
ความชั่วร้าย	evil	๒ มี.ค. ๒๕๔๕
ความตระหนัก	awareness	๒ มี.ค. ๒๕๔๕
ความทะยานอยาก	appetite	๒ มี.ค. ๒๕๔๕
ความบรรสาน	harmony	๒ มี.ค. ๒๕๔๕
ความบังเอิญ	chance	๒ มี.ค. ๒๕๔๕
ความประทับ	impression	๒ มี.ค. ๒๕๔๕
ความประพฤติ	conduct	๒ มี.ค. ๒๕๔๕
ความผิดพลาดของธรรมชาตินิยม	naturalistic fallacy	๒ มี.ค. ๒๕๔๕
ค่า	value	๒ มี.ค. ๒๕๔๕
ค่าในตัว	intrinsic value	๒ มี.ค. ๒๕๔๕
ค่าความจริง	truth-value	๒ มี.ค. ๒๕๔๕
ค่านอกตัว	extrinsic value	๒ มี.ค. ๒๕๔๕
ค่านอกตัว	value, extrinsic	๒ มี.ค. ๒๕๔๕
คำ	term	๒ มี.ค. ๒๕๔๕
คำรอง	minor term	๒ มี.ค. ๒๕๔๕
คำสอนต้องเชื่อ	dogma	๒ มี.ค. ๒๕๔๕
คำสั่งมีเงื่อนไข	conditional imperative	๒ มี.ค. ๒๕๔๕
คำสั่งมีเงื่อนไข	hypothetical imperative	๒ มี.ค. ๒๕๔๕
คำสั่งมีเงื่อนไข	imperative, hypothetical	๒ มี.ค. ๒๕๔๕
คำสั่งเด็ดขาด	categorical imperative	๒ มี.ค. ๒๕๔๕
คำหลัก	major term	๒ มี.ค. ๒๕๔๕
คำกลาง	middle term	๒ มี.ค. ๒๕๔๕
คำตรรก	logical term	๒ มี.ค. ๒๕๔๕
คำพูด	logos	๒ มี.ค. ๒๕๔๕
คณิตตรรกวิทยา	mathematical logic	๒ มี.ค. ๒๕๔๕
คณิตตรรกศาสตร์	mathematical logic	๒ มี.ค. ๒๕๔๕
คตินิยม	ideology	๒ มี.ค. ๒๕๔๕
คตินิยมลดทอน	reductionism; reductivism	๒ มี.ค. ๒๕๔๕
คติบท	maxim	๒ มี.ค. ๒๕๔๕
คุณภาพ	quality	๒ มี.ค. ๒๕๔๕
คุณวิทยา	axiology	๒ มี.ค. ๒๕๔๕
คุณสมบัติ	quality	๒ มี.ค. ๒๕๔๕
คุณสมบัติทุติยภูมิ	secondary quality	๒ มี.ค. ๒๕๔๕
คุณสมบัติปฐมภูมิ	primary quality	๒ มี.ค. ๒๕๔๕
คุณลักษณะ	attribute	๒ มี.ค. ๒๕๔๕
คุณค่า	value	๒ มี.ค. ๒๕๔๕
คุณค่าทางสุนทรียภาพ	aesthetic value	๒ มี.ค. ๒๕๔๕
คุณธรรม	virtue	๒ มี.ค. ๒๕๔๕
คุณธรรมหลัก	cardinal virtue	๒ มี.ค. ๒๕๔๕
จริยศาสตร์	ethics	๒ มี.ค. ๒๕๔๕
จริยศาสตร์แบบธรรมชาตินิยม	naturalistic ethics	๒ มี.ค. ๒๕๔๕
จักรวาล	cosmos	๒ มี.ค. ๒๕๔๕
จักรวาลวิทยา	cosmology	๒ มี.ค. ๒๕๔๕
จักรวาลนิยม	cosmism	๒ มี.ค. ๒๕๔๕
จักรกลนิยม	mechanism	๒ มี.ค. ๒๕๔๕
จารีต	mores	๒ มี.ค. ๒๕๔๕
จิต	mind; spirit	๒ มี.ค. ๒๕๔๕
จิตวิสัย	subjective	๒ มี.ค. ๒๕๔๕
จิตวิทยานิยม	psychologism	๒ มี.ค. ๒๕๔๕
จิตสัมบูรณ์	absolute mind	๒ มี.ค. ๒๕๔๕
จิตนิยม	idealism	๒ มี.ค. ๒๕๔๕
จิตนิยมแบบเพลโต	Platonic idealism	๒ มี.ค. ๒๕๔๕
จิตนิยมวัตถุวิสัย	objective idealism	๒ มี.ค. ๒๕๔๕
จิตนิยมสัมบูรณ์	absolute idealism	๒ มี.ค. ๒๕๔๕
จิตนิยมอัตวิสัย	subjective idealism	๒ มี.ค. ๒๕๔๕
จิตนิยมอุตรวิสัย	transcendental idealism	๒ มี.ค. ๒๕๔๕
จิตนิยมปรวิสัย	objective idealism	๒ มี.ค. ๒๕๔๕
จินตภาพ	image	๒ มี.ค. ๒๕๔๕
จินตนิยม	romanticism	๒ มี.ค. ๒๕๔๕
จินตนาการ	imagination	๒ มี.ค. ๒๕๔๕
จุดหมายปลายทาง	end	๒ มี.ค. ๒๕๔๕
ฉันคิด เพราะฉะนั้น ฉันจึงมีอยู่จริง	cogito ergo sum	๒ มี.ค. ๒๕๔๕
ชะตานิยม	fatalism	๒ มี.ค. ๒๕๔๕
ชั่วร้าย	evil	๒ มี.ค. ๒๕๔๕
ชั้นชน	class	๒ มี.ค. ๒๕๔๕
ชีวยนตนิยม	automatism	๒ มี.ค. ๒๕๔๕
ชีวิตนิยม	vitalism	๒ มี.ค. ๒๕๔๕
ชนิด	species	๒ มี.ค. ๒๕๔๕
ชนชั้นกลาง	bourgeois	๒ มี.ค. ๒๕๔๕
ซีนิก	cynic	๒ มี.ค. ๒๕๔๕
ซึ่งอาจพิสูจน์ว่าเป็นเท็จ	falsifiable	๒ มี.ค. ๒๕๔๕
ซึ่งอาจพิสูจน์ว่าเป็นจริง	verifiable	๒ มี.ค. ๒๕๔๕
ญัติสากล	universal proposition	๒ มี.ค. ๒๕๔๕
ญัตติ	proposition	๒ มี.ค. ๒๕๔๕
ญัตติเฉพาะ	particular proposition	๒ มี.ค. ๒๕๔๕
ญาณวิทยา	epistemology; theory of knowledge	๒ มี.ค. ๒๕๔๕
ฐานบท	axiom	๒ มี.ค. ๒๕๔๕
ดี	good	๒ มี.ค. ๒๕๔๕
ตรรกวิทยา	logic	๒ มี.ค. ๒๕๔๕
ตรรกวิทยาสัญลักษณ์	symbolic logic	๒ มี.ค. ๒๕๔๕
ตรรกวิทยาอัญรูป	modal logic	๒ มี.ค. ๒๕๔๕
ตรรกสัจจะ	logical truth	๒ มี.ค. ๒๕๔๕
ตรรกศาสตร์	dialectic; logic	๒ มี.ค. ๒๕๔๕
ตรรกศาสตร์สัญลักษณ์	symbolic logic	๒ มี.ค. ๒๕๔๕
ตรรกศาสตร์อัญรูป	modal logic	๒ มี.ค. ๒๕๔๕
ตรรกบท	syllogism	๒ มี.ค. ๒๕๔๕
ตรรกบทย่อ	enthymeme	๒ มี.ค. ๒๕๔๕
ตรรกบทเด็ดขาด	categorical syllogism	๒ มี.ค. ๒๕๔๕
ตรรกบทสถิติ	statistical syllogism	๒ มี.ค. ๒๕๔๕
ตัวเชื่อม	copula	๒ มี.ค. ๒๕๔๕
ตัวกระทำ	agent	๒ มี.ค. ๒๕๔๕
ตัวตน	self	๒ มี.ค. ๒๕๔๕
ตามชะตากรรม	fatalistic	๒ มี.ค. ๒๕๔๕
ถ้อยคำ	logos	๒ มี.ค. ๒๕๔๕
ทรรศนะดั้งเดิม	orthodox	๒ มี.ค. ๒๕๔๕
ทวินิยม	dualism	๒ มี.ค. ๒๕๔๕
ที่รู้ได้ทางประสาทสัมผัส	sensible	๒ มี.ค. ๒๕๔๕
ที่ประจักษ์ชัด	apparent	๒ มี.ค. ๒๕๔๕
ที่ปรากฏ	apparent	๒ มี.ค. ๒๕๔๕
ทางสายกลาง	middle way	๒ มี.ค. ๒๕๔๕
ทางศีลธรรม	moral	๒ มี.ค. ๒๕๔๕
ทฤษฎีสัญชานเชิงสาเหตุ	causal theory of perception	๒ มี.ค. ๒๕๔๕
ทฤษฎีสัญชานเชิงจิตนิยม	idealistic theory of perception	๒ มี.ค. ๒๕๔๕
ทฤษฎีเซต	set theory	๒ มี.ค. ๒๕๔๕
ทฤษฎีสัญชาน	theories of perception	๒ มี.ค. ๒๕๔๕
ทฤษฎีสัญชานเชิงเลือกสรร	selective theory of perception	๒ มี.ค. ๒๕๔๕
ทฤษฎีสัญชานเชิงสร้างสรรค์	creative theory of perception	๒ มี.ค. ๒๕๔๕
ทฤษฎีสัญชานเชิงสัจนิยมโดยตรง	direct realist theory of perception	๒ มี.ค. ๒๕๔๕
ทฤษฎีความจริงแบบสมนัย	correspondence theory of truth	๒ มี.ค. ๒๕๔๕
ทฤษฎีความจริงแบบสหนัย	coherence theory of truth	๒ มี.ค. ๒๕๔๕
ทฤษฎีความจริงแบบปฏิบัตินิยม	pragmatic theory of truth	๒ มี.ค. ๒๕๔๕
ทฤษฎีจัดระดับ	theory of types	๒ มี.ค. ๒๕๔๕
ทฤษฎีตัวแทน	representative theory	๒ มี.ค. ๒๕๔๕
ทฤษฎีกรณียธรรม	deontological theory	๒ มี.ค. ๒๕๔๕
ทุกขารมณ์	pain	๒ มี.ค. ๒๕๔๕
ทุทรรศนนิยม	pessimism	๒ มี.ค. ๒๕๔๕
ทุนิยม	pessimism	๒ มี.ค. ๒๕๔๕
ทุนนิยม	capitalism	๒ มี.ค. ๒๕๔๕
ธรรมชาตินิยม	naturalism	๒ มี.ค. ๒๕๔๕
ธรรมชาตินิยมทางจริยศาสตร์	ethical naturalism	๒ มี.ค. ๒๕๔๕
ธาตุ	element	๒ มี.ค. ๒๕๔๕
นอกรีต	heresy	๒ มี.ค. ๒๕๔๕
นักวิมตินิยม	sceptic; skeptic	๒ มี.ค. ๒๕๔๕
นักกังขาคติ	sceptic; skeptic	๒ มี.ค. ๒๕๔๕
นิยัตินิยม	determinism	๒ มี.ค. ๒๕๔๕
นิยัตินิยมทางเศรษฐกิจ	economic determinism	๒ มี.ค. ๒๕๔๕
นามธรรม	abstract	๒ มี.ค. ๒๕๔๕
นิรนัย	deductive	๒ มี.ค. ๒๕๔๕
นามนิยม	nominalism	๒ มี.ค. ๒๕๔๕
นาสติกะ	heterodox	๒ มี.ค. ๒๕๔๕
นูเมนอน	noumenon; noumena (pl.)	๒ มี.ค. ๒๕๔๕
บรรทัดฐาน	norm	๒ มี.ค. ๒๕๔๕
บรรพบท	antecedent	๒ มี.ค. ๒๕๔๕
บัณฑิตยสถาน	academy	๒ มี.ค. ๒๕๔๕
บุคคลลักษณนิยม	personalism	๒ มี.ค. ๒๕๔๕
บุคลิกภาพ	personality	๒ มี.ค. ๒๕๔๕
ปรมัตถะ	ultimate	๒ มี.ค. ๒๕๔๕
ปรมัตถสัจ	ultimate truth	๒ มี.ค. ๒๕๔๕
ปรมาณูนิยม	atomism	๒ มี.ค. ๒๕๔๕
ปรวิสัย	objective	๒ มี.ค. ๒๕๔๕
ประโยชน์นิยม	utilitarianism	๒ มี.ค. ๒๕๔๕
ประเภท	category	๒ มี.ค. ๒๕๔๕
ประมวลเรื่องปรัมปรา	mythology	๒ มี.ค. ๒๕๔๕
ประวัติศาสตรนิยม	historicism	๒ มี.ค. ๒๕๔๕
ประสาทสัมผัส	sense	๒ มี.ค. ๒๕๔๕
ประสบการณ์นิยม	empiricism	๒ มี.ค. ๒๕๔๕
ประสบการณ์นิยมเชิงตรรก	logical empiricism	๒ มี.ค. ๒๕๔๕
ประจักษวิสัญชาน	empirical apperception	๒ มี.ค. ๒๕๔๕
ประจักษ์ชัดในตัว	self-evident	๒ มี.ค. ๒๕๔๕
ประชาน	cognition	๒ มี.ค. ๒๕๔๕
ประพจน์	proposition	๒ มี.ค. ๒๕๔๕
ประพจน์เฉพาะ	particular proposition	๒ มี.ค. ๒๕๔๕
ประพจน์สากล	universal proposition	๒ มี.ค. ๒๕๔๕
ประพจน์ซ้ำความ	tautology	๒ มี.ค. ๒๕๔๕
ปรัชญาการเมือง	political philosophy	๒ มี.ค. ๒๕๔๕
ปรัตถานุมาน	syllogism	๒ มี.ค. ๒๕๔๕
ปรัตถานุมานย่อ	enthymeme	๒ มี.ค. ๒๕๔๕
ปรัตถานุมานเด็ดขาด	categorical syllogism	๒ มี.ค. ๒๕๔๕
ปรัตถานุมานสถิติ	statistical syllogism	๒ มี.ค. ๒๕๔๕
ปรัตถนิยม	altruism	๒ มี.ค. ๒๕๔๕
ปรัมปราวิทยา	mythology	๒ มี.ค. ๒๕๔๕
ปรัชญาสังคม	social philosophy	๒ มี.ค. ๒๕๔๕
ปรัชญากระบวนการ	process philosophy	๒ มี.ค. ๒๕๔๕
ปริมาณ	quantity	๒ มี.ค. ๒๕๔๕
ปรากฏการณ์	phenomenon; phenomena (pl.)	๒ มี.ค. ๒๕๔๕
ปรากฏการณ์วิทยา	phenomenology	๒ มี.ค. ๒๕๔๕
ปรากฏการณ์ทางจิต	mental phenomena	๒ มี.ค. ๒๕๔๕
ปรากฏการณ์นิยม	phenomenalism	๒ มี.ค. ๒๕๔๕
ปรนัย	objective	๒ มี.ค. ๒๕๔๕
ปัจเจกนิยม	individualism	๒ มี.ค. ๒๕๔๕
ปัจเจกบุคล	individual	๒ มี.ค. ๒๕๔๕
ปัจจยาการ	causation	๒ มี.ค. ๒๕๔๕
ปัจจัย	cause	๒ มี.ค. ๒๕๔๕
ปัจเจก	individual	๒ มี.ค. ๒๕๔๕
ปัจจัยภาพ	causality	๒ มี.ค. ๒๕๔๕
ปัจจัยของอาริสโตเติล	Aristotle’s cause	๒ มี.ค. ๒๕๔๕
ปัญญา	intellect	๒ มี.ค. ๒๕๔๕
ปีติสานติ์	ecstasy	๒ มี.ค. ๒๕๔๕
ปฏิฐานนิยม	positivism	๒ มี.ค. ๒๕๔๕
ปฏิฐานนิยมเชิงตรรก	logical positivism	๒ มี.ค. ๒๕๔๕
ปฏิทรรศน์	paradox	๒ มี.ค. ๒๕๔๕
ปฏิทรรศน์ของรัสเซลล์	Russell’s paradox	๒ มี.ค. ๒๕๔๕
ปฏิทรรศน์ของซีโน	Zeno’s paradoxes	๒ มี.ค. ๒๕๔๕
ปฏิบัตินิยม	pragmatism	๒ มี.ค. ๒๕๔๕
ปฏิพัฒนาการ	dialectic	๒ มี.ค. ๒๕๔๕
ปฐมธาตุ	first principle	๒ มี.ค. ๒๕๔๕
ปทัสถาน	norm	๒ มี.ค. ๒๕๔๕
ปทัฏฐาน	norm	๒ มี.ค. ๒๕๔๕
ปทารถะ	category	๒ มี.ค. ๒๕๔๕
ปุราณวิทยา	mythology	๒ มี.ค. ๒๕๔๕
ผัสสาการ	sensation	๒ มี.ค. ๒๕๔๕
ผัสสาการนิยม	sensationalism; sensationism	๒ มี.ค. ๒๕๔๕
ผิดศีลธรรม	immoral	๒ มี.ค. ๒๕๔๕
ผู้รู้	knower	๒ มี.ค. ๒๕๔๕
ผล	effect	๒ มี.ค. ๒๕๔๕
พระเป็นเจ้า	Being-in-Itself; God; godhead; godhood; godness	๒ มี.ค. ๒๕๔๕
พระวจนะ	Logos	๒ มี.ค. ๒๕๔๕
พระพรหม	Brahma	๒ มี.ค. ๒๕๔๕
พรหมัน	Brahman	๒ มี.ค. ๒๕๔๕
พรหมลิขิต	destiny; predestination	๒ มี.ค. ๒๕๔๕
พรตนิยม	asceticism	๒ มี.ค. ๒๕๔๕
พหุเทวนิยม	polytheism	๒ มี.ค. ๒๕๔๕
พวกปฏิกิริยา	reactionary	๒ มี.ค. ๒๕๔๕
พหุนิยม	pluralism	๒ มี.ค. ๒๕๔๕
พันธะ	obligation	๒ มี.ค. ๒๕๔๕
พันธนาการ	bondage	๒ มี.ค. ๒๕๔๕
พาหิรกมโนภาพ	adventitious idea	๒ มี.ค. ๒๕๔๕
พิชาน	consciousness	๒ มี.ค. ๒๕๔๕
พินิศจัย	judgement; judgment	๒ มี.ค. ๒๕๔๕
พลัง	potency	๒ มี.ค. ๒๕๔๕
พลังวิริยะ	conatus	๒ มี.ค. ๒๕๔๕
พฤติกรรมนิยม	behaviourism	๒ มี.ค. ๒๕๔๕
พจน์	term	๒ มี.ค. ๒๕๔๕
พจน์รอง	minor term	๒ มี.ค. ๒๕๔๕
พจน์หลัก	major term	๒ มี.ค. ๒๕๔๕
พจน์กลาง	middle term	๒ มี.ค. ๒๕๔๕
พุทธิปัญญา	intellect	๒ มี.ค. ๒๕๔๕
พุทธิปัญญานิยม	intellectualism	๒ มี.ค. ๒๕๔๕
