“losses occurring” basis	หลักกำหนดระยะเวลาความเสียหาย	๒ มี.ค. ๒๕๔๕
“losses to extinction” basis	หลักยกยอดขาดทุน	๒ มี.ค. ๒๕๔๕
“three years’ average” system	ระบบเฉลี่ยสามปี	๒ มี.ค. ๒๕๔๕
โรคภัยเนื่องจากอาชีพ	occupational disease	๒ มี.ค. ๒๕๔๕
มรดกมีพินัยกรรม	testate	๒ มี.ค. ๒๕๔๕
เมื่อหมดอายุ	as expiry	๒ มี.ค. ๒๕๔๕
abandonment	การสละทิ้ง	๒ มี.ค. ๒๕๔๕
เรือที่ระบุชื่อ	named steamer	๒ มี.ค. ๒๕๔๕
abandonment policy	กรมธรรม์คุ้มครองการเลิกล้ม	๒ มี.ค. ๒๕๔๕
abnormal risk	การเสี่ยงภัยผิดปรกติ	๒ มี.ค. ๒๕๔๕
absolute assignment	การโอนสิทธิ์สมบูรณ์	๒ มี.ค. ๒๕๔๕
abstainers insurance	การประกันภัยผู้ไม่ดื่มของมึนเมา	๒ มี.ค. ๒๕๔๕
accelerated endowment	การใช้เงินปันผลเร่งให้สัญญาครบกำหนด	๒ มี.ค. ๒๕๔๕
accelerated paid-up	การใช้เงินปันผลสมทบจนครบจำนวน	๒ มี.ค. ๒๕๔๕
acceptance	"การสนอง <i>ดู <a href=""/coinages/websearch.php?Wd=offer+and+acceptance&amp;Sj=0"">offer and acceptance</a></i>"	๒ มี.ค. ๒๕๔๕
acceptance letter	จดหมายสนองรับ	๒ มี.ค. ๒๕๔๕
accepted value	มูลค่าที่ยอมรับ	๒ มี.ค. ๒๕๔๕
accident frequency	ความถี่ของอุบัติเหตุ	๒ มี.ค. ๒๕๔๕
accident insurance	การประกันภัยอุบัติเหตุ	๒ มี.ค. ๒๕๔๕
accident severity	ความรุนแรงของอุบัติเหตุ	๒ มี.ค. ๒๕๔๕
accidental bodily injury	การบาดเจ็บโดยอุบัติเหตุ	๒ มี.ค. ๒๕๔๕
accidental death benefit	"ผลประโยชน์เมื่อถึงแก่กรรมโดยอุบัติเหตุ <i>ดู <a href=""/coinages/websearch.php?Wd=double+indemnity&amp;Sj=0"">double indemnity</a></i>"	๒ มี.ค. ๒๕๔๕
accident	อุบัติเหตุ	๒ มี.ค. ๒๕๔๕
accident and health insurance	การประกันภัยอุบัติเหตุและสุขภาพ	๒ มี.ค. ๒๕๔๕
accidental means	วิถีอุบัติเหตุ	๒ มี.ค. ๒๕๔๕
accommodation business	ธุรกิจเกื้อกูล	๒ มี.ค. ๒๕๔๕
account agent	"ตัวแทนเงินเชื่อ <i>มีความหมายเหมือนกับ <a href=""/coinages/websearch.php?Wd=credit+agent&amp;Sj=0"">credit agent</a></i>"	๒ มี.ค. ๒๕๔๕
account sales	ใบแจ้งการขาย	๒ มี.ค. ๒๕๔๕
accountants clause	ข้อกำหนดนักบัญชี	๒ มี.ค. ๒๕๔๕
เว้นแต่เกิดจาก	unless caused by	๒ มี.ค. ๒๕๔๕
เว้นแต่ความเสียหายร่วม	unless general	๒ มี.ค. ๒๕๔๕
acquisition cost	ค่าใช้จ่ายในการขาย	๒ มี.ค. ๒๕๔๕
acquisition expenses	"<i>มีความหมายเหมือนกับ <a href=""/coinages/websearch.php?Wd=acquisition+cost&amp;Sj=0"">acquisition cost</a></i>"	๒ มี.ค. ๒๕๔๕
act of God	เหตุสุดวิสัย(ตามธรรมชาติ)	๒ มี.ค. ๒๕๔๕
actual total loss	ความเสียหายสิ้นเชิงแท้จริง	๒ มี.ค. ๒๕๔๕
actuary	นักคณิตศาสตร์ประกันภัย	๒ มี.ค. ๒๕๔๕
actual deaths	การตายจริง	๒ มี.ค. ๒๕๔๕
ระยะรอรับผลประโยชน์	deferred period	๒ มี.ค. ๒๕๔๕
ระยะเริ่มแรก	initial period	๒ มี.ค. ๒๕๔๕
ระยะไม่คุ้มครอง	waiting period	๒ มี.ค. ๒๕๔๕
ระยะชดใช้ค่าสินไหมทดแทน	indemnity period	๒ มี.ค. ๒๕๔๕
ระยะตรวจพบ	discovery period	๒ มี.ค. ๒๕๔๕
ระยะปลอดพันธะ	cooling-off period	๒ มี.ค. ๒๕๔๕
ระยะผ่อนผัน	grace period	๒ มี.ค. ๒๕๔๕
addendum	ข้อเพิ่มเติม	๒ มี.ค. ๒๕๔๕
addition to age	อายุบวกเพิ่ม	๒ มี.ค. ๒๕๔๕
additional benefit	ผลประโยชน์เพิ่ม	๒ มี.ค. ๒๕๔๕
additional insurance	การเอาประกันภัยเพิ่ม	๒ มี.ค. ๒๕๔๕
additional peril	ภัยเพิ่ม	๒ มี.ค. ๒๕๔๕
additional premium	เบี้ยประกันภัยเพิ่ม	๒ มี.ค. ๒๕๔๕
ระหว่างการเสี่ยงภัย	on risk	๒ มี.ค. ๒๕๔๕
adhesion contract	สัญญาสำเร็จรูป	๒ มี.ค. ๒๕๔๕
adjustable premium	เบี้ยประกันภัยที่ปรับได้	๒ มี.ค. ๒๕๔๕
adjuster	ผู้เจรจาตกลง	๒ มี.ค. ๒๕๔๕
adjusters’ note	บันทึกของผู้เจรจาตกลง	๒ มี.ค. ๒๕๔๕
adjustment income	เงินได้ที่ปรับแล้ว	๒ มี.ค. ๒๕๔๕
administration bond	กรมธรรม์ค้ำประกันการจัดการมรดก	๒ มี.ค. ๒๕๔๕
administrator	ผู้จัดการมรดก	๒ มี.ค. ๒๕๔๕
admitted assets	สินทรัพย์ประเมินแล้ว	๒ มี.ค. ๒๕๔๕
advance payments bond	กรมธรรม์ค้ำประกันการจ่ายเงินล่วงหน้า	๒ มี.ค. ๒๕๔๕
advance premium	เบี้ยประกันภัยล่วงหน้า	๒ มี.ค. ๒๕๔๕
advance profits insurance	การประกันภัยกำไรที่คาดหมาย	๒ มี.ค. ๒๕๔๕
adventure	การเสี่ยงภัย	๒ มี.ค. ๒๕๔๕
adverse selection	การคัดเลือกที่ขัดประโยชน์	๒ มี.ค. ๒๕๔๕
ระบบเขต	block system	๒ มี.ค. ๒๕๔๕
ระบบเฉลี่ยสามปี	“three years’ average” system	๒ มี.ค. ๒๕๔๕
ระบบกำหนดน้ำหนักภัยด้วยตัวเลข	numerical weighting system	๒ มี.ค. ๒๕๔๕
ระบบตัวแทนของสถาบันลอยด์	Lloyd’ s Agency System	๒ มี.ค. ๒๕๔๕
ระบบประเมิน	assessmentism	๒ มี.ค. ๒๕๔๕
มหัตภัย	catastrophe	๒ มี.ค. ๒๕๔๕
มหาอัคคีภัย	conflagration	๒ มี.ค. ๒๕๔๕
aerial devices	"ภัยเนื่องจากเครื่องบิน <i>มีความหมายเหมือนกับ <a href=""/coinages/websearch.php?Wd=aircraft+devices&amp;Sj=0"">aircraft devices</a></i>"	๒ มี.ค. ๒๕๔๕
เหตุสุดวิสัย	"force majeure; <a href=""/coinages/websearch.php?Wd=vis+major&amp;Sj=0"">vis major</a>"	๒ มี.ค. ๒๕๔๕
เหตุสุดวิสัย(ตามธรรมชาติ)	act of God	๒ มี.ค. ๒๕๔๕
เหตุสุดวิสัย(ตามธรรมชาติ)	act of God	๒ มี.ค. ๒๕๔๕
เหตุการณ์วินาศภัย	loss event	๒ มี.ค. ๒๕๔๕
เหตุการณ์ที่เกิดขึ้น	occurrence	๒ มี.ค. ๒๕๔๕
เหตุความไม่แน่นอนของชีวิต	life contingency	๒ มี.ค. ๒๕๔๕
affreightment	การจ้างเรือบรรทุกสินค้า	๒ มี.ค. ๒๕๔๕
age	อายุ	๒ มี.ค. ๒๕๔๕
age admitted	อายุที่ยอมรับ	๒ มี.ค. ๒๕๔๕
agency	๑. การเป็นตัวแทน<br/>๒. ธุรกิจตัวแทน	๒ มี.ค. ๒๕๔๕
agent	ตัวแทน	๒ มี.ค. ๒๕๔๕
aggravated risk	ภัยที่เพิ่มการเสี่ยง	๒ มี.ค. ๒๕๔๕
aggregate excess of loss reinsurance	การประกันภัยต่อความเสียหายส่วนเกินรวม	๒ มี.ค. ๒๕๔๕
aggregate limit of indemnity	จำนวนจำกัดความรับผิดรวม	๒ มี.ค. ๒๕๔๕
aggregate stop loss reinsurance	การประกันภัยต่อกำหนดค่าเสียหายโดยจำนวนรวม	๒ มี.ค. ๒๕๔๕
agreed returns	การคืนเบี้ยประกันภัยตามตกลง	๒ มี.ค. ๒๕๔๕
agreed value policy	"กรมธรรม์แบบกำหนดมูลค่า <i>มีความหมายเหมือนกับ <a href=""/coinages/websearch.php?Wd=valued+policy&amp;Sj=0"">valued policy</a></i>"	๒ มี.ค. ๒๕๔๕
เอาประกันภัย	insure	๒ มี.ค. ๒๕๔๕
เอาประกันภัยต่อ	cede	๒ มี.ค. ๒๕๔๕
aircraft devices	ภัยเนื่องจากเครื่องบิน	๒ มี.ค. ๒๕๔๕
aircraft hull insurance	การประกันภัยตัวเครื่องบิน	๒ มี.ค. ๒๕๔๕
aircraft passenger insurance	การประกันภัยผู้โดยสารเครื่องบิน	๒ มี.ค. ๒๕๔๕
airliner	เครื่องบินของสายการบิน	๒ มี.ค. ๒๕๔๕
airport owners’ and operators’ insurance	การประกันภัยความรับผิดของสนามบิน	๒ มี.ค. ๒๕๔๕
เอกสารแสดงความเสียหาย	proof of loss	๒ มี.ค. ๒๕๔๕
เอกสารการโอนสิทธิ์	assignment	๒ มี.ค. ๒๕๔๕
เอกสารค้ำประกันการจำนอง	mortgage guarantee certificate	๒ มี.ค. ๒๕๔๕
เอกสารชดใช้ค่าสินไหมทดแทนชั่วคราว	short of loss	๒ มี.ค. ๒๕๔๕
โอกาสเสี่ยงภัย	exposure	๒ มี.ค. ๒๕๔๕
โอกาสเสี่ยงภัยเริ่มแรก	primary exposure	๒ มี.ค. ๒๕๔๕
ยอดรวม	portfolio	๒ มี.ค. ๒๕๔๕
ยอดรวมเบี้ยประกันภัย	portfolio premium	๒ มี.ค. ๒๕๔๕
ยอดรวมสมดุล	balance portfolio	๒ มี.ค. ๒๕๔๕
ยอดรวมค่าสินไหมทดแทน	loss portfolio	๒ มี.ค. ๒๕๔๕
ยอดรวมค่าสินไหมทดแทนค้างจ่าย	outstanding claims portfolio	๒ มี.ค. ๒๕๔๕
ยอดรวมติดพัน	portfolio run-off	๒ มี.ค. ๒๕๔๕
ยอดรวมผสม	portfolio mix	๒ มี.ค. ๒๕๔๕
ยอดขาดมาตรฐาน	standard turnover	๒ มี.ค. ๒๕๔๕
aleatory contract	สัญญาเสี่ยงโชค	๒ มี.ค. ๒๕๔๕
alien company	บริษัทต่างประเทศ	๒ มี.ค. ๒๕๔๕
alien enemy	คนชาติศัตรู	๒ มี.ค. ๒๕๔๕
all risks	สรรพภัย	๒ มี.ค. ๒๕๔๕
allocation of surplus	การจัดสรรเงินส่วนเกิน	๒ มี.ค. ๒๕๔๕
allotment of bonus	การจัดสรรเงินปันผล	๒ มี.ค. ๒๕๔๕
American Experience Table of Mortality	ตารางมรณวิสัยของสหรัฐอเมริกา	๒ มี.ค. ๒๕๔๕
amortization	การไถ่ถอนมูลค่า	๒ มี.ค. ๒๕๔๕
amount at risk	จำนวนเงินเสี่ยงภัย	๒ มี.ค. ๒๕๔๕
ภัยสงคราม	war perils	๒ มี.ค. ๒๕๔๕
ภัยสงบ	silent risk	๒ มี.ค. ๒๕๔๕
ภัยแยกเสี่ยง	split risk	๒ มี.ค. ๒๕๔๕
ภัยเสี่ยงเอง	own risk	๒ มี.ค. ๒๕๔๕
ภัยรับโดยบังคับ	assigned risk	๒ มี.ค. ๒๕๔๕
ภัยเกี่ยวกับความคุ้มครองและชดใช้	protection and indemnity risks	๒ มี.ค. ๒๕๔๕
ภัยโดดเดี่ยว	isolated risk	๒ มี.ค. ๒๕๔๕
ภัยสามัญ	simple risk	๒ มี.ค. ๒๕๔๕
ภัยเนื่องจากเครื่องบิน	"aerial devices; <a href=""/coinages/websearch.php?Wd=aircraft+devices&amp;Sj=0"">aircraft devices</a>"	๒ มี.ค. ๒๕๔๕
ภัยเป้าหมาย	target risk	๒ มี.ค. ๒๕๔๕
ภัยเพิ่ม	additional peril	๒ มี.ค. ๒๕๔๕
ภัยเพิ่มพิเศษ	extraneous perils	๒ มี.ค. ๒๕๔๕
ภัยก่อนการใช้สินเชื่อ	"peril; <a href=""/coinages/websearch.php?Wd=risk&amp;Sj=0"">risk</a>"	๒ มี.ค. ๒๕๔๕
ภัยการเมือง	ice deviation risk	๒ มี.ค. ๒๕๔๕
ภัยการระเบิด	explosion	๒ มี.ค. ๒๕๔๕
ภัยการเดินเรือ	assault risk	๒ มี.ค. ๒๕๔๕
ภัยการเบี่ยงเส้นทางเนื่องจากน้ำแข็ง	navigation risks	๒ มี.ค. ๒๕๔๕
ภัยการจู่โจมทำร้าย	Pre-Credit risk	๒ มี.ค. ๒๕๔๕
ภัยขณะลำเลียง	craft risks	๒ มี.ค. ๒๕๔๕
ภัยขนาดใหญ่พิเศษ	jumbo risk	๒ มี.ค. ๒๕๔๕
ภัยคุ้มกัน	protected risk	๒ มี.ค. ๒๕๔๕
ภัยจากหนี้สูญ	non-payment risk	๒ มี.ค. ๒๕๔๕
ภัยจากการจู่โจมทำร้าย	assault risk	๒ มี.ค. ๒๕๔๕
ภัยต่ำกว่าเกณฑ์เฉลี่ย	under-average risk	๒ มี.ค. ๒๕๔๕
ภัยตามฤดูกาล	seasonal risk	๒ มี.ค. ๒๕๔๕
ภัยที่เพิ่มการเสี่ยง	aggravated risk	๒ มี.ค. ๒๕๔๕
ภัยที่ไม่อาจเอาประกันภัย	uninsurable risk	๒ มี.ค. ๒๕๔๕
ภัยทางทะเล	perils of the sea	๒ มี.ค. ๒๕๔๕
ภัยนิวเคลียร์	nuclear risks	๒ มี.ค. ๒๕๔๕
ภัยบก	land risks	๒ มี.ค. ๒๕๔๕
ภัยปรมาณู	atomic risks	๒ มี.ค. ๒๕๔๕
ภัยพ่วงภัยทางทะเล	incidental non-marine	๒ มี.ค. ๒๕๔๕
ภัยพิเศษ	special peril	๒ มี.ค. ๒๕๔๕
annuitant	ผู้รับเงินรายปี	๒ มี.ค. ๒๕๔๕
annuity	เงินรายปี	๒ มี.ค. ๒๕๔๕
annuity bond	บัตรเงินรายปี	๒ มี.ค. ๒๕๔๕
annuity certain	เงินรายปีตามกำหนด	๒ มี.ค. ๒๕๔๕
anticipated freight	ค่าระวางที่คาดไว้	๒ มี.ค. ๒๕๔๕
anticipatory credit cover	ความคุ้มครองการจ่ายเงินล่วงหน้า	๒ มี.ค. ๒๕๔๕
รับเสี่ยงภัย	assume	๒ มี.ค. ๒๕๔๕
รับประกันภัย	insure	๒ มี.ค. ๒๕๔๕
รับผิดหรือไม่รับผิด	liable or no liable	๒ มี.ค. ๒๕๔๕
มีมูลค่าตามกรมธรรม์เดิม	valued as original	๒ มี.ค. ๒๕๔๕
รายละเอียดคลาดเคลื่อน	misdescription	๒ มี.ค. ๒๕๔๕
รายได้จากเบี้ยประกันภัย	premium income	๒ มี.ค. ๒๕๔๕
รายการบัญชีความเสียหาย	average statement	๒ มี.ค. ๒๕๔๕
รายการภัยที่ปฏิเสธ	decline list	๒ มี.ค. ๒๕๔๕
รายงานการเจรจาตกลงความเสียหายร่วม	general average adjustment	๒ มี.ค. ๒๕๔๕
รายงานของผู้สำรวจ	surveyor’s report	๒ มี.ค. ๒๕๔๕
ภาวะมหันตภัย	catastrophe hazard	๒ มี.ค. ๒๕๔๕
ภาวะภัย	hazard	๒ มี.ค. ๒๕๔๕
ภาวะภัยแทรกซ้อน	interruption hazard	๒ มี.ค. ๒๕๔๕
ภาวะภัยสามัญ	common hazard	๒ มี.ค. ๒๕๔๕
ภาวะภัยจากอาชีพ	occupational hazard	๒ มี.ค. ๒๕๔๕
ภาวะภัยทั่วไป	general hazard	๒ มี.ค. ๒๕๔๕
ภาวะภัยทางศีลธรรม	moral hazard	๒ มี.ค. ๒๕๔๕
ภาวะภัยทางอุปนิสัย	morale hazard	๒ มี.ค. ๒๕๔๕
ภาวะภัยทางกายภาพ	physical hazard	๒ มี.ค. ๒๕๔๕
ภาษีเบี้ยประกันภัย	premium tax	๒ มี.ค. ๒๕๔๕
ภาษีจากค่าชดใช้เกิน	balancing charges	๒ มี.ค. ๒๕๔๕
มาตรฐานสิ่งปลูกสร้าง	standard of construction	๒ มี.ค. ๒๕๔๕
มีผลบังคับ	in force	๒ มี.ค. ๒๕๔๕
ภาพที่เป็นอยู่ก่อน	pre-existing condition	๒ มี.ค. ๒๕๔๕
application	คำขอเอาประกันภัย	๒ มี.ค. ๒๕๔๕
apprehensive period	ช่วงเวลาไม่ใช้อัตราปรกติ	๒ มี.ค. ๒๕๔๕
apportionment	การจัดสัดส่วน	๒ มี.ค. ๒๕๔๕
aquacultural insurance	การประกันภัยสัตว์น้ำ	๒ มี.ค. ๒๕๔๕
arbitration	การใช้อนุญาโตตุลาการ	๒ มี.ค. ๒๕๔๕
arbitration clause	ข้อกำหนดการใช้อนุญาโตตุลาการ	๒ มี.ค. ๒๕๔๕
arrests, restraints and detainments	การจับกุม หน่วงเหนี่ยว และกักขัง	๒ มี.ค. ๒๕๔๕
arranged total loss	ความเสียหายสิ้นเชิงตามตกลง	๒ มี.ค. ๒๕๔๕
arrears	เบี้ยประกันภัยเกินกำหนด	๒ มี.ค. ๒๕๔๕
arrived demaged value	มูลค่า ณ ปลายทางหลังเสียหาย	๒ มี.ค. ๒๕๔๕
arrived sound value	มูลค่าไม่เสียหาย ณ ปลายทาง	๒ มี.ค. ๒๕๔๕
as expiry	เมื่อหมดอายุ	๒ มี.ค. ๒๕๔๕
as original	ตามกรมธรรม์ฉบับต้น	๒ มี.ค. ๒๕๔๕
assault risk	ภัยจากการจู่โจมทำร้าย	๒ มี.ค. ๒๕๔๕
assessment insurance	๑. การประกันภัยแบบประเมินเบี้ยประกันภัย<br/>๒. การประกันชีวิตแบบสัญญาเปิด	๒ มี.ค. ๒๕๔๕
assessmentism	ระบบประเมิน	๒ มี.ค. ๒๕๔๕
assessor	ผู้ประเมิน(ความเสียหาย)	๒ มี.ค. ๒๕๔๕
assignor	ผู้โอนสิทธิ์	๒ มี.ค. ๒๕๔๕
association scheme	แผนร่วมรับประกันภัย	๒ มี.ค. ๒๕๔๕
assigned risk	ภัยรับโดยบังคับ	๒ มี.ค. ๒๕๔๕
assignee	ผู้รับโอนสิทธิ์	๒ มี.ค. ๒๕๔๕
assignment	๑. การโอนสิทธิ์<br/>๒. เอกสารการโอนสิทธิ์	๒ มี.ค. ๒๕๔๕
assume	รับเสี่ยงภัย	๒ มี.ค. ๒๕๔๕
assured	ผู้เอาประกันภัย	๒ มี.ค. ๒๕๔๕
assurer	ผู้รับประกันภัย	๒ มี.ค. ๒๕๔๕
assuming company	บริษัทรับประกันภัยต่อ	๒ มี.ค. ๒๕๔๕
assumption certificate	หนังสือรับรองการชำระเงิน	๒ มี.ค. ๒๕๔๕
assurance	การประกันภัย	๒ มี.ค. ๒๕๔๕
atomic risks	ภัยปรมาณู	๒ มี.ค. ๒๕๔๕
attachment of risk	การเริ่มเสี่ยงภัย	๒ มี.ค. ๒๕๔๕
attained age	อายุปัจจุบัน	๒ มี.ค. ๒๕๔๕
attachment date	วันเริ่มเสี่ยงภัย	๒ มี.ค. ๒๕๔๕
attestation clause	ข้อกำหนดการลงนามประทับตรา	๒ มี.ค. ๒๕๔๕
automatic cover	ความคุ้มครองโดยอัตโนมัติ	๒ มี.ค. ๒๕๔๕
automatic cover clause	ข้อกำหนดความคุ้มครองโดยอัตโนมัติ	๒ มี.ค. ๒๕๔๕
automatic premium loan	เงินกู้ตามกรมธรรม์โดยอัตโนมัติ	๒ มี.ค. ๒๕๔๕
automatic reinstatement	การฟื้นสัญญาโดยอัตโนมัติ	๒ มี.ค. ๒๕๔๕
automatic reinsurance treaty	สัญญาประกันภัยต่ออัตโนมัติ	๒ มี.ค. ๒๕๔๕
มูลค่า ณ ปลายทางหลังเสียหาย	arrived admaged value	๒ มี.ค. ๒๕๔๕
มูลค่ารวม	gross value	๒ มี.ค. ๒๕๔๕
มูลค่ารวม ณ ปลายทางหลังเสียหาย	gross arrived damaged value	๒ มี.ค. ๒๕๔๕
มูลค่าเวนคืนกรมธรรม์ประกันชีวิต	"cash surrender value; <a href=""/coinages/websearch.php?Wd=surrender+value&amp;Sj=0"">surrender value</a>"	๒ มี.ค. ๒๕๔๕
มูลค่าเหมาจ่าย	commuted valuas expirye	๒ มี.ค. ๒๕๔๕
มูลค่าเสี่ยงภัย	values at risk	๒ มี.ค. ๒๕๔๕
มูลค่าเงินสด	cash value	๒ มี.ค. ๒๕๔๕
มูลค่าเงินกู้	loan value	๒ มี.ค. ๒๕๔๕
มูลค่าใช้เงินสำเร็จ	paid-up value	๒ มี.ค. ๒๕๔๕
มูลค่าเพื่อเฉลี่ยค่าเสียหายร่วม	contributory value	๒ มี.ค. ๒๕๔๕
มูลค่าหลังเสียหาย	damaged value	๒ มี.ค. ๒๕๔๕
มูลค่าไม่เสียหาย	sound value	๒ มี.ค. ๒๕๔๕
มูลค่าประกันภัยพื้นฐาน	base value	๒ มี.ค. ๒๕๔๕
มูลค่าปัจจุบัน	present value	๒ มี.ค. ๒๕๔๕
มูลค่าไม่เสียหาย ณ ปลายทาง	arrived sound value	๒ มี.ค. ๒๕๔๕
มูลค่าของใหม่	replacement value	๒ มี.ค. ๒๕๔๕
มูลค่าครบกำหนด	maturity value	๒ มี.ค. ๒๕๔๕
มูลค่าตามบัญชี	book value	๒ มี.ค. ๒๕๔๕
มูลค่าตกค้าง	residual value	๒ มี.ค. ๒๕๔๕
มูลค่าที่ยอมรับ	accepted value	๒ มี.ค. ๒๕๔๕
average	๑. ความเสียหาย<br/>๒. การเฉลี่ยค่าเสียหาย	๒ มี.ค. ๒๕๔๕
average condition	เงื่อนไขการเฉลี่ยค่าเสียหาย	๒ มี.ค. ๒๕๔๕
average rate	อัตราเฉลี่ย	๒ มี.ค. ๒๕๔๕
average adjuster	ผู้เจรจาตกลงวินาศภัยทางทะเล	๒ มี.ค. ๒๕๔๕
average agent	ตัวแทนจัดการความเสียหาย	๒ มี.ค. ๒๕๔๕
average bond	กรมธรรม์ค้ำประกันความเสียหายร่วม	๒ มี.ค. ๒๕๔๕
average clause	ข้อกำหนดการเฉลี่ยค่าเสียหาย	๒ มี.ค. ๒๕๔๕
average statement	รายการบัญชีความเสียหาย	๒ มี.ค. ๒๕๔๕
aviation hull insurance	"การประกันภัยตัวเครื่องบิน <i>มีความหมายเหมือนกับ <a href=""/coinages/websearch.php?Wd=aircraft+hull+insurance&amp;Sj=0"">aircraft hull insurance</a></i>"	๒ มี.ค. ๒๕๔๕
award	คำชี้ขาด	๒ มี.ค. ๒๕๔๕
เลิกการสำรอง	release of reserve	๒ มี.ค. ๒๕๔๕
เกิดแล้วยังไม่รายงาน (ไอบีเอ็นอาร์)	"incurred but not reported (<a href=""/coinages/websearch.php?Wd=I.B.N.R.&amp;Sj=0"">I.B.N.R.</a>)"	๒ มี.ค. ๒๕๔๕
เกิดหรือไม่เกิดวินาศภัย	lost or not lost	๒ มี.ค. ๒๕๔๕
เกิดส่วนที่ตกลง	overclosing	๒ มี.ค. ๒๕๔๕
เกณฑ์ตีมูลค่าประกันภัย	basis of valuation	๒ มี.ค. ๒๕๔๕
เขตรับผิดของตัวแทน	debit	๒ มี.ค. ๒๕๔๕
เขตมหาอัคคีภัย	conflagration area	๒ มี.ค. ๒๕๔๕
เขตแผ่นดินไหว	earthquake zone	๒ มี.ค. ๒๕๔๕
เขตอันตราย	redlining	๒ มี.ค. ๒๕๔๕
เครื่องบินของสายการบิน	airliner	๒ มี.ค. ๒๕๔๕
เงินเอาประกันภัย	sum insured	๒ มี.ค. ๒๕๔๕
เงินมัดจำความเสียหาย	general average deposit	๒ มี.ค. ๒๕๔๕
เงินรายปี	annuity	๒ มี.ค. ๒๕๔๕
เงินรายปีรับรอง	guaranteed annuity	๒ มี.ค. ๒๕๔๕
เงินวางประกัน	guarantee deposit	๒ มี.ค. ๒๕๔๕
เงินส่วนเกิน	surplus	๒ มี.ค. ๒๕๔๕
เงินส่วนเกินรวม	gross surplus	๒ มี.ค. ๒๕๔๕
เงินส่วนเกินยังไม่ได้จัดสรร	unassigned surplus	๒ มี.ค. ๒๕๔๕
เงินส่วนเกินสุทธิ	net surplus	๒ มี.ค. ๒๕๔๕
เงินส่วนเกินของผู้ถือหุ้น	shareholders’ surplus	๒ มี.ค. ๒๕๔๕
เงินส่วนเกินที่แบ่งปันได้	divisible surplus	๒ มี.ค. ๒๕๔๕
เงินรายปีเกษียณอายุ	retirement annuity	๒ มี.ค. ๒๕๔๕
เงินรายปีแบบเปลี่ยนแปรได้	variable annuity	๒ มี.ค. ๒๕๔๕
เงินรายปีสำหรับผู้มีชีวิต	survivorship annuity	๒ มี.ค. ๒๕๔๕
เงินรายปีหญิงม่าย	widow’s annuity	๒ มี.ค. ๒๕๔๕
เงินรายปีจ่ายทันที	immediate annuity	๒ มี.ค. ๒๕๔๕
เงินรายปีชั่วคราว	temporary life annuity	๒ มี.ค. ๒๕๔๕
เงินรายปีชนิดจ่ายคืน	refund annuity	๒ มี.ค. ๒๕๔๕
เงินรายปีชนิดจ่ายคืนเงินสด	cash refund annuity	๒ มี.ค. ๒๕๔๕
เงินสำรอง	"provision; <a href=""/coinages/websearch.php?Wd=reserve&amp;Sj=0"">reserve</a>"	๒ มี.ค. ๒๕๔๕
เงินสำรองรักษาระดับค่าสินไหมทดแทน	claims equalisation reserve	๒ มี.ค. ๒๕๔๕
เงินสำรองเงินปันผล	bonus reserve	๒ มี.ค. ๒๕๔๕
เงินสำรองเบี้ยประกันภัยที่ยังไม่ถือเป็นรายได้	unearned premium reserve	๒ มี.ค. ๒๕๔๕
เงินสำรองแฝง	hidden reserve	๒ มี.ค. ๒๕๔๕
เงินสำรองส่วนขาด	deficiency reserve	๒ มี.ค. ๒๕๔๕
เงินสำรองอิสระ	free reserves	๒ มี.ค. ๒๕๔๕
เงินสำรองกรมธรรม์	policy reserve	๒ มี.ค. ๒๕๔๕
เงินสำรองการเสี่ยงภัยที่ยังไม่สิ้นสุด	unexpired risks reserve	๒ มี.ค. ๒๕๔๕
เงินสำรองค่าสินไหมทดแทน	"claims reserves; <a href=""/coinages/websearch.php?Wd=loss+reserve&amp;Sj=0"">loss reserve</a>"	๒ มี.ค. ๒๕๔๕
เงินสำรองค่าสินไหมทดแทนค้างจ่าย	outstanding claims reserve	๒ มี.ค. ๒๕๔๕
เงินสำรองฉุกเฉิน	contingency reserve	๒ มี.ค. ๒๕๔๕
เงินสำรองตามกฎหมาย	legal reserve	๒ มี.ค. ๒๕๔๕
เงินสำรองทางเทคนิค	technical reserve	๒ มี.ค. ๒๕๔๕
เงินสำรองประกันภัยต่อ	reinsurance reserve	๒ มี.ค. ๒๕๔๕
เงินได้เมื่อเกษียณอายุ	retirement income	๒ มี.ค. ๒๕๔๕
เงินได้ระยะพึ่งพิง	dependency period income	๒ มี.ค. ๒๕๔๕
เงินได้หญิงม่าย	widow’s life income	๒ มี.ค. ๒๕๔๕
เงินได้ทุพพลภาพ	disability income	๒ มี.ค. ๒๕๔๕
เงินรายปีตามกำหนด	annuity cretain	๒ มี.ค. ๒๕๔๕
เงินรายปีตามดัชนี	index annuity	๒ มี.ค. ๒๕๔๕
เงินรายปีตลอดชีพ	life annuity	๒ มี.ค. ๒๕๔๕
เงินรายปีที่เลื่อนการรับ	deferred annuity	๒ มี.ค. ๒๕๔๕
เงินรายปีบำนาญ	pension annuity	๒ มี.ค. ๒๕๔๕
เงินคืนตามประสบการณ์	experience refund	๒ มี.ค. ๒๕๔๕
เงินกู้ตัวเรือ	bottomry	๒ มี.ค. ๒๕๔๕
เงินกู้ตัวสินค้า	respondentia	๒ มี.ค. ๒๕๔๕
เงินกู้ตามกรมธรรม์โดยอัตโนมัติ	automatic premium loan	๒ มี.ค. ๒๕๔๕
เงินที่ได้ปรับแล้ว	edjustment income	๒ มี.ค. ๒๕๔๕
เงินปันผล	"bonus; <a href=""/coinages/websearch.php?Wd=dividend&amp;Sj=0"">dividend</a>"	๒ มี.ค. ๒๕๔๕
เงินปันผลระหว่างกาล	interim bonus	๒ มี.ค. ๒๕๔๕
เงินปันผลรอจ่าย	tontine bonus	๒ มี.ค. ๒๕๔๕
เงินปันผลรับรอง	"guaranteed bonus; <a href=""/coinages/websearch.php?Wd=guaranteed+dividend&amp;Sj=0"">guaranteed dividend</a>"	๒ มี.ค. ๒๕๔๕
เงินปันผลมีเงื่อนไข	contingent bonus	๒ มี.ค. ๒๕๔๕
เงินปันผลเงินสด	cash bonus	๒ มี.ค. ๒๕๔๕
เงินปันผลเพิ่มความคุ้มครอง	dividend additions	๒ มี.ค. ๒๕๔๕
เงินปันผลเพิ่มพูน	reversionary bonus	๒ มี.ค. ๒๕๔๕
เงินปันผลเพิ่มพูนทบต้น	compound reversionary bonus	๒ มี.ค. ๒๕๔๕
เงินปันผลครบกำหนด	maturity bonus	๒ มี.ค. ๒๕๔๕
เงินปันผลจ่ายเมื่อสัญญาสิ้นสุด	terminal dividend	๒ มี.ค. ๒๕๔๕
เงินปันผลจ่ายหลังถึงแก่กรรม	post mortem dividend	๒ มี.ค. ๒๕๔๕
เงินปันผลพิเศษ	"extra dividend; <a href=""/coinages/websearch.php?Wd=special+bonus&amp;Sj=0"">special bonus</a>"	๒ มี.ค. ๒๕๔๕
เงินฝาก	deposit	๒ มี.ค. ๒๕๔๕
เงื่อนไขอัตวินิบาตกรรม	suicide provision	๒ มี.ค. ๒๕๔๕
เงื่อนไขกรมธรรม์	policy conditions	๒ มี.ค. ๒๕๔๕
เงื่อนไขเรียกร้องค่าสินไหมทดแทน	claims condition	๒ มี.ค. ๒๕๔๕
เงื่อนไขโดยนัย	implied condition	๒ มี.ค. ๒๕๔๕
เงื่อนไขบังคับหลัง	condition subsequent of the policy	๒ มี.ค. ๒๕๔๕
เงื่อนไขบังคับก่อน	condition precedent of the policy	๒ มี.ค. ๒๕๔๕
เงื่อนไขพิเศษการเฉลี่ย	special condition of average	๒ มี.ค. ๒๕๔๕
เงื่อนไขกรมธรรม์ฉบับต้น	original conditions	๒ มี.ค. ๒๕๔๕
เงื่อนไขก่อนความรับผิด	condition precedent to liability	๒ มี.ค. ๒๕๔๕
เงื่อนไขการเฉลี่ยค่าเสียหาย	average condition	๒ มี.ค. ๒๕๔๕
เงื่อนไขการแบ่งความรับผิด	condition of average	๒ มี.ค. ๒๕๔๕
เงื่อนไขคืนเบี้ยประกันภัย	premium refund provision	๒ มี.ค. ๒๕๔๕
เงื่อนไขจำกัดความเสียหาย	"limited terms; <a href=""/coinages/websearch.php?Wd=limited+conditions&amp;Sj=0"">limited conditions</a>"	๒ มี.ค. ๒๕๔๕
โดยคุ้มครองความเสียหายเฉพาะ	with average	๒ มี.ค. ๒๕๔๕
โดยไม่คุ้มครองความเสียหายเฉพาะ	warranted free from particular average	๒ มี.ค. ๒๕๔๕
ใบเสนอขอ	"offer note; <a href=""/coinages/websearch.php?Wd=request+note&amp;Sj=0"">request note</a>"	๒ มี.ค. ๒๕๔๕
ใบมอบฉันทะรับค่าสินไหมทดแทน	collecting note	๒ มี.ค. ๒๕๔๕
ใบรับรอง	certificate	๒ มี.ค. ๒๕๔๕
ใบรับรองสุขภาพ	evidence of health	๒ มี.ค. ๒๕๔๕
ใบแจ้งยืนยัน	protest	๒ มี.ค. ๒๕๔๕
ใบแจ้งยืนยันโดยละเอียด	extended protest	๒ มี.ค. ๒๕๔๕
ใบรับรองการทรงชีพ	survival certificate	๒ มี.ค. ๒๕๔๕
ใบรับรองการประกันภัย	"certificate of insurance; <a href=""/coinages/websearch.php?Wd=insurance+certificate&amp;Sj=0"">insurance certificate</a>"	๒ มี.ค. ๒๕๔๕
ใบรับรองการประกันภัยของสถาบันลอยด์	Lloyd’s certificate	๒ มี.ค. ๒๕๔๕
ใบรับรองชั่วคราว	instant certificate	๒ มี.ค. ๒๕๔๕
ใบรับเงินค่าเบี้ยประกันภัย	premium receipt	๒ มี.ค. ๒๕๔๕
ใบรับเบี้ยประกันภัยโดยมีเงื่อนไข	conditional receipt	๒ มี.ค. ๒๕๔๕
ใบรับผูกพัน	binding receipt	๒ มี.ค. ๒๕๔๕
ใบแจ้งการสละทิ้ง	notice of abandonment	๒ มี.ค. ๒๕๔๕
ใบแจ้งการขาย	account sales	๒ มี.ค. ๒๕๔๕
ใบเตือนชำระเบี้ยประกันภัย	premium notice	๒ มี.ค. ๒๕๔๕
ใบเตือนต่ออายุ	renewal notice	๒ มี.ค. ๒๕๔๕
ใบแบบการสวมสิทธิ์	subrogation form	๒ มี.ค. ๒๕๔๕
ใบแบบขอเอาประกันภัย	proposal form	๒ มี.ค. ๒๕๔๕
ใบแบบขอเอาประกันภัยต่อ	R/I order form	๒ มี.ค. ๒๕๔๕
ใบแบบตกลงเอาประกันภัยต่อ	R/I closing form	๒ มี.ค. ๒๕๔๕
ใบสลักหลัง	endorsement	๒ มี.ค. ๒๕๔๕
ใบสลักหลังกรณีอากาศยานไม่ใช่ของตน	non-owned aircraft endorsement	๒ มี.ค. ๒๕๔๕
ใบสนองรับ	take note	๒ มี.ค. ๒๕๔๕
เบี้ยรางวัลประวัติดี	no-claim bonus	๒ มี.ค. ๒๕๔๕
เบี้ยลงโทษ	malus	๒ มี.ค. ๒๕๔๕
เบี้ยประกันภัยรับสุทธิตามกรมธรรม์ฉบับต้น	original net premium income	๒ มี.ค. ๒๕๔๕
เบี้ยประกันภัยรับสุทธิตามกรมธรรม์ฉบับต้นที่คงไว้	original net retained premium income	๒ มี.ค. ๒๕๔๕
เบี้ยประกันภัยรายงวด	fractional premium	๒ มี.ค. ๒๕๔๕
เบี้ยประกันภัยเกินกำหนด	arrears	๒ มี.ค. ๒๕๔๕
เบี้ยประกันภัยโดยประมาณ	single premium	๒ มี.ค. ๒๕๔๕
เบี้ยประกันภัยแท้จริง	pure premium	๒ มี.ค. ๒๕๔๕
เบี้ยประกันภัยแบบชั่วระยะเวลาเบื้องต้น	preliminary term premium	๒ มี.ค. ๒๕๔๕
เบี้ยประกันภัยเพิ่ม	additional premium	๒ มี.ค. ๒๕๔๕
เบี้ยประกันภัยเพิ่มรายสัปดาห์	weekly premium increase	๒ มี.ค. ๒๕๔๕
เบี้ยประกันภัยเพิ่มเนื่องจากเรือเก่า	overage	๒ มี.ค. ๒๕๔๕
เบี้ยประกันภัย	premium	๒ มี.ค. ๒๕๔๕
เบี้ยประกันภัย	charges of insurance	๒ มี.ค. ๒๕๔๕
เบี้ยประกันภัยเริ่มแรก	initial premium	๒ มี.ค. ๒๕๔๕
เบี้ยประกันภัยรวม	on gross	๒ มี.ค. ๒๕๔๕
เบี้ยประกันภัยรวมตามกรมธรรม์ฉบับต้น	original gross premium	๒ มี.ค. ๒๕๔๕
เบี้ยประกันภัยรองรับ	underlying premium	๒ มี.ค. ๒๕๔๕
เบี้ยประกันภัยรับ	written premium	๒ มี.ค. ๒๕๔๕
เบี้ยประกันภัยรับรวม	gross written premium	๒ มี.ค. ๒๕๔๕
เบี้ยประกันภัยรับสุทธิ	net written premium	๒ มี.ค. ๒๕๔๕
เบี้ยประกันภัยเพิ่มพิเศษ	extra premium	๒ มี.ค. ๒๕๔๕
เบี้ยประกันภัยเพื่อการจัดทดแทน	reinstatement premium	๒ มี.ค. ๒๕๔๕
เบี้ยประกันภัยหลัก	subject premium	๒ มี.ค. ๒๕๔๕
เบี้ยประกันภัยสุทธิ	"net premium; <a href=""/coinages/websearch.php?Wd=on+net&amp;Sj=0"">on net</a>"	๒ มี.ค. ๒๕๔๕
เบี้ยประกันภัยสุทธิธรรมชาติ	net natural premium	๒ มี.ค. ๒๕๔๕
เบี้ยประกันภัยอัตราคงที่	"level premium; <a href=""/coinages/websearch.php?Wd=level+rate&amp;Sj=0"">level rate</a>"	๒ มี.ค. ๒๕๔๕
เบี้ยประกันภัยล่วงหน้า	advance premium	๒ มี.ค. ๒๕๔๕
เบี้ยประกันภัยไม่สม่ำเสมอ	irregular premium	๒ มี.ค. ๒๕๔๕
เบี้ยประกันภัยขั้นต่ำ	minimum premium	๒ มี.ค. ๒๕๔๕
เบี้ยประกันภัยคงที่	"constant premium; <a href=""/coinages/websearch.php?Wd=fixed+premium&amp;Sj=0"">fixed premium</a>"	๒ มี.ค. ๒๕๔๕
เบี้ยประกันภัยจ่ายล่วงหน้า	lay-up returns	๒ มี.ค. ๒๕๔๕
เบี้ยประกันภัยจ่ายคืน	return premium	๒ มี.ค. ๒๕๔๕
เบี้ยประกันภัยจ่ายคืนเมื่อยกเลิกเท่านั้น	cancelling returns only	๒ มี.ค. ๒๕๔๕
เบี้ยประกันภัยจ่ายคืนเมื่อไม่มีการเรียกร้องค่าสินไหมทดแทน	return for no claim	๒ มี.ค. ๒๕๔๕
เบี้ยประกันภัยชำระครั้งเดียว	pauschal	๒ มี.ค. ๒๕๔๕
เบี้ยประกันภัยต่ออายุ	estimated premium	๒ มี.ค. ๒๕๔๕
เบี้ยประกันภัยตัวเรือจ่ายคืน	renewal premium	๒ มี.ค. ๒๕๔๕
เบี้ยประกันภัยตามที่ตกลง	hull returns	๒ มี.ค. ๒๕๔๕
เบี้ยประกันภัยที่ยังไม่ถือเป็นรายได้	unearned premium	๒ มี.ค. ๒๕๔๕
เบี้ยพีแอนด์ไอ	call; Club call	๒ มี.ค. ๒๕๔๕
เบี้ยพีแอนด์ไอเพิ่ม	supplementary calls	๒ มี.ค. ๒๕๔๕
เบี้ยประกันภัยที่ถือเป็นรายได้	"premium to be agreed; <a href=""/coinages/websearch.php?Wd=premium+to+be+arranged&amp;Sj=0"">premium to be arranged</a>"	๒ มี.ค. ๒๕๔๕
เบี้ยประกันภัยที่ถือเป็นรายได้รวม	"earned premium; <a href=""/coinages/websearch.php?Wd=premium+earned&amp;Sj=0"">premium earned</a>"	๒ มี.ค. ๒๕๔๕
เบี้ยประกันภัยที่ถือเป็นรายได้สุทธิ	net earned premium	๒ มี.ค. ๒๕๔๕
เบี้ยประกันภัยที่ปรับได้	adjustable premium	๒ มี.ค. ๒๕๔๕
เบี้ยประกันภัยธรรมชาติ	natural premium	๒ มี.ค. ๒๕๔๕
เบี้ยประกันภัยผ่อนชำระ	instalment premium	๒ มี.ค. ๒๕๔๕
เบี้ยประกันภัยฝาก	deposit premium	๒ มี.ค. ๒๕๔๕
เบี้ยประกันภัยพื้นฐาน	"base premium; <a href=""/coinages/websearch.php?Wd=premium+base&amp;Sj=0"">premium base</a>"	๒ มี.ค. ๒๕๔๕
ใบค้ำประกันอนุญาต	sufferance bond	๒ มี.ค. ๒๕๔๕
ใบคำขอมาตรฐานสัญญาประกันภัยต่อ	R/I treaty standard slip	๒ มี.ค. ๒๕๔๕
ใบตราส่ง	bill of lading	๒ มี.ค. ๒๕๔๕
แบบมาตรฐาน	standard form	๒ มี.ค. ๒๕๔๕
แบบสะสมทรัพย์	endowment	๒ มี.ค. ๒๕๔๕
แบบฟอร์มของสถาบันลอยด์	"Lloyd’s Form; <a href=""/coinages/websearch.php?Wd=Lloyd%27s+Open+Form&amp;Sj=0"">Lloyd’s Open Form</a>"	๒ มี.ค. ๒๕๔๕
แผน	scheme	๒ มี.ค. ๒๕๔๕
แผนร่วมรับประกันภัย	association scheme	๒ มี.ค. ๒๕๔๕
แผนร่วมเฉลี่ยการจัดทดแทนตามเกณฑ์ร้อยละ ๘๕	eighty-five per cent reinstatement average scheme	๒ มี.ค. ๒๕๔๕
แผนเตรียมเงินบำนาญ	funded pension plan	๒ มี.ค. ๒๕๔๕
แผนประสานเพื่อกำหนดมูลค่า	valuation linked scheme	๒ มี.ค. ๒๕๔๕
เพิ่มอัตรา	rated-up	๒ มี.ค. ๒๕๔๕
bail bond	กรมธรรม์ค้ำประกันผู้ต้องหา	๒ มี.ค. ๒๕๔๕
bailee	ผู้รับฝากทรัพย์	๒ มี.ค. ๒๕๔๕
bailee clause	ข้อกำหนดผู้รับฝากทรัพย์	๒ มี.ค. ๒๕๔๕
bailment	การฝากทรัพย์	๒ มี.ค. ๒๕๔๕
bailor	ผู้ฝากทรัพย์	๒ มี.ค. ๒๕๔๕
balanced portfolio	ยอดรวมสมดุล	๒ มี.ค. ๒๕๔๕
balancing charges	ภาษีจากค่าชดใช้เกิน	๒ มี.ค. ๒๕๔๕
bank guarantee	หนังสือค้ำประกันของธนาคาร	๒ มี.ค. ๒๕๔๕
barratry	การทุจริตของพนักงานเรือ	๒ มี.ค. ๒๕๔๕
base premium	เบี้ยประกันภัยพื้นฐาน	๒ มี.ค. ๒๕๔๕
base value	มูลค่าประกันภัยพื้นฐาน	๒ มี.ค. ๒๕๔๕
basic specification	การระบุมูลฐาน	๒ มี.ค. ๒๕๔๕
basis of valuation	เกณฑ์ตีมูลค่าประกันภัย	๒ มี.ค. ๒๕๔๕
basis rate	อัตราพื้นฐาน	๒ มี.ค. ๒๕๔๕
batch clause	ข้อกำหนดผลิตภัณฑ์เป็นรุ่น	๒ มี.ค. ๒๕๔๕
bearer policy	กรมธรรม์จ่ายผู้ถือ	๒ มี.ค. ๒๕๔๕
beneficiary	ผู้รับประโยชน์	๒ มี.ค. ๒๕๔๕
benefit	ผลประโยชน์	๒ มี.ค. ๒๕๔๕
benefit of insurance	ผลประโยชน์ในการประกันภัย	๒ มี.ค. ๒๕๔๕
benefit of salvage	ผลประโยชน์ซากทรัพย์	๒ มี.ค. ๒๕๔๕
benefit policy	กรมธรรม์กำหนดผลประโยชน์	๒ มี.ค. ๒๕๔๕
betterment	สภาพที่ดีกว่าเดิม	๒ มี.ค. ๒๕๔๕
bid bond	กรมธรรม์ค้ำประกันการประมูล	๒ มี.ค. ๒๕๔๕
bilateral contract	สัญญาผูกพันสองฝ่าย	๒ มี.ค. ๒๕๔๕
bill of lading	ใบตราส่ง	๒ มี.ค. ๒๕๔๕
binder	๑. หนังสือคุ้มครองชั่วคราว<br/>๒. หนังสือมอบอำนาจผู้รับประกันภัย	๒ มี.ค. ๒๕๔๕
binding authority	อำนาจรับประกันภัยแทน	๒ มี.ค. ๒๕๔๕
binding clause	ข้อกำหนดส่วนรับผิด	๒ มี.ค. ๒๕๔๕
binding receipt	ใบรับผูกพัน	๒ มี.ค. ๒๕๔๕
blackout period	ช่วงเวลาปลอดประโยชน์	๒ มี.ค. ๒๕๔๕
blanket rate	อัตราเบี้ยประกันภัยแบบรวม	๒ มี.ค. ๒๕๔๕
blanket policy	กรมธรรม์คุ้มครองรวม	๒ มี.ค. ๒๕๔๕
blind treaty	สัญญาประกันภัยต่อคล้อยตาม	๒ มี.ค. ๒๕๔๕
block limit	ขีดจำกัดในเขตรับประกันภัย	๒ มี.ค. ๒๕๔๕
block policy	กรมธรรม์เบ็ดเสร็จ	๒ มี.ค. ๒๕๔๕
block system	ระบบเขต	๒ มี.ค. ๒๕๔๕
blood relative clause	ข้อกำหนดญาติทางสายเลือด	๒ มี.ค. ๒๕๔๕
bodily injury	การบาดเจ็บทางร่างกาย	๒ มี.ค. ๒๕๔๕
boiler insurance	การประกันภัยหม้อกำเนิดไอน้ำ	๒ มี.ค. ๒๕๔๕
bond	๑. การค้ำประกัน<br/>๒. กรมธรรม์ค้ำประกัน	๒ มี.ค. ๒๕๔๕
bonding	การประกันภัยค้ำประกัน	๒ มี.ค. ๒๕๔๕
bonus	"เงินปันผล <i>มีความหมายเหมือนกับ <a href=""/coinages/websearch.php?Wd=dividend&amp;Sj=0"">dividend</a></i>"	๒ มี.ค. ๒๕๔๕
bonus allocation	"การจัดสรรเงินปันผล <i>มีความหมายเหมือนกับ <a href=""/coinages/websearch.php?Wd=allotment+of+bonus&amp;Sj=0"">allotment of bonus</a></i>"	๒ มี.ค. ๒๕๔๕
bonus declaration	การประกาศเงินปันผล	๒ มี.ค. ๒๕๔๕
bonus loading	ส่วนบวกเพิ่มเงินปันผล	๒ มี.ค. ๒๕๔๕
bonus reserve	เงินสำรองเงินปันผล	๒ มี.ค. ๒๕๔๕
book debts insurance	การประกันภัยหนี้ตามบัญชี	๒ มี.ค. ๒๕๔๕
book interest	ผลประโยชน์ตามบัญชี	๒ มี.ค. ๒๕๔๕
bordereau	บันทึกงบประกันภัยต่อ	๒ มี.ค. ๒๕๔๕
Both to Blame Collision Clause	ข้อกำหนดความรับผิดสองฝ่าย	๒ มี.ค. ๒๕๔๕
bottomry	เงินกู้ตัวเรือ	๒ มี.ค. ๒๕๔๕
bouquet	การประกันภัยต่อคละ	๒ มี.ค. ๒๕๔๕
bouquet of treaties	การประกันภัยต่อคละ	๒ มี.ค. ๒๕๔๕
breach of contract cover	ความคุ้มครองการผิดสัญญา	๒ มี.ค. ๒๕๔๕
breach of statutory duty	การกระทำผิดหน้าที่	๒ มี.ค. ๒๕๔๕
breach of warranty endorsement	การสลักหลังว่าด้วยการผิดคำรับรอง	๒ มี.ค. ๒๕๔๕
breaking the warranty	การผิดคำรับรอง	๒ มี.ค. ๒๕๔๕
breakdown	ชำรุดเสียหาย	๒ มี.ค. ๒๕๔๕
broker	นายหน้า	๒ มี.ค. ๒๕๔๕
brokerage	ค่าบำเหน็จนายหน้า	๒ มี.ค. ๒๕๔๕
builder’s risk	๑. การประกันภัยผู้ต่อเรือ<br/>๒. การประกันภัยผู้รับเหมาก่อสร้าง	๒ มี.ค. ๒๕๔๕
building rate	อัตราเบี้ยประกันภัยสิ่งปลูกสร้าง	๒ มี.ค. ๒๕๔๕
burglary insurance	"การประกันภัยลักทรัพย์ในเคหสถาน <i>ดู <a href=""/coinages/websearch.php?Wd=theft+insurance&amp;Sj=0"">theft insurance</a></i>"	๒ มี.ค. ๒๕๔๕
burning cost	ค่าเสียหายพื้นฐาน	๒ มี.ค. ๒๕๔๕
burning ratio	"อัตราส่วนค่าเสียหายพื้นฐาน <i>ดู <a href=""/coinages/websearch.php?Wd=burning+cost&amp;Sj=0"">burning cost</a></i>"	๒ มี.ค. ๒๕๔๕
business insurance	การประกันชีวิตเพื่อธุรกิจ	๒ มี.ค. ๒๕๔๕
business interruption insurance	การประกันภัยธุรกิจหยุดชะงัก	๒ มี.ค. ๒๕๔๕
business risk	การเสี่ยงภัยทางธุรกิจ	๒ มี.ค. ๒๕๔๕
buyer’s interest	ส่วนได้เสียของผู้ซื้อ	๒ มี.ค. ๒๕๔๕
C.L.U. (Chartered Life Underwriter)	วุฒิบัตรซีแอลยู	๒ มี.ค. ๒๕๔๕
C.P.C.U. (Chartered Property and Casualty Underwriter)	วุฒิบัตรซีพีซียู	๒ มี.ค. ๒๕๔๕
call	เบี้ยพีแอนด์ไอ	๒ มี.ค. ๒๕๔๕
cancellation clause	ข้อกำหนดการยกเลิกกรมธรรม์	๒ มี.ค. ๒๕๔๕
cancelling returns only	เบี้ยประกันภัยจ่ายคืนเมื่อยกเลิกเท่านั้น	๒ มี.ค. ๒๕๔๕
cancellation	การยกเลิกกรมธรรม์	๒ มี.ค. ๒๕๔๕
capacity	วิสัยสามารถ	๒ มี.ค. ๒๕๔๕
capital additions clause	ข้อกำหนดคุ้มครองทุนเพิ่ม	๒ มี.ค. ๒๕๔๕
capital benefits	ผลประโยชน์เป็นเงินก้อน	๒ มี.ค. ๒๕๔๕
capital sum	จำนวนเงินก้อน	๒ มี.ค. ๒๕๔๕
captive insurance company	บริษัทประกันภัยในอาณัติ	๒ มี.ค. ๒๕๔๕
capture and seizure	การจับกุมและยึดเอา	๒ มี.ค. ๒๕๔๕
cargo insurance	การประกันภัยสินค้าขนส่ง	๒ มี.ค. ๒๕๔๕
cargo interest	ส่วนได้เสียในสินค้าขนส่ง	๒ มี.ค. ๒๕๔๕
Carpenter plan	"การประกันภัยต่อแบบคาร์เพนเตอร์ <i>มีความหมายเหมือนกับ <a href=""/coinages/websearch.php?Wd=spread+loss+reinsurance&amp;Sj=0"">spread loss reinsurance</a></i>"	๒ มี.ค. ๒๕๔๕
carrier	๑. ผู้ขนส่ง<br/>๒. ผู้รับประกันภัย	๒ มี.ค. ๒๕๔๕
cash option	สิทธิเลือกเงินสด	๒ มี.ค. ๒๕๔๕
cash refund annuity	เงินรายปีชนิดจ่ายคืนเงินสด	๒ มี.ค. ๒๕๔๕
cash surrender value	"มูลค่าเวนคืนกรมธรรม์ประกันชีวิต <i>ดู <a href=""/coinages/websearch.php?Wd=cash+value&amp;Sj=0"">cash value</a></i>"	๒ มี.ค. ๒๕๔๕
cash value	มูลค่าเงินสด	๒ มี.ค. ๒๕๔๕
cash agent	ตัวแทนเงินสด	๒ มี.ค. ๒๕๔๕
cash bonus	เงินปันผลเงินสด	๒ มี.ค. ๒๕๔๕
cash loss	ค่าสินไหมทดแทนเรียกคืนทันที	๒ มี.ค. ๒๕๔๕
casualty insurance	การประกันภัยเบ็ดเตล็ด	๒ มี.ค. ๒๕๔๕
catastrophe reinsurance	การประกันมหันตภัยต่อ	๒ มี.ค. ๒๕๔๕
catastrophe	มหันตภัย	๒ มี.ค. ๒๕๔๕
catastrophe hazard	ภาวะมหันตภัย	๒ มี.ค. ๒๕๔๕
ceasing age	อายุสิ้นเกณฑ์	๒ มี.ค. ๒๕๔๕
cedant	"ผู้เอาประกันภัยต่อ <i>มีความหมายเหมือนกับ <a href=""/coinages/websearch.php?Wd=cedent&amp;Sj=0"">cedent</a>; <a href=""/coinages/websearch.php?Wd=reassured&amp;Sj=0"">reassured</a> และ <a href=""/coinages/websearch.php?Wd=reinsured&amp;Sj=0"">reinsured</a></i>"	๒ มี.ค. ๒๕๔๕
cede	เอาประกันภัยต่อ	๒ มี.ค. ๒๕๔๕
cedent	"ผู้เอาประกันภัยต่อ <i>มีความหมายเหมือนกับ <a href=""/coinages/websearch.php?Wd=cedant&amp;Sj=0"">cedant</a>; <a href=""/coinages/websearch.php?Wd=reassured&amp;Sj=0"">reassured</a> และ <a href=""/coinages/websearch.php?Wd=reinsured&amp;Sj=0"">reinsured</a></i>"	๒ มี.ค. ๒๕๔๕
ceding company	บริษัทเอาประกันภัยต่อ	๒ มี.ค. ๒๕๔๕
certificate	ใบรับรอง	๒ มี.ค. ๒๕๔๕
certificate of entry	กรมธรรม์พีแอนด์ไอ	๒ มี.ค. ๒๕๔๕
certificate of insurance	"ใบรับรองการประกันภัย <i>มีความหมายเหมือนกับ <a href=""/coinages/websearch.php?Wd=insurance+certificate&amp;Sj=0"">insurance certificate</a></i>"	๒ มี.ค. ๒๕๔๕
cession	ส่วนที่เอาประกันภัยต่อ	๒ มี.ค. ๒๕๔๕
change of voyage clause	ข้อกำหนดการเปลี่ยนแปลงเส้นทาง	๒ มี.ค. ๒๕๔๕
change in temperature clause	ข้อกำหนดเรื่องอุณหภูมิเปลี่ยน	๒ มี.ค. ๒๕๔๕
charges of insurance	เบี้ยประกันภัย	๒ มี.ค. ๒๕๔๕
Chartered Life Underwriter (C.L.U.)	วุฒิบัตรซีแอลยู	๒ มี.ค. ๒๕๔๕
Chartered loss adjuster	ผู้เจรจาตกลงความเสียหายชาร์เตอร์	๒ มี.ค. ๒๕๔๕
Chartered Property and Casualty Underwriter (C.P.C.U.)	วุฒิบัตรซีพีซียู	๒ มี.ค. ๒๕๔๕
child’s deferred assurance	การประกันชีวิตผู้เยาว์เลื่อนกำหนด	๒ มี.ค. ๒๕๔๕
chose in action	สิทธิประโยชน์อนาคต	๒ มี.ค. ๒๕๔๕
claim	๑. การเรียกร้องค่าสินไหมทดแทน<br/>๒. ค่าสินไหมทดแทน	๒ มี.ค. ๒๕๔๕
claim agent	ตัวแทนค่าสินไหมทดแทน	๒ มี.ค. ๒๕๔๕
claimright insurance	การประกันภัยการยับยั้งการชำระเงิน	๒ มี.ค. ๒๕๔๕
claims adjuster	ผู้เจรจาตกลงค่าสินไหมทดแทน	๒ มี.ค. ๒๕๔๕
Claims Bureau	สำนักงานจัดการค่าสินไหมทดแทน	๒ มี.ค. ๒๕๔๕
claims condition	เงื่อนไขเรียกร้องค่าสินไหมทดแทน	๒ มี.ค. ๒๕๔๕
claims cooperation clause	ข้อกำหนดความร่วมมือเรื่องค่าสินไหมทดแทน	๒ มี.ค. ๒๕๔๕
claims equalisation reserve	เงินสำรองรักษาระดับค่าสินไหมทดแทน	๒ มี.ค. ๒๕๔๕
claims expenses	ค่าจัดการค่าสินไหมทดแทน	๒ มี.ค. ๒๕๔๕
claims reserves	เงินสำรองค่าสินไหมทดแทน	๒ มี.ค. ๒๕๔๕
claims sharing agreement	ข้อตกลงการแบ่งภาระค่าสินไหมทดแทน	๒ มี.ค. ๒๕๔๕
claims-setting agent	ตัวแทนจัดการค่าสินไหมทดแทน	๒ มี.ค. ๒๕๔๕
classification clause	ข้อกำหนดมาตรฐานเรือ	๒ มี.ค. ๒๕๔๕
classification society	สมาคมมาตรฐานเรือ	๒ มี.ค. ๒๕๔๕
clause	ข้อกำหนด	๒ มี.ค. ๒๕๔๕
clean cut basis	หลักการตัดภาระผูกพัน	๒ มี.ค. ๒๕๔๕
clean-up fund	ทุนสำรองสุดท้าย	๒ มี.ค. ๒๕๔๕
closed line	การปิดการหาผู้รับประกันภัย	๒ มี.ค. ๒๕๔๕
Club calls	"เบี้ยพีแอนด์ไอ <i>มีความหมายเหมือนกับ <a href=""/coinages/websearch.php?Wd=call&amp;Sj=0"">call</a></i>"	๒ มี.ค. ๒๕๔๕
closing slip	สลิปแจ้งผลสรุป	๒ มี.ค. ๒๕๔๕
วัสดุกั้นอัคคีภัย	fire stop	๒ มี.ค. ๒๕๔๕
วัตถุติดที่	fixed objects	๒ มี.ค. ๒๕๔๕
วันเริ่มเสี่ยงภัย	attachment date	๒ มี.ค. ๒๕๔๕
วันเริ่มคุ้มครอง	inception date	๒ มี.ค. ๒๕๔๕
วันเริ่มผลบังคับ	effective date	๒ มี.ค. ๒๕๔๕
วันครบกำหนด	due date	๒ มี.ค. ๒๕๔๕
co-assurance	"การประกันภัยร่วม <i>มีความหมายเหมือนกับ <a href=""/coinages/websearch.php?Wd=co-insurance&amp;Sj=0"">co-insurance</a></i>"	๒ มี.ค. ๒๕๔๕
co-assurer	"ผู้รับประกันภัยร่วม <i>มีความหมายเหมือนกับ <a href=""/coinages/websearch.php?Wd=co-insurer&amp;Sj=0"">co-insurer</a></i>"	๒ มี.ค. ๒๕๔๕
co-insurance	การประกันภัยร่วม	๒ มี.ค. ๒๕๔๕
co-insurer	ผู้รับประกันภัยร่วม	๒ มี.ค. ๒๕๔๕
co-surety	ผู้รับประกันภัยค้ำประกันร่วม	๒ มี.ค. ๒๕๔๕
coded excesses method	วิธีการปรับเบี้ยประกันภัยตามประมวล	๒ มี.ค. ๒๕๔๕
วิสัยสามารถ	capacity	๒ มี.ค. ๒๕๔๕
collapse	การยุบแฟบ	๒ มี.ค. ๒๕๔๕
collateral assignment	การโอนสิทธิ์บางส่วน	๒ มี.ค. ๒๕๔๕
collecting book	สมุดเก็บเบี้ยประกันภัย	๒ มี.ค. ๒๕๔๕
collecting commission	ค่าบำเหน็จรับค่าสินไหมทดแทน	๒ มี.ค. ๒๕๔๕
collecting note	ใบมอบฉันทะรับค่าสินไหมทดแทน	๒ มี.ค. ๒๕๔๕
collective policy	๑. กรมธรรม์ร่วม<br/>๒. กรมธรรม์หมู่	๒ มี.ค. ๒๕๔๕
collector	ผู้เก็บเงิน	๒ มี.ค. ๒๕๔๕
collision	การชน	๒ มี.ค. ๒๕๔๕
collision clause	ข้อกำหนดการชน	๒ มี.ค. ๒๕๔๕
combination policy	กรมธรรม์ร่วม	๒ มี.ค. ๒๕๔๕
combined company policy	กรมธรรม์บริษัทร่วม	๒ มี.ค. ๒๕๔๕
combined liability policy	กรมธรรม์ความรับผิดร่วม	๒ มี.ค. ๒๕๔๕
combined policy	กรมธรรม์รวม	๒ มี.ค. ๒๕๔๕
combination company	บริษัทประกันชีวิตแบบรวม	๒ มี.ค. ๒๕๔๕
combination plan reinsurance	การประกันภัยต่อแบบรวม	๒ มี.ค. ๒๕๔๕
commission	ค่าบำเหน็จ	๒ มี.ค. ๒๕๔๕
Commissioners’ 1941 Standard Ordinary Table	ตารางมรณวิสัยซีเอสโอ ๑๙๔๑	๒ มี.ค. ๒๕๔๕
Commissioners’ 1958 Standard Ordinary Table	ตารางมรณวิสัยซีเอสโอ ๑๙๕๘	๒ มี.ค. ๒๕๔๕
committee of Lloyd’s	คณะกรรมการแห่งลอยด์	๒ มี.ค. ๒๕๔๕
common account	การประกันภัยต่อเพื่อประโยชน์ร่วมกัน	๒ มี.ค. ๒๕๔๕
common carrier	ผู้ขนส่งสาธารณะ	๒ มี.ค. ๒๕๔๕
common hazard	"ภาวะภัยสามัญ <i>มีความหมายเหมือนกับ <a href=""/coinages/websearch.php?Wd=general+hazard&amp;Sj=0"">general hazard</a></i>"	๒ มี.ค. ๒๕๔๕
common law	กฎหมายจารีตประเพณี	๒ มี.ค. ๒๕๔๕
common disaster clause	ข้อกำหนดภัยพิบัติร่วมกัน	๒ มี.ค. ๒๕๔๕
communication	ทางสื่อไฟ	๒ มี.ค. ๒๕๔๕
commuted value	มูลค่าเหมาจ่าย	๒ มี.ค. ๒๕๔๕
commutation	การเหมาจ่าย	๒ มี.ค. ๒๕๔๕
commutation clause	ข้อกำหนดการเหมาจ่าย	๒ มี.ค. ๒๕๔๕
compensation	การชดเชย, การทดแทน	๒ มี.ค. ๒๕๔๕
completion bond	กรมธรรม์ค้ำประกันการเสร็จสมบูรณ์	๒ มี.ค. ๒๕๔๕
component parts clause	ข้อกำหนดส่วนประกอบ(เครื่องบิน)	๒ มี.ค. ๒๕๔๕
composite company	ผู้รับประกันภัยรวม	๒ มี.ค. ๒๕๔๕
compound reversionary bonus	เงินปันผลเพิ่มพูนทบต้น	๒ มี.ค. ๒๕๔๕
comprehensive policy	กรมธรรม์สมบูรณ์แบบ	๒ มี.ค. ๒๕๔๕
compulsory insurance	การประกันภัยโดยบังคับ	๒ มี.ค. ๒๕๔๕
concealment	การปกปิดข้อความจริง	๒ มี.ค. ๒๕๔๕
concurrent insurance	การประกันภัยพ้อง	๒ มี.ค. ๒๕๔๕
condition of average	"เงื่อนไขการแบ่งความรับผิด <i>มีความหมายเหมือนกับ <a href=""/coinages/websearch.php?Wd=average+condition&amp;Sj=0"">average condition</a></i>"	๒ มี.ค. ๒๕๔๕
condition precedent of the policy	เงื่อนไขบังคับก่อน	๒ มี.ค. ๒๕๔๕
condition precedent to liability	เงื่อนไขก่อนความรับผิด	๒ มี.ค. ๒๕๔๕
condition subsequent of the policy	เงื่อนไขบังคับหลัง	๒ มี.ค. ๒๕๔๕
conditional probability	ความน่าจะเป็นแบบมีเงื่อนไข	๒ มี.ค. ๒๕๔๕
conditional receipt	ใบรับเบี้ยประกันภัยโดยมีเงื่อนไข	๒ มี.ค. ๒๕๔๕
confiscation insurance	การประกันภัยการยึดทรัพย์	๒ มี.ค. ๒๕๔๕
conflagration	มหาอัคคีภัย	๒ มี.ค. ๒๕๔๕
conflagration area	เขตมหาอัคคีภัย	๒ มี.ค. ๒๕๔๕
consideration	ค่าต่างตอบแทน	๒ มี.ค. ๒๕๔๕
consequential loss insurance	การประกันภัยความเสียหายสืบเนื่อง	๒ มี.ค. ๒๕๔๕
constant premium	"เบี้ยประกันภัยคงที่ <i>มีความหมายเหมือนกับ <a href=""/coinages/websearch.php?Wd=fixed+premium&amp;Sj=0"">fixed premium</a></i>"	๒ มี.ค. ๒๕๔๕
constructive total loss	ความเสียหายที่เสมือนเสียหายสิ้นเชิง	๒ มี.ค. ๒๕๔๕
contact damage	ความเสียหายจากการกระแทก	๒ มี.ค. ๒๕๔๕
contents rate	อัตราเบี้ยประกันภัยทรัพย์สินในอาคาร	๒ มี.ค. ๒๕๔๕
contingency fund	กองทุนฉุกเฉิน	๒ มี.ค. ๒๕๔๕
contingency insurance	การประกันภัยเหตุการณ์ที่อาจเป็นได้	๒ มี.ค. ๒๕๔๕
contingency reserve	เงินทุนสำรองฉุกเฉิน	๒ มี.ค. ๒๕๔๕
contingent assurance	การประกันชีวิตมีเงื่อนไข	๒ มี.ค. ๒๕๔๕
contingent beneficiary	ผู้รับประโยชน์มีเงื่อนไข	๒ มี.ค. ๒๕๔๕
contingent bonus	เงินปันผลมีเงื่อนไข	๒ มี.ค. ๒๕๔๕
contingent debt	หนี้มีเงื่อนไข	๒ มี.ค. ๒๕๔๕
contingent liability	ความรับผิดมีเงื่อนไข	๒ มี.ค. ๒๕๔๕
contingent survivorship assurance	การประกันชีวิตมีเงื่อนไขทรงชีพ	๒ มี.ค. ๒๕๔๕
continuation option	สิทธิเลือกต่อประกันชีวิต	๒ มี.ค. ๒๕๔๕
contra preferentem rule	กฎการตีความสัญญากำกวม	๒ มี.ค. ๒๕๔๕
contract for services	สัญญาจ้างเหมา	๒ มี.ค. ๒๕๔๕
contract of adhesion	สัญญาตายตัว	๒ มี.ค. ๒๕๔๕
contract of indemnity	สัญญาชดใช้ค่าสินไหมทดแทน	๒ มี.ค. ๒๕๔๕
contract of insurance	สัญญาประกันภัย	๒ มี.ค. ๒๕๔๕
contract of service	สัญญาจ้าง	๒ มี.ค. ๒๕๔๕
contract price clause	ข้อกำหนดชดใช้ตามสัญญาซื้อขาย	๒ มี.ค. ๒๕๔๕
contract works insurance	"การประกันภัยการรับเหมา <i>มีความหมายเหมือนกับ <a href=""/coinages/websearch.php?Wd=contractors%27+all+risks&amp;Sj=0"">contractors’ all risks</a></i>"	๒ มี.ค. ๒๕๔๕
contractors’ all risks	การประกันสรรพภัยของการรับเหมา	๒ มี.ค. ๒๕๔๕
contractual liability	ความรับผิดตามสัญญา	๒ มี.ค. ๒๕๔๕
contribution	การร่วมชดใช้ค่าสินไหมทดแทน	๒ มี.ค. ๒๕๔๕
contributory	การมีส่วนร่วม	๒ มี.ค. ๒๕๔๕
contributory negligence	ความประมาทร่วม	๒ มี.ค. ๒๕๔๕
contributory reinsurance	การประกันภัยต่อร่วม	๒ มี.ค. ๒๕๔๕
contributory value	มูลค่าเพื่อเฉลี่ยค่าเสียหายร่วม	๒ มี.ค. ๒๕๔๕
convertible term assurance	การประกันชีวิตแบบชั่วระยะเวลาที่แปลงได้	๒ มี.ค. ๒๕๔๕
cooling-off period	ระยะปลอดพันธะ	๒ มี.ค. ๒๕๔๕
corporation insurance	"การประกันชีวิตเพื่อธุรกิจ <i>มีความหมายเหมือนกับ <a href=""/coinages/websearch.php?Wd=business+insurance&amp;Sj=0"">business insurance</a> และ <a href=""/coinages/websearch.php?Wd=partnership+insurance&amp;Sj=0"">partnership insurance</a></i>"	๒ มี.ค. ๒๕๔๕
cost escalation cover	ความคุ้มครองต้นทุนเพิ่ม	๒ มี.ค. ๒๕๔๕
cost of insurance	ค่าประกันภัย	๒ มี.ค. ๒๕๔๕
counter life	บุคคลสมทบ	๒ มี.ค. ๒๕๔๕
country damage	ความเสียหายสืบจากท้องถิ่น	๒ มี.ค. ๒๕๔๕
coupon policy	กรมธรรม์ชนิดคูปอง	๒ มี.ค. ๒๕๔๕
coverage	ความคุ้มครอง	๒ มี.ค. ๒๕๔๕
วิถีอุบัติเหตุ	accidental means	๒ มี.ค. ๒๕๔๕
วิธีใช้กำลังและความรุนแรง	"forcible and violent means; <a href=""/coinages/websearch.php?Wd=violent+and+forcible+means&amp;Sj=0"">violent and forcible means</a>"	๒ มี.ค. ๒๕๔๕
วิธีการปรับเบี้ยประกันภัยตามประมวล	coded excesses method	๒ มี.ค. ๒๕๔๕
วิธีของซิลล์เมอร์	Zillmerisation	๒ มี.ค. ๒๕๔๕
วินาศภัย	loss	๒ มี.ค. ๒๕๔๕
วิธีคำนวณความรับผิดโดยเอกเทศ	independent liability method	๒ มี.ค. ๒๕๔๕
craft risks	ภัยขณะลำเลียง	๒ มี.ค. ๒๕๔๕
credit agent	ตัวแทนเครดิต	๒ มี.ค. ๒๕๔๕
credit card insurance	การประกันภัยบัตรเครดิต	๒ มี.ค. ๒๕๔๕
credit insurance	การประกันภัยสินเชื่อ	๒ มี.ค. ๒๕๔๕
credit life assurance	การประกันชีวิตเพื่อสินเชื่อ	๒ มี.ค. ๒๕๔๕
creditor life insurance	"การประกันชีวิตเพื่อเจ้าหนี้ <i>มีความหมายเหมือนกับ <a href=""/coinages/websearch.php?Wd=credit+life+assurance&amp;Sj=0"">credit life assurance</a></i>"	๒ มี.ค. ๒๕๔๕
crop insurance	การประกันภัยพืชผล	๒ มี.ค. ๒๕๔๕
cross liabilities	ความรับผิดปฏิพันธ์	๒ มี.ค. ๒๕๔๕
cross purchase agreement	ข้อตกลงไขว้	๒ มี.ค. ๒๕๔๕
customary strandings	การเกยตื้นที่แหล่งประจำ	๒ มี.ค. ๒๕๔๕
customers’ extension	การขยายความคุ้มครองทรัพย์สินลูกค้า	๒ มี.ค. ๒๕๔๕
Customs and Excise bonds	กรมธรรม์ค้ำประกันศุลกากรและอากรสรรพสามิต	๒ มี.ค. ๒๕๔๕
custody and control	ความดูแลรักษาและควบคุม	๒ มี.ค. ๒๕๔๕
customary groundings	"การติดตื้นที่แหล่งประจำ <i>ดู <a href=""/coinages/websearch.php?Wd=customary+strandings&amp;Sj=0"">customary strandings</a></i>"	๒ มี.ค. ๒๕๔๕
cut-off	"การชำระความรับผิดเด็ดขาด <i>ดู <a href=""/coinages/websearch.php?Wd=clean+cut+basis&amp;Sj=0"">clean cut basis</a></i>"	๒ มี.ค. ๒๕๔๕
cut-through clause	ข้อกำหนดการรับผิดโดยตรง	๒ มี.ค. ๒๕๔๕
cycle insurance	การประกันภัยรถจักรยาน	๒ มี.ค. ๒๕๔๕
วงเงินโทษปรับ	penalty	๒ มี.ค. ๒๕๔๕
วุฒิบัตรซีแอลยู	"Chartered Life Underwriter (<a href=""/coinages/websearch.php?Wd=C.L.U.&amp;Sj=0"">C.L.U.</a>)"	๒ มี.ค. ๒๕๔๕
วุฒิบัตรซีพีซียู	"Chartered Property and Casualty Underwriter (<a href=""/coinages/websearch.php?Wd=C.P.C.U.&amp;Sj=0"">C.P.C.U.</a>)"	๒ มี.ค. ๒๕๔๕
Da Costa clause	"ข้อกำหนดญาติทางสายเลือด <i>มีความหมายเหมือนกับ <a href=""/coinages/websearch.php?Wd=blood+relative+clause&amp;Sj=0"">blood relative clause</a></i>"	๒ มี.ค. ๒๕๔๕
damaged value	มูลค่าหลังเสียหาย	๒ มี.ค. ๒๕๔๕
damages	ค่าเสียหาย	๒ มี.ค. ๒๕๔๕
datum level	ขีดการจ่ายหมด	๒ มี.ค. ๒๕๔๕
datum line cover	ความคุ้มครองจ่ายหมดเมื่อถึงขีด	๒ มี.ค. ๒๕๔๕
death benefit	ผลประโยชน์เมื่อถึงแก่กรรม	๒ มี.ค. ๒๕๔๕
death-in-service benefits	ผลประโยชน์เมื่อถึงแก่กรรมในหน้าที่	๒ มี.ค. ๒๕๔๕
debit	เขตรับผิดชอบของตัวแทน	๒ มี.ค. ๒๕๔๕
debris removal clause	ข้อกำหนดเคลื่อนย้ายซากทรัพย์	๒ มี.ค. ๒๕๔๕
declaration	๑. คำแถลง<br/>๒. การแจ้งรายละเอียด	๒ มี.ค. ๒๕๔๕
declaration of bonus	"การประกาศเงินปันผล <i>มีความหมายเหมือนกับ <a href=""/coinages/websearch.php?Wd=bonus+declaration&amp;Sj=0"">bonus declaration</a></i>"	๒ มี.ค. ๒๕๔๕
decline list	รายการภัยที่ปฏิเสธ	๒ มี.ค. ๒๕๔๕
decreasing term insurance	การประกันชีวิตแบบชั่วระยะเวลาลดเงินเอาประกันภัย	๒ มี.ค. ๒๕๔๕
deductible	"การรับผิดส่วนแรก <i>มีความหมายเหมือนกับ <a href=""/coinages/websearch.php?Wd=excess&amp;Sj=0"">excess</a> และ <a href=""/coinages/websearch.php?Wd=first+loss&amp;Sj=0"">first loss</a></i>"	๒ มี.ค. ๒๕๔๕
defamation insurance	การประกันภัยการหมิ่นประมาท	๒ มี.ค. ๒๕๔๕
deferred account	บัญชีผ่อนจ่าย	๒ มี.ค. ๒๕๔๕
deferred annuity	เงินรายปีที่เลื่อนการรับ	๒ มี.ค. ๒๕๔๕
deferred period	ระยะรอรับผลประโยชน์	๒ มี.ค. ๒๕๔๕
deficiency reserve	เงินสำรองส่วนขาด	๒ มี.ค. ๒๕๔๕
deficit clause	ข้อกำหนดการขาดทุน	๒ มี.ค. ๒๕๔๕
definite advice	คำยืนยันแน่นอน	๒ มี.ค. ๒๕๔๕
delivery guarantee cover	ความคุ้มครองการส่งมอบ	๒ มี.ค. ๒๕๔๕
demurrage	๑. ค่าเสียเวลา<br/>๒. ช่วงเสียเวลา	๒ มี.ค. ๒๕๔๕
denial of access	การห้ามเข้าใช้อาคาร	๒ มี.ค. ๒๕๔๕
dependency period income	เงินได้ระยะพึ่งพิง	๒ มี.ค. ๒๕๔๕
deposit	เงินฝาก	๒ มี.ค. ๒๕๔๕
deposit premium	เบี้ยประกันภัยฝาก	๒ มี.ค. ๒๕๔๕
depreciation	การเสื่อมราคา	๒ มี.ค. ๒๕๔๕
deviation	การเบี่ยงเส้นทาง	๒ มี.ค. ๒๕๔๕
deviation clause	ข้อกำหนดการเบี่ยงเส้นทาง	๒ มี.ค. ๒๕๔๕
difference in conditions policy	กรมธรรม์คุ้มครองความต่างกันของเงื่อนไข	๒ มี.ค. ๒๕๔๕
difference insurance	การประกันภัยค่าแตกต่าง	๒ มี.ค. ๒๕๔๕
direct business	ธุรกิจโดยตรง	๒ มี.ค. ๒๕๔๕
direct insurance	การประกันภัยโดยตรง	๒ มี.ค. ๒๕๔๕
direct reinsurer	ผู้รับประกันภัยต่อโดยตรง	๒ มี.ค. ๒๕๔๕
direct writing	การรับประกันภัยโดยตรง	๒ มี.ค. ๒๕๔๕
directors’ and officers’ liability insurance	การประกันภัยความรับผิดของกรรมการและพนักงานบริษัท	๒ มี.ค. ๒๕๔๕
disability benefit	ผลประโยชน์ทุพพลภาพ	๒ มี.ค. ๒๕๔๕
disability income	เงินได้ทุพพลภาพ	๒ มี.ค. ๒๕๔๕
disability percentage table	ตารางอัตราทุพพลภาพ	๒ มี.ค. ๒๕๔๕
disability provision	ข้อกำหนดเกี่ยวกับทุพพลภาพ	๒ มี.ค. ๒๕๔๕
disablement benefit	ผลประโยชน์เพื่อทุพพลภาพ	๒ มี.ค. ๒๕๔๕
disbursements	ค่าใช้จ่ายการเดินเรือ	๒ มี.ค. ๒๕๔๕
disbursements clause	ข้อกำหนดค่าใช้จ่าย	๒ มี.ค. ๒๕๔๕
disclosure	"การเปิดเผยความจริง <i>ดู <a href=""/coinages/websearch.php?Wd=duty+of+disclosure&amp;Sj=0"">duty of disclosure</a></i>"	๒ มี.ค. ๒๕๔๕
discount	ส่วนลด	๒ มี.ค. ๒๕๔๕
discovery cover	ความคุ้มครองเมื่อตรวจพบ	๒ มี.ค. ๒๕๔๕
discovery period	ระยะตรวจพบ	๒ มี.ค. ๒๕๔๕
dividend	เงินปันผล	๒ มี.ค. ๒๕๔๕
dividend additions	เงินปันผลเพิ่มความคุ้มครอง	๒ มี.ค. ๒๕๔๕
divisible surplus	เงินส่วนเกินที่แบ่งปันได้	๒ มี.ค. ๒๕๔๕
domestic company	บริษัทภายในประเทศ	๒ มี.ค. ๒๕๔๕
donor policy	กรมธรรม์บริจาค	๒ มี.ค. ๒๕๔๕
double endowment assurance	การประกันชีวิตแบบสะสมทรัพย์ทวีคูณ	๒ มี.ค. ๒๕๔๕
double protection	ความคุ้มครองสองเท่า	๒ มี.ค. ๒๕๔๕
double indemnity	การชดใช้สองเท่า	๒ มี.ค. ๒๕๔๕
double insurance	การประกันภัยซ้ำซ้อน	๒ มี.ค. ๒๕๔๕
dual basis	หลักค่าจ้างทวิภาค	๒ มี.ค. ๒๕๔๕
dual valuation clause	ข้อกำหนดมูลค่าทวิภาค	๒ มี.ค. ๒๕๔๕
dual wages basis	หลักค่าจ้างทวิภาค	๒ มี.ค. ๒๕๔๕
due date	วันครบกำหนด	๒ มี.ค. ๒๕๔๕
duty of disclosure	หน้าที่เปิดเผยความจริง	๒ มี.ค. ๒๕๔๕
สรรพภัย	all risks	๒ มี.ค. ๒๕๔๕
สมาคมมาตรฐานเรือ	classification society	๒ มี.ค. ๒๕๔๕
สมาชิกสมทบสถาบันลอยด์	Lloyd’s Associates	๒ มี.ค. ๒๕๔๕
สมาคมผู้รับประกันภัยแบบสถาบันลอยด์	Lloyd’s Association	๒ มี.ค. ๒๕๔๕
สมาชิกสถาบันลอยด์	Member of Lloyd’s	๒ มี.ค. ๒๕๔๕
สภาพที่ดีกว่าเดิม	betterment	๒ มี.ค. ๒๕๔๕
สภาพพร้อมออกทะเล	seaworthiness	๒ มี.ค. ๒๕๔๕
สภาพพร้อมออกทะเลที่ยอมรับแล้ว	seaworthiness admitted	๒ มี.ค. ๒๕๔๕
earned premium	เบี้ยประกันภัยที่ถือเป็นรายได้	๒ มี.ค. ๒๕๔๕
earned-incurred basis	หลักเปรียบเทียบค่าเสียหายที่เกิดขึ้นแล้วกับรายได้	๒ มี.ค. ๒๕๔๕
earthquake fire damage	ความเสียหายจากไฟเพราะแผ่นดินไหว	๒ มี.ค. ๒๕๔๕
earthquake insurance	การประกันภัยแผ่นดินไหว	๒ มี.ค. ๒๕๔๕
earthquake shock damage	ความเสียหายจากการสั่นสะเทือนเพราะแผ่นดินไหว	๒ มี.ค. ๒๕๔๕
earthquake zone	เขตแผ่นดินไหว	๒ มี.ค. ๒๕๔๕
หมู่ยานพาหนะ	fleet	๒ มี.ค. ๒๕๔๕
สมุดเก็บเบี้ยประกันภัย	collecting book	๒ มี.ค. ๒๕๔๕
หรือตามกรมธรรม์ฉบับต้น	or as original	๒ มี.ค. ๒๕๔๕
educational insurance	การประกันชีวิตเพื่อการศึกษา	๒ มี.ค. ๒๕๔๕
ส่วนเหลื่อมทรัพย์สินเหนือหนี้สิน	"margin of solvency; <a href=""/coinages/websearch.php?Wd=solvency+margin&amp;Sj=0"">solvency margin</a>"	๒ มี.ค. ๒๕๔๕
ส่วนร่วมชดใช้ความเสียหายร่วม	general average contribution	๒ มี.ค. ๒๕๔๕
ส่วนรับคืน	recovery	๒ มี.ค. ๒๕๔๕
ส่วนรับประกันภัย	line	๒ มี.ค. ๒๕๔๕
ส่วนรับประกันภัยรวม	gross line	๒ มี.ค. ๒๕๔๕
ส่วนรับประกันภัยเกินขีด	over-line	๒ มี.ค. ๒๕๔๕
ส่วนรับประกันภัยส่วนเกิน	surplus line	๒ มี.ค. ๒๕๔๕
ส่วนรับประกันภัยสุทธิ	"net line; <a href=""/coinages/websearch.php?Wd=net+retained+line&amp;Sj=0"">net retained line</a>"	๒ มี.ค. ๒๕๔๕
ส่วนเก็บไว้	"retained line; <a href=""/coinages/websearch.php?Wd=retention&amp;Sj=0"">retention</a>"	๒ มี.ค. ๒๕๔๕
ส่วนเก็บไว้เอง(การเสี่ยงภัย)	self-retention	๒ มี.ค. ๒๕๔๕
ส่วนเก็บไว้เอง(การเสี่ยงภัย)	self-retention	๒ มี.ค. ๒๕๔๕
ส่วนเพิ่มเนื่องจากอาชีพ	occupational extra	๒ มี.ค. ๒๕๔๕
ส่วนลด	discount	๒ มี.ค. ๒๕๔๕
ส่วนลดจูงใจ	loyalty discount	๒ มี.ค. ๒๕๔๕
ส่วนลดตามกรมธรรม์	original discount	๒ มี.ค. ๒๕๔๕
ส่วนลดตามกรมธรรม์ฉบับต้น	original deduction	๒ มี.ค. ๒๕๔๕
ส่วนลดประวัติดี	no -claim discount	๒ มี.ค. ๒๕๔๕
ส่วนได้เสียในสินค้าขนส่ง	cargo interest	๒ มี.ค. ๒๕๔๕
ส่วนได้เสียในตัวเรือ	hull interest	๒ มี.ค. ๒๕๔๕
ส่วนได้เสียอันสามารถเอาประกันภัยได้	insurable interest	๒ มี.ค. ๒๕๔๕
ส่วนได้เสียของผู้ขาย	seller’s interest	๒ มี.ค. ๒๕๔๕
ส่วนได้เสียของผู้ซื้อ	buyer’s interest	๒ มี.ค. ๒๕๔๕
ส่วนได้เสียต่ำ	short interest	๒ มี.ค. ๒๕๔๕
ส่วนได้จากตารางมรณวิสัย	"mortality gains; <a href=""/coinages/websearch.php?Wd=mortality+savings&amp;Sj=0"">mortality savings</a>"	๒ มี.ค. ๒๕๔๕
ส่วนที่เอาประกันภัยต่อ	cession	๒ มี.ค. ๒๕๔๕
ส่วนที่รับประกันภัย	written line	๒ มี.ค. ๒๕๔๕
ส่วนบวกเพิ่ม	loading	๒ มี.ค. ๒๕๔๕
ส่วนบวกเพิ่มระยะแรก	front- loading	๒ มี.ค. ๒๕๔๕
ส่วนบวกเพิ่มเงินปันผล	bonus loading	๒ มี.ค. ๒๕๔๕
ส่วนบวกเพิ่มเบี้ยประกันภัย	premium loading	๒ มี.ค. ๒๕๔๕
ส่วนบวกเพิ่มค่าสินไหมทดแทน	loss loading	๒ มี.ค. ๒๕๔๕
effective date	วันเริ่มผลบังคับ	๒ มี.ค. ๒๕๔๕
eighty-five per cent reinstatement average scheme	แผนร่วมเฉลี่ยการจัดทดแทนตามเกณฑ์ร้อยละ ๘๕	๒ มี.ค. ๒๕๔๕
electrical clause	ข้อกำหนดว่าด้วยไฟฟ้า	๒ มี.ค. ๒๕๔๕
elective benefits	ผลประโยชน์ที่เลือกได้	๒ มี.ค. ๒๕๔๕
emergency fund	กองทุนฉุกเฉิน	๒ มี.ค. ๒๕๔๕
employer’s liability insurance	การประกันภัยความรับผิดของนายจ้าง	๒ มี.ค. ๒๕๔๕
endorsement	การสลักหลัง, ใบสลักหลัง	๒ มี.ค. ๒๕๔๕
endowment	แบบสะสมทรัพย์	๒ มี.ค. ๒๕๔๕
engineering insurance	การประกันภัยทางวิศวกรรม	๒ มี.ค. ๒๕๔๕
engineering interruption insurance	การประกันภัยการหยุดชะงักทางวิศวกรรม	๒ มี.ค. ๒๕๔๕
สัญญาเสี่ยงโชค	aleatory contract	๒ มี.ค. ๒๕๔๕
สัญญาจ้าง	contract of service	๒ มี.ค. ๒๕๔๕
สัญญาจ้างเหมา	contract for services	๒ มี.ค. ๒๕๔๕
สัญญาชดใช้ค่าสินไหมทดแทน	contract of indemnity	๒ มี.ค. ๒๕๔๕
สัญญาสำเร็จรูป	adhesion contract	๒ มี.ค. ๒๕๔๕
สัญญาการพนันขันต่อ	wagering contract	๒ มี.ค. ๒๕๔๕
สัญญาคุ้มครองการเอาประกันภัยต่อ	reinsurance cover	๒ มี.ค. ๒๕๔๕
สัญญาตายตัว	contract of adhesion	๒ มี.ค. ๒๕๔๕
สัญญาประกันภัยต่อแบบเปิด	open treaty	๒ มี.ค. ๒๕๔๕
สัญญาประกันภัยต่อแบบส่วนเกิน	surplus treaty	๒ มี.ค. ๒๕๔๕
สัญญาประกันภัยต่อส่วนเกินชั้นที่สอง	second surplus treaty	๒ มี.ค. ๒๕๔๕
สัญญาประกันภัยต่อส่วนเกินชั้นที่หนึ่ง	first surplus treaty	๒ มี.ค. ๒๕๔๕
สัญญาประกันภัยต่ออัตราเลื่อน	sliding scale treaty	๒ มี.ค. ๒๕๔๕
สัญญาประกันภัยต่ออัตราคงที่	fixed rate treaty	๒ มี.ค. ๒๕๔๕
สัญญาประกันภัยต่ออัตโนมัติ	automatic reinsurance treaty	๒ มี.ค. ๒๕๔๕
สัญญาประกันภัยต่อคล้อยตาม	blind treaty	๒ มี.ค. ๒๕๔๕
สัญญาประกันภัยต่อคุ้มครองทั้งประเภท	whole account treaty	๒ มี.ค. ๒๕๔๕
สัญญาประกันภัยต่อตามพันธะ	fixed treaty	๒ มี.ค. ๒๕๔๕
สัญญาประกันภัยต่อผูกพันแบบเฉพาะราย	facultative obligatory treaty	๒ มี.ค. ๒๕๔๕
สัญญาประกันชีวิตแบบเงินรายเดือน	monthly income contract	๒ มี.ค. ๒๕๔๕
สัญญาผูกพันสองฝ่าย	bilateral contract	๒ มี.ค. ๒๕๔๕
สัญญาผูกพันฝ่ายเดียว	unilateral contract	๒ มี.ค. ๒๕๔๕
สัญญาประกันภัย	contract of insurance	๒ มี.ค. ๒๕๔๕
สัญญาประกันภัยเปิด	open cover	๒ มี.ค. ๒๕๔๕
สัญญาประกันภัยล่วงหน้า	forward contract	๒ มี.ค. ๒๕๔๕
สัญญาประกันภัยต่อ	"reinsurance treaty; <a href=""/coinages/websearch.php?Wd=treaty&amp;Sj=0"">treaty</a>"	๒ มี.ค. ๒๕๔๕
สัญญาประกันภัยต่อเฉพาะราย	facultative treaty	๒ มี.ค. ๒๕๔๕
สาเหตุใกล้ชิด	proximate cause	๒ มี.ค. ๒๕๔๕
สำเนาสลิป	"off slip; <a href=""/coinages/websearch.php?Wd=signer&amp;Sj=0"">signer</a>; <a href=""/coinages/websearch.php?Wd=signing+slip&amp;Sj=0"">signing slip</a>"	๒ มี.ค. ๒๕๔๕
สิ่งติดตรึง	fixtures and fitting	๒ มี.ค. ๒๕๔๕
สิ่งปลูกสร้างมาตรฐาน	standard construction	๒ มี.ค. ๒๕๔๕
สิ่งปลูกสร้างไม่ได้มาตรฐาน	non-standard construction	๒ มี.ค. ๒๕๔๕
สิ้นสุดการเสี่ยงภัย	off risk	๒ มี.ค. ๒๕๔๕
สิทธิเลือกเงินสด	cash option	๒ มี.ค. ๒๕๔๕
สิทธิเลือกวิธิรับเงินเอาประกัน	settlement option	๒ มี.ค. ๒๕๔๕
สิทธิเลือกวิธีชดใช้	settlement option	๒ มี.ค. ๒๕๔๕
สิทธิเลือกอันได้อาจริบได้	non-forfeiture options	๒ มี.ค. ๒๕๔๕
สิทธิเลือกต่อประกันชีวิต	continuation option	๒ มี.ค. ๒๕๔๕
สิทธิของผู้ถือกรรมสิทธิ์	incident of ownership	๒ มี.ค. ๒๕๔๕
สิทธิประโยชน์อนาคต	chose in action	๒ มี.ค. ๒๕๔๕
สิทธิพึงได้	vesting	๒ มี.ค. ๒๕๔๕
สำนักคำนวณอัตราเบี้ยประกันภัย	rating bureau	๒ มี.ค. ๒๕๔๕
สำนักงานออกกรมธรรม์	policy signing office	๒ มี.ค. ๒๕๔๕
สำนักงานจัดการค้าสินไหมทดแทน	Claims Bureau	๒ มี.ค. ๒๕๔๕
สินค้าขนถ่าย	outturn	๒ มี.ค. ๒๕๔๕
สินค้าคงคลัง	inventory	๒ มี.ค. ๒๕๔๕
สินทรัพย์ประเมินแล้ว	admitted assets	๒ มี.ค. ๒๕๔๕
equalisation fund	กองทุนดุลยภาพ	๒ มี.ค. ๒๕๔๕
erection all risks	การประกันสรรพภัยในการติดตั้ง	๒ มี.ค. ๒๕๔๕
errors and omissions insurance	การประกันภัยความผิดตกละเว้น	๒ มี.ค. ๒๕๔๕
escalation	การปรับค่าสูงขึ้น	๒ มี.ค. ๒๕๔๕
escalator clause	ข้อกำหนดการปรับค่า	๒ มี.ค. ๒๕๔๕
escape clause	ข้อกำหนดบอกเลิกสัญญา	๒ มี.ค. ๒๕๔๕
estimated maximum loss	"ความเสียหายสูงสุดโดยประมาณ <i>มีความหมายเหมือนกับ <a href=""/coinages/websearch.php?Wd=maximum+probable+loss&amp;Sj=0"">maximum probable loss</a> และ <a href=""/coinages/websearch.php?Wd=probable+maximum+loss&amp;Sj=0"">probable maximum loss</a></i>"	๒ มี.ค. ๒๕๔๕
estimated premium	เบี้ยประกันภัยโดยประมาณ	๒ มี.ค. ๒๕๔๕
ex gratia payment	การชดใช้ด้วยการุณย์	๒ มี.ค. ๒๕๔๕
evidence of health	ใบรับรองสุขภาพ	๒ มี.ค. ๒๕๔๕
exception	ข้อยกเว้น	๒ มี.ค. ๒๕๔๕
exceptional circumstances clause	ข้อกำหนดสภาวะพิเศษ	๒ มี.ค. ๒๕๔๕
excess	การรับผิดส่วนแรก	๒ มี.ค. ๒๕๔๕
excess insurance	การประกันภัยส่วนเกิน	๒ มี.ค. ๒๕๔๕
excess interest	ดอกเบี้ยส่วนเกิน	๒ มี.ค. ๒๕๔๕
excess of line reinsurance	การประกันภัยต่อแบบส่วนเกิน	๒ มี.ค. ๒๕๔๕
excess of loss policy	กรมธรรม์ความเสียหายส่วนเกิน	๒ มี.ค. ๒๕๔๕
excess of loss ratio reinsurance	การประกันภัยต่ออัตราค่าเสียหายส่วนเกิน	๒ มี.ค. ๒๕๔๕
excess of loss reinsurance	การประกันภัยต่อความเสียหายส่วนเกิน	๒ มี.ค. ๒๕๔๕
excess value policy	กรมธรรม์มูลค่าส่วนเกิน	๒ มี.ค. ๒๕๔๕
exclusion	ข้อจำกัดความคุ้มครอง	๒ มี.ค. ๒๕๔๕
executor	ผู้จัดการมรดก(มีพินัยกรรม)	๒ มี.ค. ๒๕๔๕
expected mortality	จำนวนมรณะที่คาดหมาย	๒ มี.ค. ๒๕๔๕
expense loading	ค่าใช้จ่ายบวกเพิ่ม	๒ มี.ค. ๒๕๔๕
expense ratio	อัตราส่วนค่าใช้จ่าย	๒ มี.ค. ๒๕๔๕
experience rating	การกำหนดอัตราตามประสบการณ์	๒ มี.ค. ๒๕๔๕
experience refund	เงินคืนตามประสบการณ์	๒ มี.ค. ๒๕๔๕
explosion	ภัยการระเบิด	๒ มี.ค. ๒๕๔๕
export credit insurance	การประกันภัยสินเชื่อผู้ส่งออก	๒ มี.ค. ๒๕๔๕
exposure	โอกาสเสี่ยงภัย	๒ มี.ค. ๒๕๔๕
express warranty	คำรับรองเป็นลายลักษณ์อักษร	๒ มี.ค. ๒๕๔๕
extended protest	ใบแจ้งยืนยันโดยละเอียด	๒ มี.ค. ๒๕๔๕
extended terms insurance	การประกันภัยขยายเวลา	๒ มี.ค. ๒๕๔๕
extension	การขยายความคุ้มครอง	๒ มี.ค. ๒๕๔๕
extra dividend	เงินปันผลพิเศษ	๒ มี.ค. ๒๕๔๕
extra premium	เบี้ยประกันภัยเพิ่มพิเศษ	๒ มี.ค. ๒๕๔๕
extraneous perils	ภัยเพิ่มพิเศษ	๒ มี.ค. ๒๕๔๕
หลักรับจ่าย	written-paid basis	๒ มี.ค. ๒๕๔๕
หลักเงินสำรอง	reserve basis	๒ มี.ค. ๒๕๔๕
หลักเปรียบเทียบค่าเสียหายทีเกิดขึ้นแล้วกับรายได้	earned-incurred basis	๒ มี.ค. ๒๕๔๕
หลักสัญญาประกันภัยต่อร้อยเปอร์เซ็นต์	hundred per cent treaty basis	๒ มี.ค. ๒๕๔๕
หลักยกยอดขาดทุน	“losses to extinction” basis	๒ มี.ค. ๒๕๔๕
หลักการคำนวณค่าสินไหมทดแทน	measure of indemnity	๒ มี.ค. ๒๕๔๕
หลักการตัดภาระผูกพัน	clean cut basis	๒ มี.ค. ๒๕๔๕
หลักกำหนดระยะเวลาความเสียหาย	“losses occuring” basis	๒ มี.ค. ๒๕๔๕
หลักควบคุมความเสียหาย	merger	๒ มี.ค. ๒๕๔๕
หลักค่าจ้างทวิภาค	dual (wages) basis	๒ มี.ค. ๒๕๔๕
หลักถือกรมธรรม์มีผล	policies incepting basis	๒ มี.ค. ๒๕๔๕
หลักประกันสังคม	social security	๒ มี.ค. ๒๕๔๕
สลิป	slip	๒ มี.ค. ๒๕๔๕
สลิปแจ้งผลสรุป	closing slip	๒ มี.ค. ๒๕๔๕
สลิปเปิด	open slip	๒ มี.ค. ๒๕๔๕
สลิปต้นฉบับ	original slip	๒ มี.ค. ๒๕๔๕
สถาบันผู้รับประกันภัยแห่งลอนดอน (ไอแอลยู)	"Institute of London Underwriter (<a href=""/coinages/websearch.php?Wd=I.L.U.&amp;Sj=0"">I.L.U.</a>)"	๒ มี.ค. ๒๕๔๕
สถาบันลอยด์แห่งลอนดอน	Lloyd’s (of London)	๒ มี.ค. ๒๕๔๕
หน่วยภัยเอกเทศ	independent risk unit	๒ มี.ค. ๒๕๔๕
หน่วยงานควบคุมดูแล	supervisory authority	๒ มี.ค. ๒๕๔๕
หน่วยจัดการซากทรัพย์	salvage corps	๒ มี.ค. ๒๕๔๕
หน้าที่เปิดเผยความจริง	duty of disclosure	๒ มี.ค. ๒๕๔๕
หนังสือมอบอำนาจผู้รับประกันภัย	binder	๒ มี.ค. ๒๕๔๕
หนังสือรับรองการชำระเงิน	assumption certificate	๒ มี.ค. ๒๕๔๕
หนังสือก่อตั้งทรัสต์	trust deed	๒ มี.ค. ๒๕๔๕
หนังสือค้ำประกันการชดใช้ค่าเสียหาย	letter of indemnity	๒ มี.ค. ๒๕๔๕
หนังสือค้ำประกันของธนาคาร	bank guarantee	๒ มี.ค. ๒๕๔๕
หนังสือค้าประกันความเสียหายร่วม	"general average bond; <a href=""/coinages/websearch.php?Wd=general+average+guarantee&amp;Sj=0"">general average guarantee</a>"	๒ มี.ค. ๒๕๔๕
หนังสือคุ้มครองชั่วคราว	binder	๒ มี.ค. ๒๕๔๕
หนี้มีเงื่อนไข	contingent debt	๒ มี.ค. ๒๕๔๕
face amount	จำนวนเงินเอาประกันภัย	๒ มี.ค. ๒๕๔๕
facility of payment	ความสะดวกในการจ่ายเงิน	๒ มี.ค. ๒๕๔๕
facultative obligatory treaty	สัญญาประกันภัยต่อผูกพันแบบเฉพาะราย	๒ มี.ค. ๒๕๔๕
facultative reinsurance	การประกันภัยต่อเฉพาะราย	๒ มี.ค. ๒๕๔๕
facultative treaty	สัญญาประกันภัยต่อเฉพาะราย	๒ มี.ค. ๒๕๔๕
failure of consideration	ค่าต่างตอบแทนล้มเหลว	๒ มี.ค. ๒๕๔๕
family income contract	กรมธรรม์เพื่อรายได้ครอบครัว	๒ มี.ค. ๒๕๔๕
family maintenance contract	กรมธรรม์เพื่อค้ำจุนครอบครัว	๒ มี.ค. ๒๕๔๕
family plan policy	กรมธรรม์แบบคุ้มครองทั้งครอบครัว	๒ มี.ค. ๒๕๔๕
fiduciary	ผู้ดูแลผลประโยชน์	๒ มี.ค. ๒๕๔๕
fidelity guarantee	การประกันภัยความซื่อสัตย์	๒ มี.ค. ๒๕๔๕
fidelity insurance	"การประกันภัยความซื่อสัตย์ <i>มีความหมายเหมือนกับ <a href=""/coinages/websearch.php?Wd=fidelity+guarantee&amp;Sj=0"">fidelity guarantee</a></i>"	๒ มี.ค. ๒๕๔๕
final expenses fund	"ทุนสำรองสุดท้าย <i>มีความหมายเหมือนกับ <a href=""/coinages/websearch.php?Wd=clean-up+fund&amp;Sj=0"">clean-up fund</a></i>"	๒ มี.ค. ๒๕๔๕
fire	ไฟ	๒ มี.ค. ๒๕๔๕
fire insurance	การประกันอัคคีภัย	๒ มี.ค. ๒๕๔๕
fire interruption insurance	การประกันภัยธุรกิจหยุดชะงักเนื่องจากอัคคีภัย	๒ มี.ค. ๒๕๔๕
fire loss	ความเสียหายจากอัคคีภัย	๒ มี.ค. ๒๕๔๕
fire prevention	การป้องกันอัคคีภัย	๒ มี.ค. ๒๕๔๕
fire protection	การคุ้มกันให้พ้นอัคคีภัย	๒ มี.ค. ๒๕๔๕
fire resistance	ความต้านทานอัคคีภัย	๒ มี.ค. ๒๕๔๕
fire stop	วัสดุกั้นอัคคีภัย	๒ มี.ค. ๒๕๔๕
fire surveyor	ผู้สำรวจความเสี่ยงอัคคีภัย	๒ มี.ค. ๒๕๔๕
fire wall	กำแพงกั้นไฟ	๒ มี.ค. ๒๕๔๕
first party insurance	การประกันภัยผู้เอาประกันภัย	๒ มี.ค. ๒๕๔๕
first surplus treaty	สัญญาประกันภัยต่อส่วนเกินชั้นที่หนึ่ง	๒ มี.ค. ๒๕๔๕
first loss	การรับผิดส่วนแรก	๒ มี.ค. ๒๕๔๕
first loss insurance	การประกันภัยความเสียหายส่วนแรก	๒ มี.ค. ๒๕๔๕
fixed premium	เบี้ยประกันภัยคงที่	๒ มี.ค. ๒๕๔๕
fixed rate treaty	สัญญาประกันภัยต่ออัตราคงที่	๒ มี.ค. ๒๕๔๕
fixed objects	วัตถุติดที่	๒ มี.ค. ๒๕๔๕
fixed sum excess	การรับผิดส่วนแรกจำนวนคงที่	๒ มี.ค. ๒๕๔๕
fixed term assurance	การประกันชีวิตแบบกำหนดเวลา	๒ มี.ค. ๒๕๔๕
fixed treaty	สัญญาประกันภัยต่อตามพันธะ	๒ มี.ค. ๒๕๔๕
fixtures and fittings	สิ่งติดตรึง	๒ มี.ค. ๒๕๔๕
flat line reinsurance	การประกันภัยต่อคงที่	๒ มี.ค. ๒๕๔๕
fleet	หมู่ยานพาหนะ	๒ มี.ค. ๒๕๔๕
fleet policy	กรมธรรม์หมู่ยานพาหนะ	๒ มี.ค. ๒๕๔๕
fleet rating	การกำหนดอัตราหมู่ยานพาหนะ	๒ มี.ค. ๒๕๔๕
flight risks	การเสี่ยงภัยระหว่างบิน	๒ มี.ค. ๒๕๔๕
floater	"กรมธรรม์ลอยตัว <i>มีความหมายเหมือนกับ <a href=""/coinages/websearch.php?Wd=floating+policy&amp;Sj=0"">floating policy</a></i>"	๒ มี.ค. ๒๕๔๕
floating policy	กรมธรรม์ลอยตัว	๒ มี.ค. ๒๕๔๕
flood insurance	การประกันภัยน้ำท่วม	๒ มี.ค. ๒๕๔๕
follow the fortunes	การปฏิบัติตาม	๒ มี.ค. ๒๕๔๕
follow the lead	การคล้อยตามผู้รับประกันภัยนำ	๒ มี.ค. ๒๕๔๕
force majeure	เหตุสุดวิสัย	๒ มี.ค. ๒๕๔๕
forcible and violent means	วิธีใช้กำลังและความรุนแรง	๒ มี.ค. ๒๕๔๕
foreign jurisdiction clause	ข้อกำหนดอำนาจศาลต่างประเทศ	๒ มี.ค. ๒๕๔๕
foreign company	"บริษัทต่างรัฐ <i>ดู <a href=""/coinages/websearch.php?Wd=domestic+company&amp;Sj=0"">domestic company</a></i>"	๒ มี.ค. ๒๕๔๕
forfeiture	การเสียสิทธิ์	๒ มี.ค. ๒๕๔๕
forward contract	สัญญาประกันภัยล่วงหน้า	๒ มี.ค. ๒๕๔๕
forward exchange rate cover	ความคุ้มครองอัตราแลกเปลี่ยนล่วงหน้า	๒ มี.ค. ๒๕๔๕
forwarding charges	ค่าขนส่งต่อ	๒ มี.ค. ๒๕๔๕
foundation clause	ข้อกำหนดฐานราก	๒ มี.ค. ๒๕๔๕
fractional premium	เบี้ยประกันภัยรายงวด	๒ มี.ค. ๒๕๔๕
fraudulent misrepresentation	การแถลงข้อความเป็นเท็จเพื่อฉ้อฉล	๒ มี.ค. ๒๕๔๕
franchise	ขีดปลอดความรับผิด	๒ มี.ค. ๒๕๔๕
free of capture and seizure clause	ข้อกำหนดยกเว้นการจับกุมยึดหน่วง	๒ มี.ค. ๒๕๔๕
free of particular average	ปลอดความเสียหายเฉพาะ	๒ มี.ค. ๒๕๔๕
free reserves	เงินสำรองอิสระ	๒ มี.ค. ๒๕๔๕
freight insurance	การประกันภัยค่าระวาง	๒ มี.ค. ๒๕๔๕
front-end loading	ส่วนบวกเพิ่มระยะแรก	๒ มี.ค. ๒๕๔๕
fronting company	บริษัทรับหน้า	๒ มี.ค. ๒๕๔๕
frost	น้ำค้างแข็ง	๒ มี.ค. ๒๕๔๕
frustration clause	ข้อกำหนดการถูกปิดกั้น	๒ มี.ค. ๒๕๔๕
full paid additions	"<i>มีความหมายเหมือนกับ <a href=""/coinages/websearch.php?Wd=dividend+additions&amp;Sj=0"">dividend additions</a></i>"	๒ มี.ค. ๒๕๔๕
full reinsurance clause	ข้อกำหนดการประกันภัยต่อเต็มที่	๒ มี.ค. ๒๕๔๕
full value insurance	การประกันภัยเต็มมูลค่า	๒ มี.ค. ๒๕๔๕
funded pension plan	แผนเตรียมเงินบำนาญ	๒ มี.ค. ๒๕๔๕
general average	ความเสียหายร่วม	๒ มี.ค. ๒๕๔๕
general hazard	ภาวะภัยทั่วไป	๒ มี.ค. ๒๕๔๕
general average adjustment	รายงานการเจรจาตกลงความเสียหายร่วม	๒ มี.ค. ๒๕๔๕
general average agreement	ข้อตกลงความเสียหายร่วม	๒ มี.ค. ๒๕๔๕
general average bond	"๑. กรมธรรม์ค้ำประกันความเสียหายร่วม <i>ดู <a href=""/coinages/websearch.php?Wd=general+average+agreement&amp;Sj=0"">general average agreement</a> </i><br/>๒. หนังสือค้ำประกันความเสียหายร่วม <i>มีความหมายเหมือนกับ <a href=""/coinages/websearch.php?Wd=general+average+guarantee&amp;Sj=0"">general average guarantee</a></i>"	๒ มี.ค. ๒๕๔๕
general average contribution	ส่วนร่วมชดใช้ความเสียหายร่วม	๒ มี.ค. ๒๕๔๕
general average deposit	"เงินมัดจำความเสียหายร่วม <i>ดู <a href=""/coinages/websearch.php?Wd=general+average+agreement&amp;Sj=0"">general average agreement</a></i>"	๒ มี.ค. ๒๕๔๕
general average expenditure	ค่าใช้จ่ายความเสียหายร่วม	๒ มี.ค. ๒๕๔๕
general average fund	กองทุนความเสียหายร่วม	๒ มี.ค. ๒๕๔๕
general average guarantee	หนังสือค้ำประกันความเสียหายร่วม	๒ มี.ค. ๒๕๔๕
general average sacrifice	การเสียสละในความเสียหายร่วม	๒ มี.ค. ๒๕๔๕
glass insurance	การประกันภัยกระจก	๒ มี.ค. ๒๕๔๕
global policy	"กรมธรรม์คุ้มครองรวม <i>มีความหมายเหมือนกับ <a href=""/coinages/websearch.php?Wd=blanket+policy&amp;Sj=0"">blanket policy</a></i>"	๒ มี.ค. ๒๕๔๕
golfer’s insurance	การประกันภัยนักกอล์ฟ	๒ มี.ค. ๒๕๔๕
Gold Clause Agreement	ข้อตกลงเงื่อนไขทอง	๒ มี.ค. ๒๕๔๕
good faith	"ความสุจริตใจ <i>ดู <a href=""/coinages/websearch.php?Wd=utmost+good+faith&amp;Sj=0"">utmost good faith</a></i>"	๒ มี.ค. ๒๕๔๕
goods-in-transit insurance	การประกันภัยสินค้าระหว่างขนส่ง	๒ มี.ค. ๒๕๔๕
grace period	ระยะผ่อนผัน	๒ มี.ค. ๒๕๔๕
green card	บัตรเขียว	๒ มี.ค. ๒๕๔๕
gross arrived damaged value	มูลค่ารวม ณ ปลายทางหลังเสียหาย	๒ มี.ค. ๒๕๔๕
gross earned premiums	เบี้ยประกันภัยที่ถือเป็นรายได้รวม	๒ มี.ค. ๒๕๔๕
gross line	ส่วนรับประกันภัยรวม	๒ มี.ค. ๒๕๔๕
gross premium	"<i>ดู <a href=""/coinages/websearch.php?Wd=gross+rates&amp;Sj=0"">gross rates</a></i>"	๒ มี.ค. ๒๕๔๕
gross rates	อัตราเบี้ยประกันภัยรวม	๒ มี.ค. ๒๕๔๕
gross surplus	เงินส่วนเกินรวม	๒ มี.ค. ๒๕๔๕
gross system	บัญชีระบบรวม	๒ มี.ค. ๒๕๔๕
gross value	มูลค่ารวม	๒ มี.ค. ๒๕๔๕
gross written premiums	เบี้ยประกันภัยรับรวม	๒ มี.ค. ๒๕๔๕
ground risks	การเสี่ยงภัยระหว่างจอด	๒ มี.ค. ๒๕๔๕
grounding risk	การเสี่ยงภัยจอดตรวจสอบ	๒ มี.ค. ๒๕๔๕
group annuity	กรมธรรม์กลุ่มแบบเงินรายปี	๒ มี.ค. ๒๕๔๕
group insurance	การประกันภัยกลุ่ม	๒ มี.ค. ๒๕๔๕
group life insurance	การประกันชีวิตประเภทกลุ่ม	๒ มี.ค. ๒๕๔๕
group underwriting	การรวมกลุ่มรับประกันภัย	๒ มี.ค. ๒๕๔๕
guaranteed annuity	เงินรายปีรับรอง	๒ มี.ค. ๒๕๔๕
guaranteed bonus	เงินปันผลรับรอง	๒ มี.ค. ๒๕๔๕
guaranteed dividend	"เงินปันผลรับรอง <i>มีความหมายเหมือนกับ <a href=""/coinages/websearch.php?Wd=guaranteed+bonus&amp;Sj=0"">guaranteed bonus</a></i>"	๒ มี.ค. ๒๕๔๕
guaranteed dividend policies	กรมธรรม์รับรองเงินปันผล	๒ มี.ค. ๒๕๔๕
guaranteed insurability	การรับรองรับประกันภัยเพิ่ม	๒ มี.ค. ๒๕๔๕
guarantee deposit	เงินวางประกัน	๒ มี.ค. ๒๕๔๕
guarantee fund	กองทุนค้ำประกัน	๒ มี.ค. ๒๕๔๕
Hague-Visby Rules	กฎเฮก-วิสบี	๒ มี.ค. ๒๕๔๕
hailstorm insurance	การประกันภัยพายุลูกเห็บ	๒ มี.ค. ๒๕๔๕
halving agreement	ข้อตกลงแบ่งครึ่ง	๒ มี.ค. ๒๕๔๕
Hamburg Rules	กฎฮัมบูร์ก	๒ มี.ค. ๒๕๔๕
hangarkeeper’s liability insurance	การประกันภัยความรับผิดของผู้รับเก็บรักษาเครื่องบิน	๒ มี.ค. ๒๕๔๕
hazard	ภาวะภัย	๒ มี.ค. ๒๕๔๕
health insurance	การประกันสุขภาพ	๒ มี.ค. ๒๕๔๕
held covered	ถือว่าคุ้มครองแล้ว	๒ มี.ค. ๒๕๔๕
hidden reserve	เงินสำรองแฝง	๒ มี.ค. ๒๕๔๕
hold-harmless agreement	ข้อตกลงรับชดใช้	๒ มี.ค. ๒๕๔๕
hold-up cover	ความคุ้มครองการจี้ปล้น	๒ มี.ค. ๒๕๔๕
home service insurance	"การประกันภัยบริการถึงบ้าน <i>มีความหมายเหมือนกับ <a href=""/coinages/websearch.php?Wd=industrial+insurance&amp;Sj=0"">industrial insurance</a></i>"	๒ มี.ค. ๒๕๔๕
honour policy	กรมธรรม์ด้วยเกียรติ	๒ มี.ค. ๒๕๔๕
hospital and medical expenses insurance	การประกันภัยค่ารักษาพยาบาล	๒ มี.ค. ๒๕๔๕
hospital cash insurance	การประกันภัยค่ารักษาพยาบาลแบบเงินสด	๒ มี.ค. ๒๕๔๕
house purchase assurance	การประกันชีวิตเพื่อซื้อบ้าน	๒ มี.ค. ๒๕๔๕
hours clause	ข้อกำหนดจำนวนชั่วโมง	๒ มี.ค. ๒๕๔๕
householders’ insurance	การประกันภัยสำหรับผู้อยู่อาศัย	๒ มี.ค. ๒๕๔๕
houseowners’ insurance	การประกันภัยสำหรับเจ้าของบ้าน	๒ มี.ค. ๒๕๔๕
hull insurance	การประกันภัยตัวเรือ	๒ มี.ค. ๒๕๔๕
hull interest	ส่วนได้เสียในตัวเรือ	๒ มี.ค. ๒๕๔๕
Hull Paramount Clauses	ข้อกำหนดสุดยอดสำหรับตัวเรือ	๒ มี.ค. ๒๕๔๕
hull returns	เบี้ยประกันภัยตัวเรือจ่ายคืน	๒ มี.ค. ๒๕๔๕
hull syndicate	คณะผู้ร่วมประกันภัยตัวเรือ	๒ มี.ค. ๒๕๔๕
hundred per cent treaty basis	หลักสัญญาประกันภัยต่อร้อยเปอร์เซ็นต์	๒ มี.ค. ๒๕๔๕
hybrid policy	กรมธรรม์ภัยผสม	๒ มี.ค. ๒๕๔๕
I.B.N.R.	"เกิดแล้วยังไม่รายงาน (<a href=""/coinages/websearch.php?Wd=%E4%CD%BA%D5%E0%CD%E7%B9%CD%D2%C3%EC&amp;Sj=0"">ไอบีเอ็นอาร์</a>)"	๒ มี.ค. ๒๕๔๕
I.L.U. (Institute of London Underwriters)	"สถาบันผู้รับประกันภัยแห่งลอนดอน (<a href=""/coinages/websearch.php?Wd=%E4%CD%E1%CD%C5%C2%D9&amp;Sj=0"">ไอแอลยู</a>)"	๒ มี.ค. ๒๕๔๕
i.o.p. (irrespective of percentage)	ปราศจากขีดปลอดความรับผิด	๒ มี.ค. ๒๕๔๕
อยู่ระหว่างการขนส่ง	in transitu	๒ มี.ค. ๒๕๔๕
ice deviation clause	ข้อกำหนดการเบี่ยงเส้นทางเนื่องจากน้ำแข็ง	๒ มี.ค. ๒๕๔๕
ice deviation risk	ภัยการเบี่ยงเส้นทางเนื่องจากน้ำแข็ง	๒ มี.ค. ๒๕๔๕
ice exclusion clause	ข้อกำหนดยกเว้นเนื่องจากน้ำแข็ง	๒ มี.ค. ๒๕๔๕
immediate annuity	เงินรายปีจ่ายทันที	๒ มี.ค. ๒๕๔๕
impact damage	ความเสียหายจากการถูกกระแทก	๒ มี.ค. ๒๕๔๕
impaired risk	"การเสี่ยงภัยสูงกว่าปรกติ <i>มีความหมายเหมือนกับ <a href=""/coinages/websearch.php?Wd=substandard+risk&amp;Sj=0"">substandard risk</a></i>"	๒ มี.ค. ๒๕๔๕
implied condition	เงื่อนไขโดยนัย	๒ มี.ค. ๒๕๔๕
implied warranty	คำรับรองโดยนัย	๒ มี.ค. ๒๕๔๕
importation of average	การต้องเฉลี่ยค่าเสียหาย	๒ มี.ค. ๒๕๔๕
in force	มีผลบังคับ	๒ มี.ค. ๒๕๔๕
in transitu	อยู่ระหว่างการขนส่ง	๒ มี.ค. ๒๕๔๕
inception date	วันเริ่มคุ้มครอง	๒ มี.ค. ๒๕๔๕
Inchmaree Clause	ข้อกำหนดอินช์มารี	๒ มี.ค. ๒๕๔๕
incident of ownership	สิทธิของผู้ถือกรรมสิทธิ์	๒ มี.ค. ๒๕๔๕
incidental non-marine	ภัยพ่วงภัยทางทะเล	๒ มี.ค. ๒๕๔๕
income bond	"กรมธรรม์ค้ำประกันเงินได้ <i>ดู <a href=""/coinages/websearch.php?Wd=retirement+annuity&amp;Sj=0"">retirement annuity</a></i>"	๒ มี.ค. ๒๕๔๕
income policy	กรมธรรม์จ่ายเงินได้ประจำ	๒ มี.ค. ๒๕๔๕
incontestable clause	ข้อกำหนดไม่โต้แย้ง	๒ มี.ค. ๒๕๔๕
increase in cost of working	การเพิ่มค่าใช้จ่าย	๒ มี.ค. ๒๕๔๕
increased value and excess liabilities policy	"กรมธรรม์มูลค่าส่วนเกิน <i>มีความหมายเหมือนกับ <a href=""/coinages/websearch.php?Wd=excess+value+policy&amp;Sj=0"">excess value policy</a></i>"	๒ มี.ค. ๒๕๔๕
incurred but not reported	"เกิดแล้วยังไม่รายงาน (<a href=""/coinages/websearch.php?Wd=%E4%CD%BA%D5%E0%CD%E7%B9%CD%D2%C3%EC&amp;Sj=0"">ไอบีเอ็นอาร์</a>)"	๒ มี.ค. ๒๕๔๕
incurred loss ratio	อัตราส่วนความเสียหายที่เกิดขึ้นแล้ว	๒ มี.ค. ๒๕๔๕
incurred losses	ความเสียหายที่เกิดขึ้นแล้ว	๒ มี.ค. ๒๕๔๕
indemnification aliunde	การรับชดใช้จากแหล่งอื่น	๒ มี.ค. ๒๕๔๕
indemnity	การชดใช้ค่าสินไหมทดแทน	๒ มี.ค. ๒๕๔๕
indemnity period	ระยะชดใช้ค่าสินไหมทดแทน	๒ มี.ค. ๒๕๔๕
independent company	"บริษัทเอกเทศ <i>มีความหมายเหมือนกับ <a href=""/coinages/websearch.php?Wd=non-tariff+company&amp;Sj=0"">non-tariff company</a></i>"	๒ มี.ค. ๒๕๔๕
independent liability method	วิธีคำนวณความรับผิดโดยเอกเทศ	๒ มี.ค. ๒๕๔๕
independent range	พิสัยความรับผิดโดยเอกเทศ	๒ มี.ค. ๒๕๔๕
independent risk unit	หน่วยภัยเอกเทศ	๒ มี.ค. ๒๕๔๕
index annuity	เงินรายปีตามดัชนี	๒ มี.ค. ๒๕๔๕
index clause	ข้อกำหนดดัชนี	๒ มี.ค. ๒๕๔๕
indirect business	ธุรกิจผ่านคนกลาง	๒ มี.ค. ๒๕๔๕
industrial fire insurance	การประกันอัคคีภัยอุตสาหกรรม	๒ มี.ค. ๒๕๔๕
industrial injuries insurance	การประกันภัยการบาดเจ็บจากอุตสาหกรรม	๒ มี.ค. ๒๕๔๕
industrial insurance	การประกันชีวิตประเภทอุตสาหะ	๒ มี.ค. ๒๕๔๕
industrial property rights insurance	การประกันภัยสิทธิในอุตสาหกรรม	๒ มี.ค. ๒๕๔๕
indivisibility of premiums	การไม่แบ่งคืนเบี้ยประกันภัย	๒ มี.ค. ๒๕๔๕
inflation factor	ตัวปรับตามเงินเฟ้อ	๒ มี.ค. ๒๕๔๕
ingestion damage	ความเสียหายจากการดูดสิ่งแปลกปลอม	๒ มี.ค. ๒๕๔๕
inherent vice	การเสื่อมสภาพในตัวเอง	๒ มี.ค. ๒๕๔๕
initial period	ระยะเริ่มแรก	๒ มี.ค. ๒๕๔๕
initial premium	เบี้ยประกันภัยเริ่มแรก	๒ มี.ค. ๒๕๔๕
inland marine insurance	การประกันภัยการขนส่งสินค้าภายในประเทศ	๒ มี.ค. ๒๕๔๕
innkeeper’s liability	ความรับผิดของเจ้าของโรงแรม	๒ มี.ค. ๒๕๔๕
insolvency clause	ข้อกำหนดภาวะหนี้สินล้นพ้นตัว	๒ มี.ค. ๒๕๔๕
inspection clause	ข้อกำหนดการตรวจสอบ	๒ มี.ค. ๒๕๔๕
instalment premium	เบี้ยประกันภัยผ่อนชำระ	๒ มี.ค. ๒๕๔๕
instant certificates	ใบรับรองชั่วคราว	๒ มี.ค. ๒๕๔๕
Institute Agent	ตัวแทนสถาบัน	๒ มี.ค. ๒๕๔๕
Institute Clauses	ข้อกำหนดสถาบัน	๒ มี.ค. ๒๕๔๕
Institute of London Underwriters (I.L.U.)	"สถาบันผู้รับประกันภัยแห่งลอนดอน (<a href=""/coinages/websearch.php?Wd=%E4%CD%E1%CD%C5%C2%D9&amp;Sj=0"">ไอแอลยู</a>)"	๒ มี.ค. ๒๕๔๕
Institute Warranties	คำรับรองสถาบัน	๒ มี.ค. ๒๕๔๕
insurability	การที่สามารถเอาประกันภัยได้	๒ มี.ค. ๒๕๔๕
insurable interest	ส่วนได้เสียอันสามารถเอาประกันภัยได้	๒ มี.ค. ๒๕๔๕
insurance	การประกันภัย	๒ มี.ค. ๒๕๔๕
insurance agent	ตัวแทนประกันภัย	๒ มี.ค. ๒๕๔๕
insurance broker	นายหน้าประกันภัย	๒ มี.ค. ๒๕๔๕
insurance certificate	ใบรับรองการประกันภัย	๒ มี.ค. ๒๕๔๕
insure	๑. รับประกันภัย<br/>๒. เอาประกันภัย	๒ มี.ค. ๒๕๔๕
insured	ผู้เอาประกันภัย	๒ มี.ค. ๒๕๔๕
insurer	ผู้รับประกันภัย	๒ มี.ค. ๒๕๔๕
inter-vivos trust	ทรัสต์มีผลระหว่างชีวิต	๒ มี.ค. ๒๕๔๕
interest clause	ข้อกำหนดดอกเบี้ย	๒ มี.ค. ๒๕๔๕
interest or no interest	การมีหรือไม่มีส่วนได้เสีย	๒ มี.ค. ๒๕๔๕
interest profit	กำไรจากดอกเบี้ย	๒ มี.ค. ๒๕๔๕
intermediaries clause	ข้อกำหนดคนกลาง	๒ มี.ค. ๒๕๔๕
intermediary	คนกลาง	๒ มี.ค. ๒๕๔๕
interim bonus	เงินปันผลระหว่างกาล	๒ มี.ค. ๒๕๔๕
intermediate policy	กรมธรรม์แบบประสม	๒ มี.ค. ๒๕๔๕
interruption hazard	ภาวะภัยแทรกซ้อน	๒ มี.ค. ๒๕๔๕
intestate	ผู้ตายไม่มีพินัยกรรม	๒ มี.ค. ๒๕๔๕
invalidity	ความไม่สมประกอบ	๒ มี.ค. ๒๕๔๕
inventory	สินค้าคงคลัง	๒ มี.ค. ๒๕๔๕
inwards reinsurance	ธุรกิจรับประกันภัยต่อ	๒ มี.ค. ๒๕๔๕
investment insurance	การประกันภัยการลงทุน	๒ มี.ค. ๒๕๔๕
อัตรา	rate	๒ มี.ค. ๒๕๔๕
อัตราระยะสั้น	"short period rate; <a href=""/coinages/websearch.php?Wd=short+rate&amp;Sj=0"">short rate</a>; <a href=""/coinages/websearch.php?Wd=short+term+rate&amp;Sj=0"">short term rate</a>"	๒ มี.ค. ๒๕๔๕
อัตราเฉลี่ย	average rate	๒ มี.ค. ๒๕๔๕
อัตราเบี้ยประกันภัย	premium rate	๒ มี.ค. ๒๕๔๕
อัตราเบี้ยประกันภัยรวม	gross rate	๒ มี.ค. ๒๕๔๕
อัตราเบี้ยประกันภัยเดิม	original rate	๒ มี.ค. ๒๕๔๕
อัตราเบี้ยประกันภัยแบบรวม	blanket rate	๒ มี.ค. ๒๕๔๕
อัตราเบี้ยประกันภัยสิ่งปลูกสร้าง	building rate	๒ มี.ค. ๒๕๔๕
อัตราเบี้ยประกันภัยขั้นต่ำ	minimum rate	๒ มี.ค. ๒๕๔๕
อัตราเบี้ยประกันภัยทรัพย์สินในอาคาร	contents rate	๒ มี.ค. ๒๕๔๕
อัตราส่วนความเสียหายที่เกิดขึ้นแล้ว	incurred loss ratio	๒ มี.ค. ๒๕๔๕
อัตราส่วนค่าเสียหายพื้นฐาน	burning ratio	๒ มี.ค. ๒๕๔๕
อัตราส่วนค่าใช้จ่าย	expense ratio	๒ มี.ค. ๒๕๔๕
อัตราส่วนค่าสินไหมทดแทน	loss ratio	๒ มี.ค. ๒๕๔๕
อัตราตามพิกัดอัตรา	tariff rate	๒ มี.ค. ๒๕๔๕
อัตราพื้นฐาน	basis rate	๒ มี.ค. ๒๕๔๕
อายุ	age	๒ มี.ค. ๒๕๔๕
อายุสิ้นเกณฑ์	ceasing age	๒ มี.ค. ๒๕๔๕
อายุที่ยอมรับ	age admitted	๒ มี.ค. ๒๕๔๕
อายุบวกเพิ่ม	addition to age	๒ มี.ค. ๒๕๔๕
อายุปัจจุบัน	attained age	๒ มี.ค. ๒๕๔๕
อำนาจรับประกันภัยแทน	binding authority	๒ มี.ค. ๒๕๔๕
irregular premium	เบี้ยประกันภัยไม่สม่ำเสมอ	๒ มี.ค. ๒๕๔๕
irrespective of percentage (i.o.p.)	ปราศจากขีดปลอดความรับผิด	๒ มี.ค. ๒๕๔๕
irrevocable beneficiary	ผู้รับประโยชน์เปลี่ยนไม่ได้	๒ มี.ค. ๒๕๔๕
irrevocable trust	ทรัสต์ที่เปลี่ยนแปลงไม่ได้	๒ มี.ค. ๒๕๔๕
isolated risk	ภัยโดดเดี่ยว	๒ มี.ค. ๒๕๔๕
อุบัติเหตุ	accident	๒ มี.ค. ๒๕๔๕
อุบัติเหตุเนื่องจากอาชีพ	occupational accident	๒ มี.ค. ๒๕๔๕
Janson clause	ข้อกำหนดแจนสัน	๒ มี.ค. ๒๕๔๕
jettison	การโยนทิ้งทะเล	๒ มี.ค. ๒๕๔๕
jeweller’s block policy	กรมธรรม์เบ็ดเสร็จคุ้มครองผู้ค้าอัญมณี	๒ มี.ค. ๒๕๔๕
joint hull survey	การสำรวจตัวเรือร่วมกัน	๒ มี.ค. ๒๕๔๕
joint insured clause	ข้อกำหนดผู้เอาประกันภัยร่วม	๒ มี.ค. ๒๕๔๕
joint life and survivorship annuity	กรมธรรม์แบบเงินรายปีร่วมปุนชีพ	๒ มี.ค. ๒๕๔๕
joint-life annuity	กรมธรรม์แบบเงินรายปีร่วม	๒ มี.ค. ๒๕๔๕
joint-life policy	กรมธรรม์แบบร่วมชีวิต	๒ มี.ค. ๒๕๔๕
judgement rating	การกำหนดอัตราตามดุลยพินิจ	๒ มี.ค. ๒๕๔๕
jumbo risk	ภัยขนาดใหญ่พิเศษ	๒ มี.ค. ๒๕๔๕
jurisdiction clause	ข้อกำหนดเขตอำนาจศาล	๒ มี.ค. ๒๕๔๕
juvenile insurance	การประกันชีวิตผู้เยาว์	๒ มี.ค. ๒๕๔๕
keys clause	ข้อกำหนดกุญแจ	๒ มี.ค. ๒๕๔๕
keyman insurance	การประกันชีวิตบุคคลหลัก	๒ มี.ค. ๒๕๔๕
kidnap and ransom insurance	การประกันภัยการลักพาตัวเรียกค่าไถ่	๒ มี.ค. ๒๕๔๕
knock-for-knock agreement	ข้อตกลงไม่เรียกร้องต่อกัน	๒ มี.ค. ๒๕๔๕
label clause	ข้อกำหนดฉลากสินค้า	๒ มี.ค. ๒๕๔๕
land risks	ภัยบก	๒ มี.ค. ๒๕๔๕
lapsation profit	กำไรจากกรมธรรม์ขาดอายุ	๒ มี.ค. ๒๕๔๕
lapse	ขาดอายุ	๒ มี.ค. ๒๕๔๕
larceny	การลักทรัพย์	๒ มี.ค. ๒๕๔๕
latent defect	ข้อบกพร่องแฝง	๒ มี.ค. ๒๕๔๕
law of large numbers	กฎว่าด้วยจำนวนมาก	๒ มี.ค. ๒๕๔๕
lay-up return	เบี้ยประกันภัยจ่ายคืนระหว่างหยุดใช้งาน	๒ มี.ค. ๒๕๔๕
layer	ช่วงชั้นความรับผิด	๒ มี.ค. ๒๕๔๕
lead	"ผู้รับประกันภัยนำ <i>มีความหมายเหมือนกับ <a href=""/coinages/websearch.php?Wd=leading+underwriter&amp;Sj=0"">leading underwriter</a></i>"	๒ มี.ค. ๒๕๔๕
leading underwriter	ผู้รับประกันภัยนำ	๒ มี.ค. ๒๕๔๕
Leading Underwriter’s Agreement	ข้อตกลงผู้รับประกันภัยนำ	๒ มี.ค. ๒๕๔๕
legal (costs and expenses) insurance	การประกันภัยคดีความ	๒ มี.ค. ๒๕๔๕
legal (costs and expenses) insurance	การประกันภัยคดีความ	๒ มี.ค. ๒๕๔๕
legal costs extension	การขยายความคุ้มครองคดีความ	๒ มี.ค. ๒๕๔๕
legal protection insurance	"การประกันภัยคดีความ <i>มีความหมายเหมือนกับ <a href=""/coinages/websearch.php?Wd=legal+insurance&amp;Sj=0"">legal (cost and expenses) insurance</a></i>"	๒ มี.ค. ๒๕๔๕
legal reserve	เงินสำรองตามกฎหมาย	๒ มี.ค. ๒๕๔๕
letter of indemnity	หนังสือค้ำประกันการชดใช้ค่าเสียหาย	๒ มี.ค. ๒๕๔๕
Lettered Rules	กฎตามตัวอักษร	๒ มี.ค. ๒๕๔๕
level premium	"เบี้ยประกันภัยอัตราคงที่ <i>มีความหมายเหมือนกับ <a href=""/coinages/websearch.php?Wd=level+rate&amp;Sj=0"">level rate</a></i>"	๒ มี.ค. ๒๕๔๕
level rate	เบี้ยประกันอัตราคงที่	๒ มี.ค. ๒๕๔๕
liability insurance	การประกันภัยความรับผิด	๒ มี.ค. ๒๕๔๕
liable or not liable	รับผิดหรือไม่รับผิด	๒ มี.ค. ๒๕๔๕
libel and slander insurance	"การประกันภัยการหมิ่นประมาท <i>มีความหมายเหมือนกับ <a href=""/coinages/websearch.php?Wd=defamation+insurance&amp;Sj=0"">defamation insurance</a></i>"	๒ มี.ค. ๒๕๔๕
licence insurance	การประกันภัยใบอนุญาต	๒ มี.ค. ๒๕๔๕
lien	การยึดหน่วง	๒ มี.ค. ๒๕๔๕
life annuity	เงินรายปีตลอดชีพ	๒ มี.ค. ๒๕๔๕
life assured	ชีวิตที่เอาประกันภัย	๒ มี.ค. ๒๕๔๕
life contingency	เหตุความไม่แน่นอนของชีวิต	๒ มี.ค. ๒๕๔๕
life expectancy	พยากรณ์ชีพ	๒ มี.ค. ๒๕๔๕
life expectancy term insurance	การประกันชีวิตแบบชั่วระยะเวลาตามพยากรณ์ชีพ	๒ มี.ค. ๒๕๔๕
life fund	กองทุนประกันชีวิต	๒ มี.ค. ๒๕๔๕
life insurance	การประกันชีวิต	๒ มี.ค. ๒๕๔๕
life insurance company	บริษัทประกันชีวิต	๒ มี.ค. ๒๕๔๕
life insurance trust	ทรัสต์ประกันชีวิต	๒ มี.ค. ๒๕๔๕
life table	"<i>มีความหมายเหมือนกับ <a href=""/coinages/websearch.php?Wd=mortality+table&amp;Sj=0"">mortality table</a></i>"	๒ มี.ค. ๒๕๔๕
limit	ขีดจำกัด	๒ มี.ค. ๒๕๔๕
limit of indemnity	ขีดจำกัดการชดใช้ค่าสินไหมทดแทน	๒ มี.ค. ๒๕๔๕
limit of liability	"ขีดจำกัดความรับผิด <i>มีความหมายเหมือนกับ <a href=""/coinages/websearch.php?Wd=limit+of+indemnity&amp;Sj=0"">limit of indemnity</a></i>"	๒ มี.ค. ๒๕๔๕
limitation of liability	การจำกัดจำนวนความรับผิด	๒ มี.ค. ๒๕๔๕
limited conditions	"เงื่อนไขจำกัดความเสียหาย <i>มีความหมายเหมือนกับ <a href=""/coinages/websearch.php?Wd=limited+terms&amp;Sj=0"">limited terms</a></i>"	๒ มี.ค. ๒๕๔๕
limited payment policy	กรมธรรม์จำกัดเวลาชำระเบี้ยประกันภัย	๒ มี.ค. ๒๕๔๕
limited terms	เงื่อนไขจำกัดความเสียหาย	๒ มี.ค. ๒๕๔๕
line	๑. ส่วนรับประกันภัย<br/>๒. ประเภทของการประกันภัย	๒ มี.ค. ๒๕๔๕
line sheet	ตารางส่วนรับประกันภัย	๒ มี.ค. ๒๕๔๕
liquidator’s bond	กรมธรรม์ค้ำประกันผู้ชำระบัญชี	๒ มี.ค. ๒๕๔๕
litigation costs and expenses	ค่าใช้จ่ายในการสู้คดี	๒ มี.ค. ๒๕๔๕
Lloyd’s (of London)	สถาบันลอยด์ (แห่งลอนดอน)	๒ มี.ค. ๒๕๔๕
Lloyd’s Acts	พระราชบัญญัติสถาบันลอยด์	๒ มี.ค. ๒๕๔๕
Lloyd’s Agency System	ระบบตัวแทนของสถาบันลอยด์	๒ มี.ค. ๒๕๔๕
Lloyd’s Agent	ตัวแทนของสถาบันลอยด์	๒ มี.ค. ๒๕๔๕
Lloyd’s Associates	สมาชิกสมทบสถาบันลอยด์	๒ มี.ค. ๒๕๔๕
Lloyd’s Association	สมาคมผู้รับประกันภัยแบบสถาบันลอยด์	๒ มี.ค. ๒๕๔๕
Lloyd’s Broker	นายหน้าประกันภัยของสถาบันลอยด์	๒ มี.ค. ๒๕๔๕
Lloyd’s certificates	ใบรับรองการประกันภัยของสถาบันลอยด์	๒ มี.ค. ๒๕๔๕
Lloyd’s Form	แบบฟอร์มของสถาบันลอยด์	๒ มี.ค. ๒๕๔๕
livestock insurance	การประกันภัยปศุสัตว์	๒ มี.ค. ๒๕๔๕
Lloyd’s List	ข่าวสารสถาบันลอยด์	๒ มี.ค. ๒๕๔๕
Lloyd’s (of London)	สถาบันลอยด์ (แห่งลอนดอน)	๒ มี.ค. ๒๕๔๕
Lloyd’s Open Form	"แบบฟอร์มของสถาบันลอยด์ <i>มีความหมายเหมือนกับ <a href=""/coinages/websearch.php?Wd=Lloyd%27s+Form&amp;Sj=0"">Lloyd’s Form</a></i>"	๒ มี.ค. ๒๕๔๕
Lloyd’s Shipping Index	ข่าวสารการเดินเรือของสถาบันลอยด์	๒ มี.ค. ๒๕๔๕
Lloyd’s Syndicate	คณะผู้ร่วมรับประกันภัยของสถาบันลอยด์	๒ มี.ค. ๒๕๔๕
Lloyd’s Underwriter	ผู้พิจารณารับประกันภัยของสถาบันลอยด์	๒ มี.ค. ๒๕๔๕
Lloyd’s Underwriter Agent	ตัวแทนผู้รับประกันภัยของสถาบันลอยด์	๒ มี.ค. ๒๕๔๕
loading profit	กำไรจากส่วนบวกเพิ่ม	๒ มี.ค. ๒๕๔๕
loading	ส่วนบวกเพิ่ม	๒ มี.ค. ๒๕๔๕
loan value	มูลค่าเงินกู้	๒ มี.ค. ๒๕๔๕
location clause	ข้อกำหนดสถานที่เก็บสินค้า	๒ มี.ค. ๒๕๔๕
location limit	ขีดจำกัดสถานที่เก็บสินค้า	๒ มี.ค. ๒๕๔๕
long-tail claims	ค่าสินไหมทดแทนยืดเยื้อ	๒ มี.ค. ๒๕๔๕
long-term agreement	ข้อตกลงระยะยาว	๒ มี.ค. ๒๕๔๕
long term insurance	การประกันภัยระยะยาว	๒ มี.ค. ๒๕๔๕
loss event	เหตุการณ์วินาศภัย	๒ มี.ค. ๒๕๔๕
loss expectancy	การคาดคะเนวินาศภัย	๒ มี.ค. ๒๕๔๕
loss lag	"การเปลี่ยนแปลงการประมาณค่าสินไหมทดแทน <i>มีความหมายเหมือนกับ <a href=""/coinages/websearch.php?Wd=loss+development&amp;Sj=0"">loss development</a></i>"	๒ มี.ค. ๒๕๔๕
loss loading	ส่วนบวกเพิ่มค่าสินไหมทดแทน	๒ มี.ค. ๒๕๔๕
loss of engagement	การเสียรายได้จากการรับจ้าง	๒ มี.ค. ๒๕๔๕
loss of limb	การสูญเสียอวัยวะแขนขา	๒ มี.ค. ๒๕๔๕
loss of profits insurance	"การประกันภัยการสูญเสียกำไร <i>มีความหมายเหมือนกับ <a href=""/coinages/websearch.php?Wd=business+interruption+insurance&amp;Sj=0"">business interruption insurance</a></i>"	๒ มี.ค. ๒๕๔๕
loss of specie	ความสิ้นสภาพ	๒ มี.ค. ๒๕๔๕
loss of use insurance	การประกันภัยความเสียประโยชน์การใช้	๒ มี.ค. ๒๕๔๕
loss portfolio	ยอดรวมค่าสินไหมทดแทน	๒ มี.ค. ๒๕๔๕
loss prevention	การป้องกันวินาศภัย	๒ มี.ค. ๒๕๔๕
loss ratio	อัตราส่วนค่าสินไหมทดแทน	๒ มี.ค. ๒๕๔๕
loss reserve	"เงินสำรองค่าสินไหมทดแทน <i>มีความหมายเหมือนกับ <a href=""/coinages/websearch.php?Wd=claims+reserves&amp;Sj=0"">claims reserves</a></i>"	๒ มี.ค. ๒๕๔๕
loss sustained cover	ความคุ้มครองวินาศภัยตามสัญญา	๒ มี.ค. ๒๕๔๕
loss-of-licence insurance	การประกันภัยการถูกถอนใบอนุญาต	๒ มี.ค. ๒๕๔๕
“losses occurring” basis	หลักกำหนดระยะเวลาความเสียหาย	๒ มี.ค. ๒๕๔๕
“losses to extinction” basis	หลักยกยอดขาดทุน	๒ มี.ค. ๒๕๔๕
loss	"๑. ความสูญเสีย<br/>๒. วินาศภัย<br/>๓. ค่าสินไหมทดแทน <i>มีความหมายเหมือนกับ <a href=""/coinages/websearch.php?Wd=claim&amp;Sj=0"">claim</a> ความหมายที่ ๒</i><br/>๔. การสูญหาย"	๒ มี.ค. ๒๕๔๕
loss adjuster	"ผู้เจรจาตกลงค่าสินไหมทดแทน <i>มีความหมายเหมือนกับ <a href=""/coinages/websearch.php?Wd=claims+adjuster&amp;Sj=0"">claims adjuster</a></i>"	๒ มี.ค. ๒๕๔๕
loss adjustment	การจัดการค่าสินไหมทดแทน	๒ มี.ค. ๒๕๔๕
loss development	การเปลี่ยนแปลงการประมาณค่าสินไหมทดแทน	๒ มี.ค. ๒๕๔๕
lost or not lost	เกิดหรือไม่เกิดวินาศภัย	๒ มี.ค. ๒๕๔๕
loyalty discount	ส่วนลดจูงใจ	๒ มี.ค. ๒๕๔๕
made good	ทรัพย์สินสละทิ้ง	๒ มี.ค. ๒๕๔๕
maintenance bond insurance	การประกันภัยการค้ำประกันการบำรุงรักษา	๒ มี.ค. ๒๕๔๕
malicious damage	ความเสียหายจากการกลั่นแกล้ง	๒ มี.ค. ๒๕๔๕
malus	เบี้ยลงโทษ	๒ มี.ค. ๒๕๔๕
margin of solvency	"ส่วนเหลื่อมทรัพย์สินเหนือหนี้สิน <i>มีความหมายเหมือนกับ <a href=""/coinages/websearch.php?Wd=solvency+margin&amp;Sj=0"">solvency margin</a></i>"	๒ มี.ค. ๒๕๔๕
manual	คู่มือ	๒ มี.ค. ๒๕๔๕
manual underwriting	"คู่มือการรับประกันภัย <i>มีความหมายเหมือนกับ <a href=""/coinages/websearch.php?Wd=manual&amp;Sj=0"">manual</a></i>"	๒ มี.ค. ๒๕๔๕
marine cargo insurance	"การประกันภัยสินค้าขนส่ง <i>มีความหมายเหมือนกับ <a href=""/coinages/websearch.php?Wd=cargo+insurance&amp;Sj=0"">cargo insurance</a></i>"	๒ มี.ค. ๒๕๔๕
marine hull insurance	การประกันภัยตัวเรือ	๒ มี.ค. ๒๕๔๕
marine insurance	การประกันภัยทางทะเล	๒ มี.ค. ๒๕๔๕
market capacity	ขีดความสามารถของตลาดรับประกันภัย	๒ มี.ค. ๒๕๔๕
master policy	กรมธรรม์แม่	๒ มี.ค. ๒๕๔๕
material damage warranty	คำรับรองความเสียหายทรัพย์สิน	๒ มี.ค. ๒๕๔๕
material fact	ข้อความจริงอันเป็นสาระสำคัญ	๒ มี.ค. ๒๕๔๕
material property	ทรัพย์สินที่มีตัวตน	๒ มี.ค. ๒๕๔๕
maturity bonus	เงินปันผลครบกำหนด	๒ มี.ค. ๒๕๔๕
maturity value	มูลค่ากำหนด	๒ มี.ค. ๒๕๔๕
maturity	ครบกำหนด	๒ มี.ค. ๒๕๔๕
maximum possible loss	ความเสียหายสูงสุดที่อาจเกิดขึ้น	๒ มี.ค. ๒๕๔๕
maximum probable loss	"ความเสียหายสูงสุดที่น่าจะเป็น <i>มีความหมายเหมือนกับ <a href=""/coinages/websearch.php?Wd=estimated+maximum+loss&amp;Sj=0"">estimated maximum loss</a> และ <a href=""/coinages/websearch.php?Wd=probable+maximum+loss&amp;Sj=0"">probable maximum loss</a></i>"	๒ มี.ค. ๒๕๔๕
maximum value insurance	การประกันภัยแบบกำหนดมูลค่าสูงสุด	๒ มี.ค. ๒๕๔๕
measure of indemnity	หลักการคำนวณค่าสินไหมทดแทน	๒ มี.ค. ๒๕๔๕
medical examination	การตรวจสุขภาพ	๒ มี.ค. ๒๕๔๕
memorandum clause	ข้อกำหนดเมมโมแรนดัม	๒ มี.ค. ๒๕๔๕
Member of Lloyd’s	สมาชิกสถาบันลอยด์	๒ มี.ค. ๒๕๔๕
merit rating	การกำหนดอัตราตามความเป็นธรรม	๒ มี.ค. ๒๕๔๕
merger	๑. การรวมบริษัท<br/>๒. หลักควบความเสียหาย	๒ มี.ค. ๒๕๔๕
metal workers’ extension	การขยายความคุ้มครองเครื่องจักรระหว่างขนย้าย	๒ มี.ค. ๒๕๔๕
minimising a loss	การบรรเทาวินาศภัย	๒ มี.ค. ๒๕๔๕
minimum premium	เบี้ยประกันภัยขั้นต่ำ	๒ มี.ค. ๒๕๔๕
minimum rate	อัตราเบี้ยประกันภัยขั้นต่ำ	๒ มี.ค. ๒๕๔๕
misdescription	รายละเอียดคลาดเคลื่อน	๒ มี.ค. ๒๕๔๕
misrepresentation	การแถลงข้อความเป็นเท็จ	๒ มี.ค. ๒๕๔๕
missing beneficiaries indemnity	การชดใช้ค่าสินไหมทดแทนกรณีผู้รับมรดกสาบสูญ	๒ มี.ค. ๒๕๔๕
missing document indemnity	การชดใช้ค่าสินไหมทดแทนกรณีเอกสารสูญหาย	๒ มี.ค. ๒๕๔๕
misstatement of age	การแถลงอายุคลาดเคลื่อน	๒ มี.ค. ๒๕๔๕
mixed company	บริษัทประกันชีวิตแบบผสม	๒ มี.ค. ๒๕๔๕
mixed policy	กรมธรรม์ผสม	๒ มี.ค. ๒๕๔๕
modified life	กรมธรรม์แปลงอัตรา	๒ มี.ค. ๒๕๔๕
monthly debit ordinary	กรมธรรม์สามัญรายเดือน	๒ มี.ค. ๒๕๔๕
monthly income contract	สัญญาประกันชีวิตแบบเงินได้รายเดือน	๒ มี.ค. ๒๕๔๕
moral hazard	ภาวะภัยทางศีลธรรม	๒ มี.ค. ๒๕๔๕
morale hazard	ภาวะภัยทางอุปนิสัย	๒ มี.ค. ๒๕๔๕
morbidity table	ตารางความเจ็บป่วย	๒ มี.ค. ๒๕๔๕
mortality gains	ส่วนได้จากตารางมรณวิสัย	๒ มี.ค. ๒๕๔๕
mortality savings	"ส่วนได้จากตารางมรณวิสัย <i>มีความหมายเหมือนกับ <a href=""/coinages/websearch.php?Wd=mortality+gains&amp;Sj=0"">mortality gains</a></i>"	๒ มี.ค. ๒๕๔๕
mortality table	ตารางมรณวิสัย	๒ มี.ค. ๒๕๔๕
mortgage clause	ข้อกำหนดผู้รับจำนอง	๒ มี.ค. ๒๕๔๕
mortgage guarantee	การค้ำประกันการจำนอง	๒ มี.ค. ๒๕๔๕
mortgage guarantee certificate	เอกสารค้ำประกันการจำนอง	๒ มี.ค. ๒๕๔๕
mortgage insurance	การประกันชีวิตคุ้มครองการจำนอง	๒ มี.ค. ๒๕๔๕
mortuary dividend	"<i>มีความหมายเหมือนกับ <a href=""/coinages/websearch.php?Wd=post+mortem+dividend&amp;Sj=0"">post mortem dividend</a></i>"	๒ มี.ค. ๒๕๔๕
motor insurance	การประกันภัยรถยนต์	๒ มี.ค. ๒๕๔๕
motorcycle insurance	การประกันภัยจักรยานยนต์	๒ มี.ค. ๒๕๔๕
multiple birth insurance	การประกันภัยคลอดแฝด	๒ มี.ค. ๒๕๔๕
multiple line insurer	ผู้รับประกันภัยหลายประเภท	๒ มี.ค. ๒๕๔๕
mutual insurance	การประกันภัยแบบสหการ	๒ มี.ค. ๒๕๔๕
mutual insurance company	บริษัทประกันภัยแบบสหการ	๒ มี.ค. ๒๕๔๕
mutual life insurance company	บริษัทประกันชีวิตแบบสหการ	๒ มี.ค. ๒๕๔๕
mutualisation	การแปลงเป็นแบบสหการ	๒ มี.ค. ๒๕๔๕
Name	นามผู้รับประกันภัยแห่งสถาบันลอยด์	๒ มี.ค. ๒๕๔๕
name limit	ขีดจำกัดจุดเก็บสินค้า	๒ มี.ค. ๒๕๔๕
nail to nail	ตะปูถึงตะปู	๒ มี.ค. ๒๕๔๕
named policy	กรมธรรม์แบบระบุชื่อเรือ	๒ มี.ค. ๒๕๔๕
named steamer	เรือที่ระบุชื่อ	๒ มี.ค. ๒๕๔๕
natural premium	เบี้ยประกันภัยธรรมชาติ	๒ มี.ค. ๒๕๔๕
navigation risks	ภัยการเดินเรือ	๒ มี.ค. ๒๕๔๕
Negligence Clause	ข้อกำหนดความประมาทเลินเล่อ	๒ มี.ค. ๒๕๔๕
net line	ส่วนรับประกันภัยสุทธิ	๒ มี.ค. ๒๕๔๕
net natural premium	"เบี้ยประกันภัยสุทธิธรรมชาติ <i>มีความหมายเหมือนกับ <a href=""/coinages/websearch.php?Wd=natural+premium&amp;Sj=0"">natural premium</a></i>"	๒ มี.ค. ๒๕๔๕
net absolute(ly)	จำนวนสุทธิสัมบูรณ์	๒ มี.ค. ๒๕๔๕
net absolute(ly)	จำนวนสุทธิสัมบูรณ์	๒ มี.ค. ๒๕๔๕
net amount at risk	"จำนวนเงินเสี่ยงภัยสุทธิ <i>มีความหมายเหมือนกับ <a href=""/coinages/websearch.php?Wd=amount+at+risk&amp;Sj=0"">amount at risk</a></i>"	๒ มี.ค. ๒๕๔๕
net cost	ต้นทุนสุทธิ	๒ มี.ค. ๒๕๔๕
net earned premiums	เบี้ยประกันภัยที่ถือเป็นรายได้สุทธิ	๒ มี.ค. ๒๕๔๕
net premium	เบี้ยประกันภัยสุทธิ	๒ มี.ค. ๒๕๔๕
net retained line	"ส่วนรับประกันภัยสุทธิ <i>มีความหมายเหมือนกับ <a href=""/coinages/websearch.php?Wd=net+line&amp;Sj=0"">net line</a></i>"	๒ มี.ค. ๒๕๔๕
net surplus	เงินส่วนเกินสุทธิ	๒ มี.ค. ๒๕๔๕
net value	"<i>ดู <a href=""/coinages/websearch.php?Wd=damaged+value&amp;Sj=0"">damaged value</a></i>"	๒ มี.ค. ๒๕๔๕
net written premiums	เบี้ยประกันภัยรับสุทธิ	๒ มี.ค. ๒๕๔๕
new business	ธุรกิจใหม่	๒ มี.ค. ๒๕๔๕
new for old	ของใหม่แทนของเก่า	๒ มี.ค. ๒๕๔๕
no claim for accident reported	การไม่เรียกร้องค่าสินไหมทดแทนสำหรับอุบัติเหตุที่ได้รับแจ้งแล้ว	๒ มี.ค. ๒๕๔๕
no cure no pay	ไม่สำเร็จไม่จ่าย	๒ มี.ค. ๒๕๔๕
no-claim bonus	"เบี้ยรางวัลประวัติดี <i>มีความหมายเหมือนกับ <a href=""/coinages/websearch.php?Wd=no-claim+discount&amp;Sj=0"">no-claim discount</a></i>"	๒ มี.ค. ๒๕๔๕
no-claim discount	ส่วนลดประวัติดี	๒ มี.ค. ๒๕๔๕
nominator’s clause	"<i>มีความหมายเหมือนกับ <a href=""/coinages/websearch.php?Wd=payor+insurance&amp;Sj=0"">payor insurance</a></i>"	๒ มี.ค. ๒๕๔๕
non-admitted company	บริษัทที่ไม่ได้รับอนุญาต	๒ มี.ค. ๒๕๔๕
non-admitted reinsurance	การประกันภัยต่อที่ไม่ได้รับอนุญาต	๒ มี.ค. ๒๕๔๕
non-average policy	กรมธรรม์ปลอดการร่วมเฉลี่ยค่าเสียหาย	๒ มี.ค. ๒๕๔๕
non-cancellable policy	กรมธรรม์ห้ามการบอกเลิก	๒ มี.ค. ๒๕๔๕
non-contribution clause	ข้อกำหนดการไม่ร่วมชดใช้	๒ มี.ค. ๒๕๔๕
non-contributory	"การไม่มีส่วนร่วม <i>ดู <a href=""/coinages/websearch.php?Wd=contributory&amp;Sj=0"">contributory</a></i>"	๒ มี.ค. ๒๕๔๕
non-disclosure	การไม่เปิดเผยข้อความจริง	๒ มี.ค. ๒๕๔๕
non-forfeiture options	สิทธิเลือกอันไม่อาจริบได้	๒ มี.ค. ๒๕๔๕
non-Institute company	บริษัทที่ไม่ได้เป็นสมาชิกของสถาบัน	๒ มี.ค. ๒๕๔๕
non-concurrent insurance	การประกันภัยไม่พ้องกัน	๒ มี.ค. ๒๕๔๕
non-marine	ไม่ใช่ทางทะเล	๒ มี.ค. ๒๕๔๕
non-medical insurance	การประกันชีวิตโดยไม่ตรวจสุขภาพ	๒ มี.ค. ๒๕๔๕
non-owned aircraft endorsement	ใบสลักหลังกรณีอากาศยานไม่ใช่ของตน	๒ มี.ค. ๒๕๔๕
non-participating policy	กรมธรรม์ชนิดไม่มีเงินปันผล	๒ มี.ค. ๒๕๔๕
non-payment risk	ภัยจากหนี้สูญ	๒ มี.ค. ๒๕๔๕
non-proportionate reinsurance	การประกันภัยต่อแบบไม่กำหนดสัดส่วน	๒ มี.ค. ๒๕๔๕
non-standard construction	สิ่งปลูกสร้างไม่ได้มาตรฐาน	๒ มี.ค. ๒๕๔๕
non-tariff company	บริษัทนอกพิกัดอัตรา	๒ มี.ค. ๒๕๔๕
nonfeasance	การละเว้น	๒ มี.ค. ๒๕๔๕
North American Warranty	คำรับรองอเมริกาเหนือ	๒ มี.ค. ๒๕๔๕
notice of abandonment	ใบแจ้งการสละทิ้ง	๒ มี.ค. ๒๕๔๕
Not to Inure clause	ข้อกำหนดไม่ให้ประโยชน์	๒ มี.ค. ๒๕๔๕
not under repair	ข้อกำหนดเรือไม่ต้องซ่อม	๒ มี.ค. ๒๕๔๕
notional reinstatement value cover	ความคุ้มครองมูลค่าจัดทดแทน	๒ มี.ค. ๒๕๔๕
notification of claim	การแจ้งเกิดวินาศภัย	๒ มี.ค. ๒๕๔๕
Nuclear Exclusion	ข้อจำกัดความคุ้มครองภัยนิวเคลียร์	๒ มี.ค. ๒๕๔๕
nuclear risks	"ภัยนิวเคลียร์ <i>มีความหมายเหมือนกับ <a href=""/coinages/websearch.php?Wd=atomic+risks&amp;Sj=0"">atomic risks</a></i>"	๒ มี.ค. ๒๕๔๕
numerical weighting system	ระบบกำหนดน้ำหนักภัยด้วยตัวเลข	๒ มี.ค. ๒๕๔๕
Numbered Rules	กฎตามตัวเลข	๒ มี.ค. ๒๕๔๕
old age and survivors insurance (OASI)	การประกันภัยผู้สูงอายุ	๒ มี.ค. ๒๕๔๕
objective risk	ความเสี่ยงภัยเชิงวัตถุวิสัย	๒ มี.ค. ๒๕๔๕
obligatory reinsurance	การประกันภัยต่อโดยผูกพัน	๒ มี.ค. ๒๕๔๕
obligee	ผู้รับการค้ำประกัน	๒ มี.ค. ๒๕๔๕
obligor	ผู้มีภาระผูกพัน	๒ มี.ค. ๒๕๔๕
occupational extra	ส่วนเพิ่มเนื่องจากอาชีพ	๒ มี.ค. ๒๕๔๕
occupational hazard	ภาวะภัยจากอาชีพ	๒ มี.ค. ๒๕๔๕
occupational accident	อุบัติเหตุเนื่องจากอาชีพ	๒ มี.ค. ๒๕๔๕
occupational classification	การแยกประเภทอาชีพ	๒ มี.ค. ๒๕๔๕
occupational disease	โรคภัยเนื่องจากอาชีพ	๒ มี.ค. ๒๕๔๕
occupancy	ลักษณะการใช้อาคาร	๒ มี.ค. ๒๕๔๕
occurrence	เหตุการณ์ที่เกิดขึ้น	๒ มี.ค. ๒๕๔๕
ocean marine insurance	การประกันภัยทางทะเล	๒ มี.ค. ๒๕๔๕
off risk	สิ้นสุดการเสี่ยงภัย	๒ มี.ค. ๒๕๔๕
off slip	สำเนาสลิป	๒ มี.ค. ๒๕๔๕
office premium	"<i>ดู <a href=""/coinages/websearch.php?Wd=gross+rates&amp;Sj=0"">gross rates</a></i>"	๒ มี.ค. ๒๕๔๕
offer and acceptance	การเสนอและการสนอง	๒ มี.ค. ๒๕๔๕
offer note	"ใบเสนอขอ <i>มีความหมายเหมือนกับ <a href=""/coinages/websearch.php?Wd=request+note&amp;Sj=0"">request note</a></i>"	๒ มี.ค. ๒๕๔๕
old age and survivors insurance (OASI)	การประกันภัยผู้สูงอายุ	๒ มี.ค. ๒๕๔๕
omnibus clause	ข้อกำหนดสารพัน	๒ มี.ค. ๒๕๔๕
omnibus insurance	การประกันภัยสารพัน	๒ มี.ค. ๒๕๔๕
oncost	ค่าใช้จ่ายประจำ	๒ มี.ค. ๒๕๔๕
on net	เบี้ยประกันภัยสุทธิ	๒ มี.ค. ๒๕๔๕
on risk	ระหว่างการเสี่ยงภัย	๒ มี.ค. ๒๕๔๕
on gross	เบี้ยประกันภัยรวม	๒ มี.ค. ๒๕๔๕
one disaster or casualty clause	ข้อกำหนดความเสียหายต่อครั้ง	๒ มี.ค. ๒๕๔๕
open policy	กรมธรรม์เปิด	๒ มี.ค. ๒๕๔๕
open cover	๑. ความคุ้มครองเปิด<br/>๒. สัญญาประกันภัยเปิด	๒ มี.ค. ๒๕๔๕
open slip	สลิปเปิด	๒ มี.ค. ๒๕๔๕
open treaty	"สัญญาประกันภัยต่อแบบเปิด <i>มีความหมายเหมือนกับ <a href=""/coinages/websearch.php?Wd=facultative+obligatory+treaty&amp;Sj=0"">facultative obligatory treaty</a></i>"	๒ มี.ค. ๒๕๔๕
opening the warranty	การแก้คำรับรอง	๒ มี.ค. ๒๕๔๕
operative clause	ข้อกำหนดความคุ้มครอง	๒ มี.ค. ๒๕๔๕
or as original	หรือตามกรมธรรม์ฉบับต้น	๒ มี.ค. ๒๕๔๕
ordinary freight	ค่าระวางปรกติ	๒ มี.ค. ๒๕๔๕
ordinary insurance	การประกันชีวิตประเภทสามัญ	๒ มี.ค. ๒๕๔๕
ordinary life policy	กรมธรรม์ประกันชีวิตแบบสามัญ	๒ มี.ค. ๒๕๔๕
original cover	ความคุ้มครองต้นฉบับ	๒ มี.ค. ๒๕๔๕
original deductions	ส่วนลดตามกรมธรรม์ฉบับต้น	๒ มี.ค. ๒๕๔๕
original discounts	"ส่วนลดตามกรมธรรม์ <i>มีความหมายเหมือนกับ <a href=""/coinages/websearch.php?Wd=original+deductions&amp;Sj=0"">original deductions</a></i>"	๒ มี.ค. ๒๕๔๕
original gross premium	เบี้ยประกันภัยรวมตามกรมธรรม์ฉบับต้น	๒ มี.ค. ๒๕๔๕
original insured	ผู้เอาประกันภัยเดิม	๒ มี.ค. ๒๕๔๕
original net premium income	เบี้ยประกันภัยรับสุทธิตามกรมธรรม์ฉบับต้น	๒ มี.ค. ๒๕๔๕
original conditions	เงื่อนไขกรมธรรม์ฉบับต้น	๒ มี.ค. ๒๕๔๕
original net retained premium income	เบี้ยประกันภัยรับสุทธิตามกรมธรรม์ฉบับต้นที่คงไว้	๒ มี.ค. ๒๕๔๕
original rate	อัตราเบี้ยประกันภัยเดิม	๒ มี.ค. ๒๕๔๕
original slip	สลิปต้นฉบับ	๒ มี.ค. ๒๕๔๕
original terms	ข้อกำหนดฉบับต้น	๒ มี.ค. ๒๕๔๕
other insurance clause	ข้อกำหนดเกี่ยวกับการประกันภัยอื่น ๆ	๒ มี.ค. ๒๕๔๕
outstanding claims advance	การจ่ายล่วงหน้าค่าสินไหมทดแทนค้างจ่าย	๒ มี.ค. ๒๕๔๕
outstanding claims portfolio	ยอดรวมค่าสินไหมทดแทนค้างจ่าย	๒ มี.ค. ๒๕๔๕
outstanding claims reserve	เงินสำรองค่าสินไหมทดแทนค้างจ่าย	๒ มี.ค. ๒๕๔๕
outturn	สินค้าขนถ่าย	๒ มี.ค. ๒๕๔๕
outward reinsurance	ธุรกิจเอาประกันภัยต่อ	๒ มี.ค. ๒๕๔๕
over-insurance	การเอาประกันภัยสูงกว่ามูลค่า	๒ มี.ค. ๒๕๔๕
over-line	ส่วนรับประกันภัยเกินขีด	๒ มี.ค. ๒๕๔๕
overage	๑. เบี้ยประกันภัยเพิ่มเนื่องจากเรือเก่า<br/>๒. น้ำหนักเพิ่ม	๒ มี.ค. ๒๕๔๕
overclosing	เกินส่วนที่ตกลง	๒ มี.ค. ๒๕๔๕
overlapping insurance	การประกันภัยเหลื่อมกัน	๒ มี.ค. ๒๕๔๕
overplacing	การเสนอเกิน	๒ มี.ค. ๒๕๔๕
own damage	ความเสียหายของรถที่เอาประกันภัย	๒ มี.ค. ๒๕๔๕
own risk	ภัยเสี่ยงเอง	๒ มี.ค. ๒๕๔๕
owner’s liability	ความรับผิดของเจ้าของ	๒ มี.ค. ๒๕๔๕
owners’ clauses	ข้อกำหนดของเจ้าของ	๒ มี.ค. ๒๕๔๕
package policy	กรมธรรม์ภัยรวม	๒ มี.ค. ๒๕๔๕
paid-up addition	การเพิ่มใช้เงินสำเร็จ	๒ มี.ค. ๒๕๔๕
paid-up policy	กรมธรรม์ใช้เงินสำเร็จ	๒ มี.ค. ๒๕๔๕
paid-up value	มูลค่าใช้เงินสำเร็จ	๒ มี.ค. ๒๕๔๕
pair and set clause	ข้อกำหนดคู่และชุด	๒ มี.ค. ๒๕๔๕
paramount clause	ข้อกำหนดสุดยอด	๒ มี.ค. ๒๕๔๕
Paramount War Clause (Cargo)	ข้อกำหนดสุดยอดสำหรับภัยสงคราม(สินค้า)	๒ มี.ค. ๒๕๔๕
Paramount War Clause (Cargo)	ข้อกำหนดสุดยอดสำหรับภัยสงคราม(สินค้า)	๒ มี.ค. ๒๕๔๕
parity clause	ข้อกำหนดความเสมอภาค	๒ มี.ค. ๒๕๔๕
part time agent	ตัวแทนไม่เต็มเวลา	๒ มี.ค. ๒๕๔๕
partial disablement	ทุพพลภาพบางส่วน	๒ มี.ค. ๒๕๔๕
partial indemnity clause	ข้อกำหนดจ่ายค่าสินไหมทดแทนบางส่วน	๒ มี.ค. ๒๕๔๕
partial loss	ความเสียหายบางส่วน	๒ มี.ค. ๒๕๔๕
part of	บางส่วน	๒ มี.ค. ๒๕๔๕
particular average (loss)	ความเสียหายเฉพาะ	๒ มี.ค. ๒๕๔๕
particular average (loss)	ความเสียหายเฉพาะ	๒ มี.ค. ๒๕๔๕
particular charges	ค่าใช้จ่ายเฉพาะ	๒ มี.ค. ๒๕๔๕
partnership insurance	"การประกันชีวิตเพื่อธุรกิจ <i>มีความหมายเหมือนกับ <a href=""/coinages/websearch.php?Wd=business+insurance&amp;Sj=0"">business insurance</a> และ <a href=""/coinages/websearch.php?Wd=corporation+insurance&amp;Sj=0"">corporation insurance</a></i>"	๒ มี.ค. ๒๕๔๕
participating policy	กรมธรรม์ชนิดมีเงินปันผล	๒ มี.ค. ๒๕๔๕
passenger liability	ความรับผิดต่อผู้โดยสาร	๒ มี.ค. ๒๕๔๕
party wall	กำแพงร่วม	๒ มี.ค. ๒๕๔๕
pauschal	เบี้ยประกันภัยจ่ายล่วงหน้า	๒ มี.ค. ๒๕๔๕
payor insurance	การประกันชีวิตผู้ชำระเบี้ยประกันภัย	๒ มี.ค. ๒๕๔๕
payroll deduction insurance	"<i>มีความหมายเหมือนกับ <a href=""/coinages/websearch.php?Wd=salary+savings+insurance&amp;Sj=0"">salary savings insurance</a></i>"	๒ มี.ค. ๒๕๔๕
peak risk	การเสี่ยงภัยสูงสุด	๒ มี.ค. ๒๕๔๕
peak value clause	ข้อกำหนดมูลค่าสูงสุด	๒ มี.ค. ๒๕๔๕
penalty	วงเงินโทษปรับ	๒ มี.ค. ๒๕๔๕
pension annuity	"เงินรายปีบำนาญ <i>ดู <a href=""/coinages/websearch.php?Wd=retirement+annuity&amp;Sj=0"">retirement annuity</a></i>"	๒ มี.ค. ๒๕๔๕
percentage adjustments	การปรับอัตราร้อยละ	๒ มี.ค. ๒๕๔๕
percentage of fire loss insurance	การประกันภัยแบบร้อยละของความเสียหายอัคคีภัย	๒ มี.ค. ๒๕๔๕
performance bond	กรมธรรม์ค้ำประกันการรับเหมา	๒ มี.ค. ๒๕๔๕
perils of the sea	ภัยทางทะเล	๒ มี.ค. ๒๕๔๕
peril	ภัย	๒ มี.ค. ๒๕๔๕
period policy	"กรมธรรม์แบบกำหนดเวลา <i>มีความหมายเหมือนกับ <a href=""/coinages/websearch.php?Wd=time+policy&amp;Sj=0"">time policy</a></i>"	๒ มี.ค. ๒๕๔๕
permanent disablement	ทุพพลภาพถาวร	๒ มี.ค. ๒๕๔๕
permanent health insurance	การประกันสุขภาพแบบถาวร	๒ มี.ค. ๒๕๔๕
perpetual insurance	การประกันภัยแบบตลอดไป	๒ มี.ค. ๒๕๔๕
personal accident insurance	การประกันภัยอุบัติเหตุส่วนบุคคล	๒ มี.ค. ๒๕๔๕
personal injury	การบาดเจ็บเสียหายส่วนบุคคล	๒ มี.ค. ๒๕๔๕
personal liability insurance	การประกันภัยความรับผิดส่วนบุคคล	๒ มี.ค. ๒๕๔๕
personal surety	ผู้ค้ำประกันส่วนบุคคล	๒ มี.ค. ๒๕๔๕
physical hazard	ภาวะภัยทางกายภาพ	๒ มี.ค. ๒๕๔๕
pilferage	การลักเล็กขโมยน้อย	๒ มี.ค. ๒๕๔๕
plurality of risk	พหุภัย	๒ มี.ค. ๒๕๔๕
pluvius insurance	"<i>มีความหมายเหมือนกับ <a href=""/coinages/websearch.php?Wd=weather+insurance&amp;Sj=0"">weather insurance</a></i>"	๒ มี.ค. ๒๕๔๕
policies incepting basis	หลักถือกรมธรรม์มีผล	๒ มี.ค. ๒๕๔๕
policy	กรมธรรม์ประกันภัย	๒ มี.ค. ๒๕๔๕
policy conditions	เงื่อนไขกรมธรรม์	๒ มี.ค. ๒๕๔๕
policy fee	ค่าธรรมเนียมกรมธรรม์	๒ มี.ค. ๒๕๔๕
policy proof of interest	กรมธรรม์ยอมรับส่วนได้เสีย	๒ มี.ค. ๒๕๔๕
policy reserves	เงินสำรองกรมธรรม์	๒ มี.ค. ๒๕๔๕
policy signing office	สำนักงานออกกรมธรรม์	๒ มี.ค. ๒๕๔๕
policy value	"<i>มีความหมายเหมือนกับ <a href=""/coinages/websearch.php?Wd=reserve&amp;Sj=0"">reserve</a> ความหมายที่ ๒</i>"	๒ มี.ค. ๒๕๔๕
policy year	ปีกรมธรรม์	๒ มี.ค. ๒๕๔๕
policyholder; policy-holder	ผู้ถือกรมธรรม์	๒ มี.ค. ๒๕๔๕
political risks	ภัยการเมือง	๒ มี.ค. ๒๕๔๕
pool	กลุ่มรับเสี่ยงภัย	๒ มี.ค. ๒๕๔๕
port risks insurance	การประกันภัยเรือในท่า	๒ มี.ค. ๒๕๔๕
port to port	ท่าถึงท่า	๒ มี.ค. ๒๕๔๕
portfolio	ยอดรวม	๒ มี.ค. ๒๕๔๕
portfolio mix	ยอดรวมผสม	๒ มี.ค. ๒๕๔๕
portfolio premium	ยอดรวมเบี้ยประกันภัย	๒ มี.ค. ๒๕๔๕
portfolio reinsurance	การประกันภัยต่อตามยอดรวม	๒ มี.ค. ๒๕๔๕
portfolio return	การคืนยอดรวม	๒ มี.ค. ๒๕๔๕
portfolio run-off	ยอดรวมติดพัน	๒ มี.ค. ๒๕๔๕
portfolio transfer	การโอนยอดรวม	๒ มี.ค. ๒๕๔๕
positions bond	กรมธรรม์ค้ำประกันตำแหน่ง	๒ มี.ค. ๒๕๔๕
possible maximum loss	"ความเสียหายสูงสุดที่อาจเกิดขึ้น <i>มีความหมายเหมือนกับ <a href=""/coinages/websearch.php?Wd=maximum+possible+loss&amp;Sj=0"">maximum possible loss</a></i>"	๒ มี.ค. ๒๕๔๕
post mortem dividend	เงินปันผลจ่ายหลังถึงแก่กรรม	๒ มี.ค. ๒๕๔๕
Pre-Credit risk	ภัยก่อนการใช้สินเชื่อ	๒ มี.ค. ๒๕๔๕
preamble	"บทนำกรมธรรม์ <i>มีความหมายเหมือนกับ <a href=""/coinages/websearch.php?Wd=recital+clause&amp;Sj=0"">recital clause</a></i>"	๒ มี.ค. ๒๕๔๕
pre-existing condition	สภาพที่เป็นอยู่ก่อน	๒ มี.ค. ๒๕๔๕
preferred risk	การเสี่ยงภัยน้อยกว่าปรกติ	๒ มี.ค. ๒๕๔๕
preliminary term premium	เบี้ยประกันภัยแบบชั่วระยะเวลาเบื้องต้น	๒ มี.ค. ๒๕๔๕
premium	เบี้ยประกันภัย	๒ มี.ค. ๒๕๔๕
premium advice note	บันทึกแจ้งเบี้ยประกันภัย	๒ มี.ค. ๒๕๔๕
premium base	"เบี้ยประกันภัยพื้นฐาน <i>มีความหมายเหมือนกับ <a href=""/coinages/websearch.php?Wd=base+premium&amp;Sj=0"">base premium</a></i>"	๒ มี.ค. ๒๕๔๕
premium earned	"เบี้ยประกันภัยที่ถือเป็นรายได้ <i>มีความหมายเหมือนกับ <a href=""/coinages/websearch.php?Wd=earned+premium&amp;Sj=0"">earned premium</a></i>"	๒ มี.ค. ๒๕๔๕
premium income	รายได้จากเบี้ยประกันภัย	๒ มี.ค. ๒๕๔๕
premium limit	ขีดจำกัดเบี้ยประกันภัย	๒ มี.ค. ๒๕๔๕
premium loading	"ส่วนบวกเพิ่มเบี้ยประกันภัย <i>มีความหมายเหมือนกับ <a href=""/coinages/websearch.php?Wd=loading&amp;Sj=0"">loading</a></i>"	๒ มี.ค. ๒๕๔๕
premium notice	ใบเตือนชำระเบี้ยประกันภัย	๒ มี.ค. ๒๕๔๕
premium rate	อัตราเบี้ยประกันภัย	๒ มี.ค. ๒๕๔๕
premium receipt	ใบรับเงินค่าเบี้ยประกันภัย	๒ มี.ค. ๒๕๔๕
premium refund provision	เงื่อนไขคืนเบี้ยประกันภัย	๒ มี.ค. ๒๕๔๕
premium tax	ภาษีเบี้ยประกันภัย	๒ มี.ค. ๒๕๔๕
premium to be agreed	"เบี้ยประกันภัยตามที่จะตกลง <i>มีความหมายเหมือนกับ <a href=""/coinages/websearch.php?Wd=premium+to+be+arranged&amp;Sj=0"">premium to be arranged</a></i>"	๒ มี.ค. ๒๕๔๕
premium to be arranged	เบี้ยประกันภัยตามที่จะตกลง	๒ มี.ค. ๒๕๔๕
premium transfer	การโอนเบี้ยประกันภัย	๒ มี.ค. ๒๕๔๕
present value	มูลค่าปัจจุบัน	๒ มี.ค. ๒๕๔๕
prevention	การป้องกัน	๒ มี.ค. ๒๕๔๕
primary exposure	โอกาสเสี่ยงภัยเริ่มแรก	๒ มี.ค. ๒๕๔๕
primary insurance	การประกันภัยช่วงแรก	๒ มี.ค. ๒๕๔๕
primary reinsurance clause	ข้อกำหนดความรับผิดต่อผู้เอาประกันภัยเริ่มแรก	๒ มี.ค. ๒๕๔๕
principal	ตัวการ	๒ มี.ค. ๒๕๔๕
pro rata reinsurance	"การประกันภัยต่อแบบตามสัดส่วน <i>มีความหมายเหมือนกับ <a href=""/coinages/websearch.php?Wd=proportional+reinsurance&amp;Sj=0"">proportional reinsurance</a></i>"	๒ มี.ค. ๒๕๔๕
pro-rata premium	"<i>มีความหมายเหมือนกับ <a href=""/coinages/websearch.php?Wd=fractional+premium&amp;Sj=0"">fractional premium</a></i>"	๒ มี.ค. ๒๕๔๕
probable maximum loss	ความเสียหายสูงสุดที่น่าจะเป็น	๒ มี.ค. ๒๕๔๕
proceeds	จำนวนเงินประกันภัยที่จ่าย	๒ มี.ค. ๒๕๔๕
procuration fee	ค่าตอบแทนจัดหาประกันภัย	๒ มี.ค. ๒๕๔๕
producer	ผู้หาประกันภัย	๒ มี.ค. ๒๕๔๕
products guarantee	การประกันภัยค้ำประกันผลิตภัณฑ์	๒ มี.ค. ๒๕๔๕
products liability insurance	การประกันภัยความรับผิดจากผลิตภัณฑ์	๒ มี.ค. ๒๕๔๕
professional indemnity insurance	การประกันภัยความรับผิดจากวิชาชีพ	๒ มี.ค. ๒๕๔๕
professional reinsurer	ผู้รับประกันภัยต่ออาชีพ	๒ มี.ค. ๒๕๔๕
profit commission	ค่าบำเหน็จกำไร	๒ มี.ค. ๒๕๔๕
profit-sharing	การแบ่งผลกำไร	๒ มี.ค. ๒๕๔๕
profits insurance	การประกันภัยกำไร	๒ มี.ค. ๒๕๔๕
proof of loss	๑. การพิสูจน์ความเสียหาย<br/>๒. เอกสารแสดงความเสียหาย	๒ มี.ค. ๒๕๔๕
property damage insurance	การประกันภัยความรับผิดต่อทรัพย์สิน	๒ มี.ค. ๒๕๔๕
property insurance	การประกันภัยทรัพย์สิน	๒ มี.ค. ๒๕๔๕
proportional rule	กฎตามสัดส่วน	๒ มี.ค. ๒๕๔๕
proposal	คำขอเอาประกันภัย	๒ มี.ค. ๒๕๔๕
proposal form	ใบแบบคำขอเอาประกันภัย	๒ มี.ค. ๒๕๔๕
proportional benefits	ผลประโยชน์ตามสัดส่วน	๒ มี.ค. ๒๕๔๕
proportional reinsurance	การประกันภัยต่อแบบตามสัดส่วน	๒ มี.ค. ๒๕๔๕
prospective rating	การกำหนดอัตราตามประสบการณ์	๒ มี.ค. ๒๕๔๕
prosecution clause	ข้อกำหนดการฟ้องคดี	๒ มี.ค. ๒๕๔๕
protest	ใบแจ้งยืนยัน	๒ มี.ค. ๒๕๔๕
protected risk	ภัยคุ้มกัน	๒ มี.ค. ๒๕๔๕
protection	๑. การคุ้มกัน<br/>๒. ความคุ้มครอง	๒ มี.ค. ๒๕๔๕
Protection and Indemnity Club	"ชมรมความคุ้มครองและการชดใช้ (<a href=""/coinages/websearch.php?Wd=%AA%C1%C3%C1%BE%D5%E1%CD%B9%B4%EC%E4%CD&amp;Sj=0"">ชมรมพีแอนด์ไอ</a>)"	๒ มี.ค. ๒๕๔๕
protection and indemnity risks	ภัยเกี่ยวกับความคุ้มครองและชดใช้	๒ มี.ค. ๒๕๔๕
protracted default	การยืดเยื้อไม่ชำระหนี้	๒ มี.ค. ๒๕๔๕
provision	"๑. บทบัญญัติ<br/>๒. เงินสำรอง <i>มีความหมายเหมือนกับ <a href=""/coinages/websearch.php?Wd=reserve&amp;Sj=0"">reserve</a></i>"	๒ มี.ค. ๒๕๔๕
provisional premium	"<i>มีความหมายเหมือนกับ <a href=""/coinages/websearch.php?Wd=advance+premium&amp;Sj=0"">advance premium</a> และ <a href=""/coinages/websearch.php?Wd=deposit+premium&amp;Sj=0"">deposit premium</a></i>"	๒ มี.ค. ๒๕๔๕
proximate cause	สาเหตุใกล้ชิด	๒ มี.ค. ๒๕๔๕
Public Authority clause	ข้อกำหนดคำสั่งทางการ	๒ มี.ค. ๒๕๔๕
public adjuster	ผู้เจรจาตกลงทั่วไป	๒ มี.ค. ๒๕๔๕
public liability insurance	การประกันภัยความรับผิดต่อสาธารณะ	๒ มี.ค. ๒๕๔๕
pure burning cost	"ค่าเสียหายแท้จริง <i>มีความหมายเหมือนกับ <a href=""/coinages/websearch.php?Wd=burning+cost&amp;Sj=0"">burning cost</a></i>"	๒ มี.ค. ๒๕๔๕
pure endowment	การสะสมทรัพย์แท้จริง	๒ มี.ค. ๒๕๔๕
pure indemnity	การชดใช้ค่าสินไหมทดแทนแท้จริง	๒ มี.ค. ๒๕๔๕
pure lost cost	จำนวนค่าสินไหมทดแทน	๒ มี.ค. ๒๕๔๕
pure premium	เบี้ยประกันภัยแท้จริง	๒ มี.ค. ๒๕๔๕
pure risk	การเสี่ยงภัยแท้จริง	๒ มี.ค. ๒๕๔๕
quay to quay	"ท่าถึงท่า <i>มีความหมายเหมือนกับ <a href=""/coinages/websearch.php?Wd=port+to+port&amp;Sj=0"">port to port</a></i>"	๒ มี.ค. ๒๕๔๕
quota share reinsurance	การประกันภัยต่อตามส่วน	๒ มี.ค. ๒๕๔๕
quota surplus reinsurance	การประกันภัยต่อตามส่วนผสมส่วนเกิน	๒ มี.ค. ๒๕๔๕
R/I closing form	ใบแบบตกลงเอาประกันภัยต่อ	๒ มี.ค. ๒๕๔๕
R/I order form	ใบแบบขอเอาประกันภัยต่อ	๒ มี.ค. ๒๕๔๕
R/I treaty standard slip	ใบคำขอมาตรฐานสัญญาประกันภัยต่อ	๒ มี.ค. ๒๕๔๕
rain insurance	การประกันภัยฝน	๒ มี.ค. ๒๕๔๕
ransom insurance	"การประกันภัยการเรียกค่าไถ่ <i>มีความหมายเหมือนกับ <a href=""/coinages/websearch.php?Wd=kidnap+and+ransom+insurance&amp;Sj=0"">kidnap and ransom insurance</a></i>"	๒ มี.ค. ๒๕๔๕
rat(e)able contribution	การร่วมรับผิดตามสัดส่วน	๒ มี.ค. ๒๕๔๕
rate	อัตรา	๒ มี.ค. ๒๕๔๕
rat(e)able contribution	การร่วมรับผิดตามสัดส่วน	๒ มี.ค. ๒๕๔๕
rated-up	เพิ่มอัตรา	๒ มี.ค. ๒๕๔๕
rating	การกำหนดอัตรา	๒ มี.ค. ๒๕๔๕
rating bureau	สำนักคำนวณอัตราเบี้ยประกันภัย	๒ มี.ค. ๒๕๔๕
reassured	"ผู้เอาประกันภัยต่อ <i>มีความหมายเหมือนกับ <a href=""/coinages/websearch.php?Wd=cedant&amp;Sj=0"">cedant</a>; <a href=""/coinages/websearch.php?Wd=cedent&amp;Sj=0"">cedent</a> และ <a href=""/coinages/websearch.php?Wd=reinsured&amp;Sj=0"">reinsured</a></i>"	๒ มี.ค. ๒๕๔๕
reassurer	"ผู้รับประกันภัยต่อ <i>มีความหมายเหมือนกับ <a href=""/coinages/websearch.php?Wd=reinsurer&amp;Sj=0"">reinsurer</a></i>"	๒ มี.ค. ๒๕๔๕
reasonable precautions clause	ข้อกำหนดระมัดระวังตามควร	๒ มี.ค. ๒๕๔๕
reasonable despatch clause	ข้อกำหนดปฏิบัติการโดยพลันตามควร	๒ มี.ค. ๒๕๔๕
rebating	การลดเบี้ยประกันภัย	๒ มี.ค. ๒๕๔๕
recall of products insurance	การประกันภัยการเก็บคืนผลิตภัณฑ์	๒ มี.ค. ๒๕๔๕
recission	การยกเลิก	๒ มี.ค. ๒๕๔๕
recital clause	บทนำกรมธรรม์	๒ มี.ค. ๒๕๔๕
reciprocal exchange	ชมรมประกันภัยกันและกัน	๒ มี.ค. ๒๕๔๕
reciprocal insurance	การประกันภัยกันและกัน	๒ มี.ค. ๒๕๔๕
reciprocity	การตอบแทนกันและกัน	๒ มี.ค. ๒๕๔๕
reconditioning charges	ค่าใช้จ่ายปรับสภาพ	๒ มี.ค. ๒๕๔๕
recourse indemnity	การชดใช้ค่าสินไหมทดแทนคืน	๒ มี.ค. ๒๕๔๕
recovery	ส่วนรับคืน	๒ มี.ค. ๒๕๔๕
recovery agent	ตัวแทนเรียกร้องส่วนรับคืน	๒ มี.ค. ๒๕๔๕
redlining	เขตอันตราย	๒ มี.ค. ๒๕๔๕
red line clause	ข้อกำหนดตัวแดง	๒ มี.ค. ๒๕๔๕
reduced paid-up insurance	การประกันชีวิตใช้เงินสำเร็จลดเงินเอาประกันภัย	๒ มี.ค. ๒๕๔๕
reduced premium policy	"กรมธรรม์แบบเบี้ยประกันภัยลด <i>มีความหมายเหมือนกับ <a href=""/coinages/websearch.php?Wd=modified+life&amp;Sj=0"">modified life</a></i>"	๒ มี.ค. ๒๕๔๕
refund annuity	เงินรายปีชนิดจ่ายคืน	๒ มี.ค. ๒๕๔๕
reinstatement	๑. การฟื้นสัญญา<br/>๒. การจัดทดแทน	๒ มี.ค. ๒๕๔๕
reinstatement clause	ข้อกำหนดการจัดทดแทน	๒ มี.ค. ๒๕๔๕
reinstatement memorandum	"ข้อกำหนดการจัดทดแทน <i>มีความหมายเหมือนกับ <a href=""/coinages/websearch.php?Wd=reinstatement+clause&amp;Sj=0"">reinstatement clause</a> ความหมายที่ ๑</i>"	๒ มี.ค. ๒๕๔๕
reinstatement premium	เบี้ยประกันภัยเพื่อการจัดทดแทน	๒ มี.ค. ๒๕๔๕
reinsurance	การประกันภัยต่อ	๒ มี.ค. ๒๕๔๕
reinsurance broker	นายหน้าประกันภัยต่อ	๒ มี.ค. ๒๕๔๕
reinsurance cover	สัญญาคุ้มครองการเอาประกันภัยต่อ	๒ มี.ค. ๒๕๔๕
reinsurance of common account	การประกันภัยต่อบัญชีร่วม	๒ มี.ค. ๒๕๔๕
reinsurance of joint account	"การประกันภัยต่อบัญชีร่วม <i>มีความหมายเหมือนกับ <a href=""/coinages/websearch.php?Wd=reinsurance+of+common+account&amp;Sj=0"">reinsurance of common account</a></i>"	๒ มี.ค. ๒๕๔๕
reinsurance reserve	เงินสำรองประกันภัยต่อ	๒ มี.ค. ๒๕๔๕
reinsurance treaty	สัญญาประกันภัยต่อ	๒ มี.ค. ๒๕๔๕
reinsurance waiver clause	ข้อกำหนดไม่เปลี่ยนแปลงเบี้ยประกันภัยต่อ	๒ มี.ค. ๒๕๔๕
reinsured	ผู้เอาประกันภัยต่อ	๒ มี.ค. ๒๕๔๕
reinsurer	ผู้รับประกันภัยต่อ	๒ มี.ค. ๒๕๔๕
rejection risk insurance	การประกันภัยปฏิเสธนำเข้า	๒ มี.ค. ๒๕๔๕
relationship clause	ข้อกำหนดสมาชิกในครอบครัว	๒ มี.ค. ๒๕๔๕
release of reserve	เลิกการสำรอง	๒ มี.ค. ๒๕๔๕
remoteness of damage	ความเสียหายไกลกว่าเหตุ	๒ มี.ค. ๒๕๔๕
renewal premium	เบี้ยประกันภัยต่ออายุ	๒ มี.ค. ๒๕๔๕
renewal	การต่ออายุ	๒ มี.ค. ๒๕๔๕
renewal agreement	ข้อตกลงต่ออายุ	๒ มี.ค. ๒๕๔๕
renewal notice	ใบเตือนต่ออายุ	๒ มี.ค. ๒๕๔๕
replacement clause	ข้อกำหนดการเปลี่ยนชิ้นส่วน	๒ มี.ค. ๒๕๔๕
replacement cost insurance	การประกันภัยมูลค่าของใหม่	๒ มี.ค. ๒๕๔๕
replacement in kind	การทดแทนเป็นสิ่งของ	๒ มี.ค. ๒๕๔๕
replacement value	มูลค่าของใหม่	๒ มี.ค. ๒๕๔๕
representation	การแถลงข้อความจริง	๒ มี.ค. ๒๕๔๕
request note	ใบเสนอขอ	๒ มี.ค. ๒๕๔๕
reserve	เงินสำรอง	๒ มี.ค. ๒๕๔๕
reserve account	บัญชีเงินสำรอง	๒ มี.ค. ๒๕๔๕
reserve basis	หลักเงินสำรอง	๒ มี.ค. ๒๕๔๕
residual risks policy	กรมธรรม์ประกันภัยงานตกค้าง	๒ มี.ค. ๒๕๔๕
residual value	มูลค่าตกค้าง	๒ มี.ค. ๒๕๔๕
respondentia	เงินกู้ตัวสินค้า	๒ มี.ค. ๒๕๔๕
restraints	"การหน่วงเหนี่ยว <i>ดู <a href=""/coinages/websearch.php?Wd=arrests&amp;Sj=0"">arrests</a>, <a href=""/coinages/websearch.php?Wd=restraints+and+detainments&amp;Sj=0"">restraints and detainments</a></i>"	๒ มี.ค. ๒๕๔๕
restrictive covenant indemnity	การชดใช้ค่าสินไหมทดแทนกรณีผิดสัญญา	๒ มี.ค. ๒๕๔๕
retained line	ส่วนเก็บไว้	๒ มี.ค. ๒๕๔๕
retention	"ส่วนเก็บไว้ <i>มีความหมายเหมือนกับ <a href=""/coinages/websearch.php?Wd=retained+line&amp;Sj=0"">retained line</a></i>"	๒ มี.ค. ๒๕๔๕
retention bond	กรมธรรม์ค้ำประกันการยึดหน่วง	๒ มี.ค. ๒๕๔๕
retention limits	ขีดจำกัดส่วนเก็บไว้	๒ มี.ค. ๒๕๔๕
retirement income	เงินได้เมื่อเกษียณอายุ	๒ มี.ค. ๒๕๔๕
retirement income policy	"กรมธรรม์แบบเกษียณอายุ <i>มีความหมายเหมือนกับ <a href=""/coinages/websearch.php?Wd=retirement+policy&amp;Sj=0"">retirement policy</a></i>"	๒ มี.ค. ๒๕๔๕
retirement policy	กรมธรรม์แบบเกษียณอายุ	๒ มี.ค. ๒๕๔๕
retirement annuity	เงินรายปีเกษียณอายุ	๒ มี.ค. ๒๕๔๕
retrocedant	ผู้เอาประกันภัยต่อช่วง	๒ มี.ค. ๒๕๔๕
retrocedent	"ผู้เอาประกันภัยต่อช่วง <i>มีความหมายเหมือนกับ <a href=""/coinages/websearch.php?Wd=retrocedant&amp;Sj=0"">retrocedant</a> และ <a href=""/coinages/websearch.php?Wd=retrocessionaire&amp;Sj=0"">retrocessionaire</a></i>"	๒ มี.ค. ๒๕๔๕
retrocession	การประกันภัยต่อช่วง	๒ มี.ค. ๒๕๔๕
retrocessionaire	"ผู้เอาประกันภัยต่อช่วง <i>มีความหมายเหมือนกับ <a href=""/coinages/websearch.php?Wd=retrocedant&amp;Sj=0"">retrocedant</a> และ <a href=""/coinages/websearch.php?Wd=retrocedent&amp;Sj=0"">retrocedent</a></i>"	๒ มี.ค. ๒๕๔๕
retrospective rating	การกำหนดอัตราตามผลย้อนหลัง	๒ มี.ค. ๒๕๔๕
return premium	เบี้ยประกันภัยจ่ายคืน	๒ มี.ค. ๒๕๔๕
return commission	ค่าบำเหน็จจ่ายคืน	๒ มี.ค. ๒๕๔๕
return for no claim	เบี้ยประกันภัยจ่ายคืนเมื่อไม่มีการเรียกร้องค่าสินไหมทดแทน	๒ มี.ค. ๒๕๔๕
revocable beneficiary	ผู้รับประโยชน์เปลี่ยนได้	๒ มี.ค. ๒๕๔๕
reversionary annuity	"<i>ดู <a href=""/coinages/websearch.php?Wd=survivorship+annuity&amp;Sj=0"">survivorship annuity</a></i>"	๒ มี.ค. ๒๕๔๕
reversionary bonus	เงินปันผลเพิ่มพูน	๒ มี.ค. ๒๕๔๕
rider	ข้อกำหนดต่อท้าย	๒ มี.ค. ๒๕๔๕
rider policy	กรมธรรม์ผู้ขับขี่	๒ มี.ค. ๒๕๔๕
risk	ภัย, การเสี่ยงภัย	๒ มี.ค. ๒๕๔๕
risk assessment	การประเมินภัย	๒ มี.ค. ๒๕๔๕
risk assumption	การเข้าเสี่ยงภัย	๒ มี.ค. ๒๕๔๕
risk avoidance	การหลีกเลี่ยงภัย	๒ มี.ค. ๒๕๔๕
risk index	ดัชนีการเสี่ยงภัย	๒ มี.ค. ๒๕๔๕
road risks insurance	การประกันภัยบนถนน	๒ มี.ค. ๒๕๔๕
risk prevention	การป้องกันภัย	๒ มี.ค. ๒๕๔๕
risk transfer	การโอนความเสี่ยงภัย	๒ มี.ค. ๒๕๔๕
rotation clause	ข้อกำหนดหมุนเวียน	๒ มี.ค. ๒๕๔๕
Rules of Practice	กฎวิธีการปฏิบัติ	๒ มี.ค. ๒๕๔๕
run-off liability	ความรับผิดติดพัน	๒ มี.ค. ๒๕๔๕
run-off statement	งบความรับผิดติดพัน	๒ มี.ค. ๒๕๔๕
running down clause	"ข้อกำหนดการชน <i>มีความหมายเหมือนกับ <a href=""/coinages/websearch.php?Wd=collision+clause&amp;Sj=0"">collision clause</a></i>"	๒ มี.ค. ๒๕๔๕
running off	การติดพัน	๒ มี.ค. ๒๕๔๕
sabotage	การก่อวินาศกรรม	๒ มี.ค. ๒๕๔๕
sailing warranty	คำรับรองการเดินเรือ	๒ มี.ค. ๒๕๔๕
salary saving insurance	การประกันชีวิตโดยหักเงินเดือน	๒ มี.ค. ๒๕๔๕
salvor	ผู้กู้ภัย	๒ มี.ค. ๒๕๔๕
salvage and recovery clause	ข้อกำหนดการกู้ภัยและส่วนรับคืน	๒ มี.ค. ๒๕๔๕
salvage charges	ค่ากู้ภัย	๒ มี.ค. ๒๕๔๕
salvage charges clause	ข้อกำหนดค่ากู้ภัย	๒ มี.ค. ๒๕๔๕
salvage corps	หน่วยจัดการซากทรัพย์	๒ มี.ค. ๒๕๔๕
salvage guarantee	การค้ำประกันการกู้ภัย	๒ มี.ค. ๒๕๔๕
salvage loss	ความสูญเสียจากซากทรัพย์	๒ มี.ค. ๒๕๔๕
salvage	๑. การกู้ภัย<br/>๒. ค่ากู้ภัย<br/>๓. ซากทรัพย์	๒ มี.ค. ๒๕๔๕
salvage agreement	ข้อตกลงการกู้ภัย	๒ มี.ค. ๒๕๔๕
schedule	๑. ตารางรายการ<br/>๒. ตารางกรมธรรม์	๒ มี.ค. ๒๕๔๕
schedule policy	กรมธรรม์ตารางรายการ	๒ มี.ค. ๒๕๔๕
schedule rating	การกำหนดอัตราตามตารางรายการ	๒ มี.ค. ๒๕๔๕
scheme	แผน	๒ มี.ค. ๒๕๔๕
scheme charge	ค่าใช้จ่ายสำหรับแผน	๒ มี.ค. ๒๕๔๕
school fees insurance	การประกันชีวิตเพื่อการศึกษา	๒ มี.ค. ๒๕๔๕
seasonal risk	ภัยตามฤดูกาล	๒ มี.ค. ๒๕๔๕
seaworthiness	สภาพพร้อมออกทะเล	๒ มี.ค. ๒๕๔๕
seaworthiness admitted	สภาพพร้อมออกทะเลที่ยอมรับแล้ว	๒ มี.ค. ๒๕๔๕
second leaving	การเสนอครั้งที่สอง	๒ มี.ค. ๒๕๔๕
second loss insurance	การประกันภัยความเสียหายส่วนที่สอง, การประกันภัยความเสียหายส่วนเกิน	๒ มี.ค. ๒๕๔๕
second loss policy	"<i>มีความหมายเหมือนกับ <a href=""/coinages/websearch.php?Wd=excess+of+loss+policy&amp;Sj=0"">excess of loss policy</a></i>"	๒ มี.ค. ๒๕๔๕
second mortgage	การจำนองอันดับถัดไป	๒ มี.ค. ๒๕๔๕
second surplus treaty	สัญญาประกันภัยต่อส่วนเกินชั้นที่สอง	๒ มี.ค. ๒๕๔๕
select mortality table	ตารางมรณวิสัยคัดเลือก	๒ มี.ค. ๒๕๔๕
selection	การคัดเลือก(ภัย)	๒ มี.ค. ๒๕๔๕
selection against the insurer	"การคัดเลือกที่ขัดประโยชน์ <i>มีความหมายเหมือนกับ <a href=""/coinages/websearch.php?Wd=adverse+selection&amp;Sj=0"">adverse selection</a></i>"	๒ มี.ค. ๒๕๔๕
self retention	ส่วนเก็บไว้เอง(การเสี่ยงภัย)	๒ มี.ค. ๒๕๔๕
self-insurance	การประกันภัยตนเอง	๒ มี.ค. ๒๕๔๕
seller’s interest	ส่วนได้เสียของผู้ขาย	๒ มี.ค. ๒๕๔๕
sentimental loss	ความสูญเสียค่าทางใจ	๒ มี.ค. ๒๕๔๕
services rendered policy	กรมธรรม์ผู้ให้บริการ	๒ มี.ค. ๒๕๔๕
settlement	๑. การตกลง<br/>๒. การเลื่อนข้าง	๒ มี.ค. ๒๕๔๕
Settlement of Claims Abroad	การตกลงค่าสินไหมทดแทนในต่างประเทศ	๒ มี.ค. ๒๕๔๕
settlement option	๑. สิทธิเลือกวิธีชดใช้<br/>๒. สิทธิเลือกวิธีรับเงินเอาประกันภัย	๒ มี.ค. ๒๕๔๕
settling agent	ตัวแทนตกลงค่าสินไหมทดแทน	๒ มี.ค. ๒๕๔๕
seven day clause	ข้อกำหนดเจ็ดวัน	๒ มี.ค. ๒๕๔๕
share reinsurance	"การประกันภัยต่อตามส่วน <i>มีความหมายเหมือนกับ <a href=""/coinages/websearch.php?Wd=contributory+reinsurance&amp;Sj=0"">contributory reinsurance</a> และ <a href=""/coinages/websearch.php?Wd=quota+share+reinsurance&amp;Sj=0"">quota share reinsurance</a></i>"	๒ มี.ค. ๒๕๔๕
shareholders’ surplus	เงินส่วนเกินของผู้ถือหุ้น	๒ มี.ค. ๒๕๔๕
shipowner’s liability	ความรับผิดของเจ้าของเรือ	๒ มี.ค. ๒๕๔๕
shock loss reinsurance	"การประกันมหันตภัยต่อ <i>มีความหมายเหมือนกับ <a href=""/coinages/websearch.php?Wd=catastrophe+reinsurance&amp;Sj=0"">catastrophe reinsurance</a></i>"	๒ มี.ค. ๒๕๔๕
short closing	ต่ำกว่าส่วนตกลง	๒ มี.ค. ๒๕๔๕
short delivery	การส่งมอบขาดจำนวน	๒ มี.ค. ๒๕๔๕
short form of indemnity	เอกสารชดใช้ค่าสินไหมทดแทนชั่วคราว	๒ มี.ค. ๒๕๔๕
short interest	ส่วนได้เสียต่ำ	๒ มี.ค. ๒๕๔๕
short period rate	อัตราระยะสั้น	๒ มี.ค. ๒๕๔๕
short rate	"อัตราระยะสั้น <i>มีความหมายเหมือนกับ <a href=""/coinages/websearch.php?Wd=short+period+rate&amp;Sj=0"">short period rate</a> และ <a href=""/coinages/websearch.php?Wd=short+term+rate&amp;Sj=0"">short term rate</a></i>"	๒ มี.ค. ๒๕๔๕
short term insurance	การประกันภัยระยะสั้น	๒ มี.ค. ๒๕๔๕
short term rate	"อัตราระยะสั้น <i>มีความหมายเหมือนกับ <a href=""/coinages/websearch.php?Wd=short+period+rate&amp;Sj=0"">short period rate</a> และ <a href=""/coinages/websearch.php?Wd=short+rate&amp;Sj=0"">short rate</a></i>"	๒ มี.ค. ๒๕๔๕
sickness table	"ตารางความเจ็บป่วย <i>มีความหมายเหมือนกับ <a href=""/coinages/websearch.php?Wd=morbidity+table&amp;Sj=0"">morbidity table</a></i>"	๒ มี.ค. ๒๕๔๕
signer	"สำเนาสลิป <i>มีความหมายเหมือนกับ <a href=""/coinages/websearch.php?Wd=off+slip&amp;Sj=0"">off slip</a> และ <a href=""/coinages/websearch.php?Wd=signing+slip&amp;Sj=0"">signing slip</a></i>"	๒ มี.ค. ๒๕๔๕
signing slip	สำเนาสลิป	๒ มี.ค. ๒๕๔๕
signing table	ตารางผู้รับประกันภัย	๒ มี.ค. ๒๕๔๕
silent risk	ภัยสงบ	๒ มี.ค. ๒๕๔๕
simple risk	ภัยสามัญ	๒ มี.ค. ๒๕๔๕
simultaneous payments clause	ข้อกำหนดการจ่ายพร้อมกัน	๒ มี.ค. ๒๕๔๕
single liability	ความรับผิดเดี่ยว	๒ มี.ค. ๒๕๔๕
single premium	เบี้ยประกันภัยชำระครั้งเดียว	๒ มี.ค. ๒๕๔๕
singleton policy	กรมธรรม์ประกันภัยรายเดี่ยว	๒ มี.ค. ๒๕๔๕
Sister Ship Clause	ข้อกำหนดเรือพี่น้อง	๒ มี.ค. ๒๕๔๕
situation index	ดัชนีสถานที่ตั้ง	๒ มี.ค. ๒๕๔๕
sliding scale commission	คำบำเหน็จนายหน้าอัตราเลื่อน	๒ มี.ค. ๒๕๔๕
sliding scale treaty	สัญญาประกันภัยต่ออัตราเลื่อน	๒ มี.ค. ๒๕๔๕
slip	สลิป	๒ มี.ค. ๒๕๔๕
slip agreement	ข้อตกลงในสลิป	๒ มี.ค. ๒๕๔๕
slip policy	กรมธรรม์สลิป	๒ มี.ค. ๒๕๔๕
small additional or return premiums clause	ข้อกำหนดการเพิ่มหรือคืนเบี้ยประกันภัยจำนวนเล็กน้อย	๒ มี.ค. ๒๕๔๕
smoke damage	ความเสียหายจากควัน	๒ มี.ค. ๒๕๔๕
social insurance	การประกันสังคม	๒ มี.ค. ๒๕๔๕
social security	หลักประกันสังคม	๒ มี.ค. ๒๕๔๕
solvency margin	ส่วนเหลื่อมทรัพย์สินเหนือหนี้สิน	๒ มี.ค. ๒๕๔๕
sound value	มูลค่าไม่เสียหาย	๒ มี.ค. ๒๕๔๕
special acceptance	การรับเป็นกรณีพิเศษ	๒ มี.ค. ๒๕๔๕
special peril	ภัยพิเศษ	๒ มี.ค. ๒๕๔๕
special records clause	ข้อกำหนดพิเศษประสบการณ์ความเสียหาย	๒ มี.ค. ๒๕๔๕
special bonus	"เงินปันผลพิเศษ <i>มีความหมายเหมือนกับ <a href=""/coinages/websearch.php?Wd=extra+dividend&amp;Sj=0"">extra dividend</a></i>"	๒ มี.ค. ๒๕๔๕
special condition of average	เงื่อนไขพิเศษการเฉลี่ย	๒ มี.ค. ๒๕๔๕
specific reinsurance	"การประกันภัยต่อเฉพาะราย <i>มีความหมายเหมือนกับ <a href=""/coinages/websearch.php?Wd=facultative+reinsurance&amp;Sj=0"">facultative reinsurance</a></i>"	๒ มี.ค. ๒๕๔๕
speculative risk	การเสี่ยงภัยเก็งกำไร	๒ มี.ค. ๒๕๔๕
specific exclusion	ข้อจำกัดความคุ้มครองจำเพาะ	๒ มี.ค. ๒๕๔๕
specific insurance	การประกันภัยจำเพาะ	๒ มี.ค. ๒๕๔๕
spendthrift clause	ข้อกำหนดกีดกันความสุรุ่ยสุร่าย	๒ มี.ค. ๒๕๔๕
split risk	ภัยแยกเสี่ยง	๒ มี.ค. ๒๕๔๕
spontaneous combustion	การเผาไหม้เกิดเอง	๒ มี.ค. ๒๕๔๕
spread loss reinsurance	การประกันภัยต่อแบบกระจายค่าเสียหาย	๒ มี.ค. ๒๕๔๕
spread of risk	การกระจายความเสี่ยงภัย	๒ มี.ค. ๒๕๔๕
spreader clause	ข้อกำหนดกระจายการชดใช้	๒ มี.ค. ๒๕๔๕
sprinkler insurance	การประกันภัยหัวกระจายน้ำดับเพลิง	๒ มี.ค. ๒๕๔๕
stabilisation clause	ข้อกำหนดว่าด้วยเสถียรภาพ	๒ มี.ค. ๒๕๔๕
stability clause	"ข้อกำหนดว่าด้วยเสถียรภาพ <i>มีความหมายเหมือนกับ <a href=""/coinages/websearch.php?Wd=stabilisation+clause&amp;Sj=0"">stabilisation clause</a></i>"	๒ มี.ค. ๒๕๔๕
standard fire policy	กรมธรรม์อัคคีภัยมาตรฐาน	๒ มี.ค. ๒๕๔๕
standard form	แบบมาตรฐาน	๒ มี.ค. ๒๕๔๕
standard marine clause	"ข้อกำหนดการประกันภัยทางทะเลมาตรฐาน <i>มีความหมายเหมือนกับ <a href=""/coinages/websearch.php?Wd=Institute+Clauses&amp;Sj=0"">Institute Clauses</a></i>"	๒ มี.ค. ๒๕๔๕
standard of construction	มาตรฐานสิ่งปลูกสร้าง	๒ มี.ค. ๒๕๔๕
standard risk	การเสี่ยงภัยปรกติ	๒ มี.ค. ๒๕๔๕
standard turnover	ยอดขายมาตรฐาน	๒ มี.ค. ๒๕๔๕
standard construction	สิ่งปลูกสร้างมาตรฐาน	๒ มี.ค. ๒๕๔๕
standing charges	ค่าใช้จ่ายคงที่	๒ มี.ค. ๒๕๔๕
statue of frauds	บัญญัติหนังสือสัญญา	๒ มี.ค. ๒๕๔๕
stipulation	ข้อระบุ	๒ มี.ค. ๒๕๔๕
stock company	บริษัทรวมหุ้น	๒ มี.ค. ๒๕๔๕
stock declaration policy	กรมธรรม์แจ้งจำนวนสินค้าคงคลัง	๒ มี.ค. ๒๕๔๕
stop loss reinsurance	การประกันภัยต่อกำหนดค่าเสียหาย	๒ มี.ค. ๒๕๔๕
street book	"<i>มีความหมายเหมือนกับ <a href=""/coinages/websearch.php?Wd=situation+index&amp;Sj=0"">situation index</a></i>"	๒ มี.ค. ๒๕๔๕
street works bond	กรมธรรม์ค้ำประกันงานถนน	๒ มี.ค. ๒๕๔๕
strict liability	ความรับผิดสิ้นเชิง	๒ มี.ค. ๒๕๔๕
sub-agent	ตัวแทนรอง	๒ มี.ค. ๒๕๔๕
subject approval no risk	การรับเสี่ยงภัยขึ้นอยู่กับการยอมรับเงื่อนไข	๒ มี.ค. ๒๕๔๕
subject premium	เบี้ยประกันภัยหลัก	๒ มี.ค. ๒๕๔๕
subject to average	ขึ้นอยู่กับการเฉลี่ยค่าเสียหาย	๒ มี.ค. ๒๕๔๕
subject to survey	ขึ้นอยู่กับการสำรวจ	๒ มี.ค. ๒๕๔๕
subjective risk	ความเสี่ยงภัยเชิงจิตวิสัย	๒ มี.ค. ๒๕๔๕
subscription	ความรับผิดของผู้ลงนามแทน	๒ มี.ค. ๒๕๔๕
subrogation	การสวมสิทธิ์	๒ มี.ค. ๒๕๔๕
subrogation clause	ข้อกำหนดการสวมสิทธิ์	๒ มี.ค. ๒๕๔๕
subrogation form	ใบแบบการสวมสิทธิ์	๒ มี.ค. ๒๕๔๕
subsidence	การเลื่อนทรุด	๒ มี.ค. ๒๕๔๕
substandard risk	การเสี่ยงภัยสูงกว่าปรกติ	๒ มี.ค. ๒๕๔๕
substandard life	ชีวิตต่ำกว่ามาตรฐาน	๒ มี.ค. ๒๕๔๕
Suez Canal Clause	ข้อกำหนดคลองสุเอซ	๒ มี.ค. ๒๕๔๕
sufferance bond	ใบค้ำประกันอนุญาต	๒ มี.ค. ๒๕๔๕
sufferance wharf	ท่าเรืออนุญาต	๒ มี.ค. ๒๕๔๕
sudden and unforeseen damage	ความเสียหายฉับพลันโดยไม่คาดคิด	๒ มี.ค. ๒๕๔๕
sudden death clause	ข้อกำหนดการสิ้นสุดลงทันที	๒ มี.ค. ๒๕๔๕
sue and labour clause	ข้อกำหนดการเรียกค่าเสียหายและปฏิบัติการ	๒ มี.ค. ๒๕๔๕
suicide provision	เงื่อนไขอัตวินิบาตกรรม	๒ มี.ค. ๒๕๔๕
sum insured	เงินเอาประกันภัย	๒ มี.ค. ๒๕๔๕
sums due policy	กรมธรรม์เงินครบกำหนด	๒ มี.ค. ๒๕๔๕
super profit commission	ค่าบำเหน็จกำไรเพิ่มพิเศษ	๒ มี.ค. ๒๕๔๕
supervisory authority	หน่วยงานควบคุมดูแล	๒ มี.ค. ๒๕๔๕
supplemental term insurance	การประกันชีวิตแบบชั่วระยะเวลาเพิ่มเติม	๒ มี.ค. ๒๕๔๕
supplementary accident insurance	การประกันภัยอุบัติเหตุเพิ่ม	๒ มี.ค. ๒๕๔๕
supplementary call	เบี้ยพีแอนด์ไอเพิ่ม	๒ มี.ค. ๒๕๔๕
supply bond	กรมธรรม์ค้ำประกันการจัดหา	๒ มี.ค. ๒๕๔๕
surety company	บริษัทประกันภัยค้ำประกัน	๒ มี.ค. ๒๕๔๕
suraty; surety	ผู้รับประกันภัยค้ำประกัน	๒ มี.ค. ๒๕๔๕
surplus line	ส่วนรับประกันภัยส่วนเกิน	๒ มี.ค. ๒๕๔๕
surplus reinsurance	การประกันภัยต่อแบบส่วนเกิน	๒ มี.ค. ๒๕๔๕
surplus treaty	สัญญาประกันภัยต่อแบบส่วนเกิน	๒ มี.ค. ๒๕๔๕
surplus	เงินส่วนเกิน	๒ มี.ค. ๒๕๔๕
surrender of bonuses	การเวนคืนเงินปันผล	๒ มี.ค. ๒๕๔๕
surrender value	"มูลค่าเวนคืนกรมธรรม์ประกันชีวิต <i>ดู <a href=""/coinages/websearch.php?Wd=cash+value&amp;Sj=0"">cash value</a></i>"	๒ มี.ค. ๒๕๔๕
surveyor	ผู้สำรวจ	๒ มี.ค. ๒๕๔๕
surveyor’s report	รายงานของผู้สำรวจ	๒ มี.ค. ๒๕๔๕
survival certificate	ใบรับรองการทรงชีพ	๒ มี.ค. ๒๕๔๕
survivorship annuity	เงินรายปีสำหรับผู้มีชีวิต	๒ มี.ค. ๒๕๔๕
sympathetic damage	ความเสียหายจากผลกระทบ	๒ มี.ค. ๒๕๔๕
Syndicate	คณะผู้ร่วม(รับประกันภัย)	๒ มี.ค. ๒๕๔๕
Syndicate List	บัญชีรายชื่อคณะผู้ร่วม(รับประกันภัย)	๒ มี.ค. ๒๕๔๕
table of limits	ตารางขีดจำกัด	๒ มี.ค. ๒๕๔๕
tacit renewal clause	ข้อกำหนดการต่ออายุกรมธรรม์โดยนัย	๒ มี.ค. ๒๕๔๕
take note	ใบสนองรับ	๒ มี.ค. ๒๕๔๕
target risk	ภัยเป้าหมาย	๒ มี.ค. ๒๕๔๕
tariff company	บริษัทใช้พิกัดอัตรา	๒ มี.ค. ๒๕๔๕
tariff rate	อัตราตามพิกัดอัตรา	๒ มี.ค. ๒๕๔๕
tax clause	ข้อกำหนดภาษีเบี้ยประกันภัย	๒ มี.ค. ๒๕๔๕
technical reserves	เงินสำรองทางเทคนิค	๒ มี.ค. ๒๕๔๕
temporary life annuity	เงินรายปีชั่วคราว	๒ มี.ค. ๒๕๔๕
temporary life assurance	การประกันชีวิตชั่วคราว	๒ มี.ค. ๒๕๔๕
temporary removal clause	ข้อกำหนดการเคลื่อนย้ายชั่วคราว	๒ มี.ค. ๒๕๔๕
temporary disablement	ทุพพลภาพชั่วคราว	๒ มี.ค. ๒๕๔๕
temporary importation bond	กรมธรรม์ค้ำประกันการนำเข้าชั่วคราว	๒ มี.ค. ๒๕๔๕
tenant’s liability	ความรับผิดของผู้เช่า	๒ มี.ค. ๒๕๔๕
tender bond	"กรมธรรม์ค้ำประกันการประมูล <i>มีความหมายเหมือนกับ <a href=""/coinages/websearch.php?Wd=bid+bond&amp;Sj=0"">bid bond</a></i>"	๒ มี.ค. ๒๕๔๕
tender clause	ข้อกำหนดการประมูล	๒ มี.ค. ๒๕๔๕
terminal dividend	เงินปันผลจ่ายเมื่อสัญญาสิ้นสุด	๒ มี.ค. ๒๕๔๕
term insurance	การประกันชีวิตแบบชั่วระยะเวลา	๒ มี.ค. ๒๕๔๕
termination of adventure	การสิ้นสุดการเสี่ยงภัย	๒ มี.ค. ๒๕๔๕
termination of adventure clause	ข้อกำหนดการสิ้นสุดการเสี่ยงภัย	๒ มี.ค. ๒๕๔๕
testator	ผู้ทำพินัยกรรม	๒ มี.ค. ๒๕๔๕
testate	มรดกมีพินัยกรรม	๒ มี.ค. ๒๕๔๕
theft insurance	การประกันภัยโจรกรรม	๒ มี.ค. ๒๕๔๕
third party	บุคคลภายนอก	๒ มี.ค. ๒๕๔๕
third party insurance	การประกันภัยความรับผิดต่อบุคคลภายนอก	๒ มี.ค. ๒๕๔๕
third party liability insurance	"การประกันภัยความรับผิดต่อบุคคลภายนอก <i>มีความหมายเหมือนกับ <a href=""/coinages/websearch.php?Wd=third+party+insurance&amp;Sj=0"">third party insurance</a></i>"	๒ มี.ค. ๒๕๔๕
third party only policy	กรมธรรม์ความรับผิดเฉพาะบุคคลภายนอก	๒ มี.ค. ๒๕๔๕
three-year accounting	บัญชีสามปี	๒ มี.ค. ๒๕๔๕
“three years’ average” system	ระบบเฉลี่ยสามปี	๒ มี.ค. ๒๕๔๕
ticket policy	กรมธรรม์แบบตั๋ว	๒ มี.ค. ๒๕๔๕
time excess	ช่วงเวลารับผิดส่วนแรก	๒ มี.ค. ๒๕๔๕
time policy	กรมธรรม์แบบกำหนดเวลา	๒ มี.ค. ๒๕๔๕
title insurance	การประกันภัยกรรมสิทธิ์	๒ มี.ค. ๒๕๔๕
to pay as cargo	จ่ายตามสินค้า	๒ มี.ค. ๒๕๔๕
tonner policy	๑. กรมธรรม์จำกัดระวางเรือ<br/>๒. กรมธรรม์จำกัดผู้ตาย	๒ มี.ค. ๒๕๔๕
tontine bonus	เงินปันผลรอจ่าย	๒ มี.ค. ๒๕๔๕
total disablement	ทุพพลภาพสิ้นเชิง	๒ มี.ค. ๒๕๔๕
total loss	ความเสียหายสิ้นเชิง	๒ มี.ค. ๒๕๔๕
total loss of part	ความเสียหายสิ้นเชิงเฉพาะส่วน	๒ มี.ค. ๒๕๔๕
total loss of vessel only	ความเสียหายสิ้นเชิงของตัวเรือเท่านั้น	๒ มี.ค. ๒๕๔๕
total loss only	ความเสียหายสิ้นเชิงเท่านั้น	๒ มี.ค. ๒๕๔๕
total loss only reinsurance clause	"ข้อกำหนดการประกันภัยต่อความเสียหายสิ้นเชิงเท่านั้น <i>มีความหมายเหมือนกับ <a href=""/coinages/websearch.php?Wd=total+loss+only&amp;Sj=0"">total loss only</a></i>"	๒ มี.ค. ๒๕๔๕
touch and stay	การแวะพัก	๒ มี.ค. ๒๕๔๕
tourist floater	กรมธรรม์ลอยตัวของผู้เดินทาง	๒ มี.ค. ๒๕๔๕
Tow and Assist Clause	ข้อกำหนดการลากจูงและช่วยเหลือ	๒ มี.ค. ๒๕๔๕
trading warranties	คำรับรองเขตเส้นทาง	๒ มี.ค. ๒๕๔๕
transfer of portfolio	"การโอนยอดรวม <i>มีความหมายเหมือนกับ <a href=""/coinages/websearch.php?Wd=portfolio+transfer&amp;Sj=0"">portfolio transfer</a></i>"	๒ มี.ค. ๒๕๔๕
transit clause	ข้อกำหนดระหว่างการเดินทาง	๒ มี.ค. ๒๕๔๕
treaty	"สัญญาประกันภัยต่อ <i>มีความหมายเหมือนกับ <a href=""/coinages/websearch.php?Wd=reinsurance+treaty&amp;Sj=0"">reinsurance treaty</a></i>"	๒ มี.ค. ๒๕๔๕
treaty reinsurance	การประกันภัยต่อตามสัญญา	๒ มี.ค. ๒๕๔๕
trustee	ทรัสตี	๒ มี.ค. ๒๕๔๕
trust	ทรัสต์	๒ มี.ค. ๒๕๔๕
trust agreement	ข้อตกลงทรัสต์	๒ มี.ค. ๒๕๔๕
trust deed	หนังสือก่อตั้งทรัสต์	๒ มี.ค. ๒๕๔๕
tsunami	คลื่นสึนามิ	๑๐ ม.ค. ๒๕๔๘
twenty-four hours clause	ข้อกำหนด ๒๔ ชั่วโมง	๒ มี.ค. ๒๕๔๕
twisting	การบิดเบือน	๒ มี.ค. ๒๕๔๕
two plane warranty	คำรับรองเครื่องบิน ๒ ลำ	๒ มี.ค. ๒๕๔๕
two rig warranty	คำรับรองแท่นเจาะ ๒ แท่น	๒ มี.ค. ๒๕๔๕
two risks warranty	คำรับรองภัย ๒ ราย	๒ มี.ค. ๒๕๔๕
two vessel warranty	คำรับรองเรือ ๒ ลำ	๒ มี.ค. ๒๕๔๕
uberrima fides	"ความสุจริตใจอย่างยิ่ง <i>มีความหมายเหมือนกับ <a href=""/coinages/websearch.php?Wd=utmost+good+faith&amp;Sj=0"">utmost good faith</a></i>"	๒ มี.ค. ๒๕๔๕
ultimate net loss	ความเสียหายสุทธิขั้นสุดท้าย	๒ มี.ค. ๒๕๔๕
umbrella cover	ความคุ้มครองแบบครอบคลุม	๒ มี.ค. ๒๕๔๕
umbrella liability policy	"กรมธรรม์ความรับผิดแบบครอบคลุม <i>มีความหมายเหมือนกับ <a href=""/coinages/websearch.php?Wd=umbrella+cover&amp;Sj=0"">umbrella cover</a> ความหมายที่ ๑</i>"	๒ มี.ค. ๒๕๔๕
unassigned surplus	เงินส่วนเกินยังมิได้จัดสรร	๒ มี.ค. ๒๕๔๕
underlying insurance	การประกันภัยรองรับ	๒ มี.ค. ๒๕๔๕
underlying premium	"เบี้ยประกันภัยรองรับ <i>มีความหมายเหมือนกับ <a href=""/coinages/websearch.php?Wd=base+premium&amp;Sj=0"">base premium</a></i>"	๒ มี.ค. ๒๕๔๕
under-average risk	ภัยต่ำกว่าเกณฑ์เฉลี่ย	๒ มี.ค. ๒๕๔๕
under-insurance	การประกันภัยต่ำกว่ามูลค่า	๒ มี.ค. ๒๕๔๕
underwriting and claims control clause	ข้อกำหนดการควบคุมการรับประกันภัยและการเรียกร้องค่าสินไหมทดแทน	๒ มี.ค. ๒๕๔๕
underwriting cover	"ความคุ้มครองการรับประกันภัย <i>มีความหมายเหมือนกับ <a href=""/coinages/websearch.php?Wd=working+cover&amp;Sj=0"">working cover</a></i>"	๒ มี.ค. ๒๕๔๕
underwriting profit	กำไรจากการรับประกันภัย	๒ มี.ค. ๒๕๔๕
undervalued policy	กรมธรรม์ประกันภัยต่ำกว่ามูลค่า	๒ มี.ค. ๒๕๔๕
underwriter	"๑. ผู้รับประกันภัย <i>ดู <a href=""/coinages/websearch.php?Wd=assurer&amp;Sj=0"">assurer</a>; <a href=""/coinages/websearch.php?Wd=carrier&amp;Sj=0"">carrier</a> และ <a href=""/coinages/websearch.php?Wd=insurer&amp;Sj=0"">insurer</a></i><br/>๒. ผู้พิจารณาการรับประกันภัย"	๒ มี.ค. ๒๕๔๕
underwriting	การรับประกันภัย	๒ มี.ค. ๒๕๔๕
underwriting agent	ตัวแทนรับประกันภัย	๒ มี.ค. ๒๕๔๕
unearned premium	เบี้ยประกันภัยที่ยังไม่ถือเป็นรายได้	๒ มี.ค. ๒๕๔๕
unearned premium insurance	การประกันภัยเบี้ยประกันภัยที่ยังไม่ถือเป็นรายได้	๒ มี.ค. ๒๕๔๕
unearned premium reserve	เงินสำรองเบี้ยประกันภัยที่ยังไม่ถือเป็นรายได้	๒ มี.ค. ๒๕๔๕
unexpired risks reserve	"เงินสำรองการเสี่ยงภัยที่ยังไม่สิ้นสุด <i>มีความหมายเหมือนกับ <a href=""/coinages/websearch.php?Wd=unearned+premium+reserve&amp;Sj=0"">unearned premium reserve</a></i>"	๒ มี.ค. ๒๕๔๕
unfair competition and practice	การแข่งขันและปฏิบัติที่ไม่เป็นธรรม	๒ มี.ค. ๒๕๔๕
unfunded trust	ทรัสต์ที่ไม่ตั้งกองทุน	๒ มี.ค. ๒๕๔๕
Uninsured Standing Charges clause	ข้อกำหนดค่าใช้จ่ายคงที่ที่ไม่ได้เอาประกันภัย	๒ มี.ค. ๒๕๔๕
uninsured working expenses	ค่าใช้จ่ายที่ไม่ได้เอาประกันภัย	๒ มี.ค. ๒๕๔๕
uninsurable risk	ภัยที่ไม่อาจเอาประกันภัย	๒ มี.ค. ๒๕๔๕
unilateral contract	สัญญาผูกพันฝ่ายเดียว	๒ มี.ค. ๒๕๔๕
unless caused by	เว้นแต่เกิดจาก	๒ มี.ค. ๒๕๔๕
unless general	เว้นแต่ความเสียหายร่วม	๒ มี.ค. ๒๕๔๕
unvalued policy	กรมธรรม์แบบไม่ได้กำหนดมูลค่า	๒ มี.ค. ๒๕๔๕
Up and Down clause	"ข้อกำหนดการปรับค่า <i>มีความหมายเหมือนกับ <a href=""/coinages/websearch.php?Wd=escalator+clause&amp;Sj=0"">escalator clause</a></i>"	๒ มี.ค. ๒๕๔๕
utmost good faith	ความสุจริตใจอย่างยิ่ง	๒ มี.ค. ๒๕๔๕
valuation	การประเมินค่า	๒ มี.ค. ๒๕๔๕
Valuation Clause	ข้อกำหนดการกำหนดมูลค่า	๒ มี.ค. ๒๕๔๕
valuation linked scheme	แผนประสานเพื่อกำหนดมูลค่า	๒ มี.ค. ๒๕๔๕
valued as original	มีมูลค่าตามกรมธรรม์เดิม	๒ มี.ค. ๒๕๔๕
valued policy	กรมธรรม์แบบกำหนดมูลค่า	๒ มี.ค. ๒๕๔๕
values at risk	มูลค่าเสี่ยงภัย	๒ มี.ค. ๒๕๔๕
values policy	กรมธรรม์แบบระบุมูลค่าสินไหมทดแทน	๒ มี.ค. ๒๕๔๕
Value Added Tax cover	ความคุ้มครองภาษีมูลค่าเพิ่ม	๒ มี.ค. ๒๕๔๕
variable annuity	เงินรายปีแบบเปลี่ยนแปรได้	๒ มี.ค. ๒๕๔๕
vending machine insurance	การประกันภัยตู้ขายสินค้าแบบหยอดเหรียญ	๒ มี.ค. ๒๕๔๕
vesting	สิทธิพึงได้	๒ มี.ค. ๒๕๔๕
violent and forcible means	"วิธีใช้กำลังและความรุนแรง <i>มีความหมายเหมือนกับ <a href=""/coinages/websearch.php?Wd=forcible+and+violent+means&amp;Sj=0"">forcible and violent means</a></i>"	๒ มี.ค. ๒๕๔๕
vis major	"เหตุสุดวิสัย <i>มีความหมายเหมือนกับ <a href=""/coinages/websearch.php?Wd=force+majeure&amp;Sj=0"">force majeure</a></i>"	๒ มี.ค. ๒๕๔๕
voluntary excess	การรับผิดส่วนแรกโดยสมัครใจ	๒ มี.ค. ๒๕๔๕
voyage policy	กรมธรรม์แบบเที่ยวเดินทาง	๒ มี.ค. ๒๕๔๕
wagering contract	สัญญาการพนันขันต่อ	๒ มี.ค. ๒๕๔๕
wages declaration	การแจ้งค่าแรง	๒ มี.ค. ๒๕๔๕
waiting period	ระยะไม่คุ้มครอง	๒ มี.ค. ๒๕๔๕
waiver	การสละสิทธิ์	๒ มี.ค. ๒๕๔๕
waiver clause	ข้อกำหนดการสละสิทธิ์	๒ มี.ค. ๒๕๔๕
waiver of premium disability benefit	การยกเว้นเบี้ยประกันภัยเพราะทุพพลภาพ	๒ มี.ค. ๒๕๔๕
war clause	ข้อกำหนดภัยสงคราม	๒ มี.ค. ๒๕๔๕
war perils	ภัยสงคราม	๒ มี.ค. ๒๕๔๕
war exclusion clause	ข้อกำหนดการยกเว้นภัยสงคราม	๒ มี.ค. ๒๕๔๕
war risk cancellation	การยกเลิกการเสี่ยงภัยสงคราม	๒ มี.ค. ๒๕๔๕
war risk insurance	การประกันภัยสงคราม	๒ มี.ค. ๒๕๔๕
war risks agreement	ข้อตกลงการเสี่ยงภัยสงคราม	๒ มี.ค. ๒๕๔๕
warranted free from particular average	โดยไม่คุ้มครองความเสียหายเฉพาะ	๒ มี.ค. ๒๕๔๕
warranty	คำรับรอง	๒ มี.ค. ๒๕๔๕
warehouse bond	กรมธรรม์ค้ำประกันคลังสินค้า	๒ มี.ค. ๒๕๔๕
warehouse risk	การเสี่ยงภัยคลังสินค้า	๒ มี.ค. ๒๕๔๕
water damage insurance	การประกันภัยความเสียหายจากน้ำ	๒ มี.ค. ๒๕๔๕
waterborne Agreement	ข้อตกลงคุ้มครองบนพื้นน้ำ	๒ มี.ค. ๒๕๔๕
wear and tear	การสึกหรอ	๒ มี.ค. ๒๕๔๕
weather insurance	การประกันภัยสภาพลมฟ้าอากาศ	๒ มี.ค. ๒๕๔๕
weekly premium increase	เบี้ยประกันภัยเพิ่มรายสัปดาห์	๒ มี.ค. ๒๕๔๕
weekly premium insurance	"<i>มีความหมายเหมือนกับ <a href=""/coinages/websearch.php?Wd=industrial+insurance&amp;Sj=0"">industrial insurance</a></i>"	๒ มี.ค. ๒๕๔๕
weight and height table	ตารางน้ำหนักและส่วนสูง	๒ มี.ค. ๒๕๔๕
whole account treaty	สัญญาประกันภัยต่อคุ้มครองทั้งประเภท	๒ มี.ค. ๒๕๔๕
widow’s annuity	เงินรายปีหญิงม่าย	๒ มี.ค. ๒๕๔๕
widow’s benefits	ผลประโยชน์หญิงม่าย	๒ มี.ค. ๒๕๔๕
widow’s life income	เงินได้หญิงม่าย	๒ มี.ค. ๒๕๔๕
whole turnover insurance	การประกันภัยยอดรวมธุรกิจ	๒ มี.ค. ๒๕๔๕
will	พินัยกรรม	๒ มี.ค. ๒๕๔๕
wilful misconduct	ความประพฤติผิดโดยจงใจ	๒ มี.ค. ๒๕๔๕
with average	โดยคุ้มครองความเสียหายเฉพาะ	๒ มี.ค. ๒๕๔๕
with profits policy	"กรมธรรม์ร่วมกำไร <i>มีความหมายเหมือนกับ <a href=""/coinages/websearch.php?Wd=participating+policy&amp;Sj=0"">participating policy</a></i>"	๒ มี.ค. ๒๕๔๕
with proportion	ตามสัดส่วน	๒ มี.ค. ๒๕๔๕
without profits policy	"กรมธรรม์ไม่ได้ร่วมกำไร <i>มีความหมายเหมือนกับ <a href=""/coinages/websearch.php?Wd=non-participating+policy&amp;Sj=0"">non-participating policy</a></i>"	๒ มี.ค. ๒๕๔๕
without proportion	ไม่มีส่วนได้	๒ มี.ค. ๒๕๔๕
work in progress cover	ความคุ้มครองงานที่ดำเนินอยู่	๒ มี.ค. ๒๕๔๕
working cover	ความคุ้มครองช่วงชั้นปรกติ	๒ มี.ค. ๒๕๔๕
working layer	ช่วงชั้นปรกติ	๒ มี.ค. ๒๕๔๕
workmen’s clause	ข้อกำหนดคนงาน	๒ มี.ค. ๒๕๔๕
World to World	ทั่วโลก	๒ มี.ค. ๒๕๔๕
wrap-up insurance	"การประกันภัยรวมผู้เกี่ยวข้อง <i>มีความหมายเหมือนกับ <a href=""/coinages/websearch.php?Wd=omnibus+insurance&amp;Sj=0"">omnibus insurance</a></i>"	๒ มี.ค. ๒๕๔๕
written line	ส่วนที่รับประกันภัย	๒ มี.ค. ๒๕๔๕
written premiums	เบี้ยประกันภัยรับ	๒ มี.ค. ๒๕๔๕
written-paid basis	หลักรับจ่าย	๒ มี.ค. ๒๕๔๕
year free of premium	ปีปลอดเบี้ยประกันภัย	๒ มี.ค. ๒๕๔๕
yacht insurance	การประกันภัยเรือยอช์ต	๒ มี.ค. ๒๕๔๕
York-Antwerp Rules	กฎยอร์ก-แอนต์เวิร์ป	๒ มี.ค. ๒๕๔๕
Zillmerisation	วิธีของซิลล์เมอร์	๒ มี.ค. ๒๕๔๕
zoning	การแบ่งเขตรับประกันภัย	๒ มี.ค. ๒๕๔๕
ลักษณะการใช้อาคาร	occupancy	๒ มี.ค. ๒๕๔๕
ไม่มีส่วนได้	without proportion	๒ มี.ค. ๒๕๔๕
ไม่ใช่ทางทะเล	non-marine	๒ มี.ค. ๒๕๔๕
ไม่สำเร็จไม่จ่าย	no cure no pay	๒ มี.ค. ๒๕๔๕
ไม่ได้มาตรฐาน	non-standard	๒ มี.ค. ๒๕๔๕
ไอแอลยู (สถาบันผู้รับประกันภัยแห่งลอนดอน)	"Institute of London Underwriter (<a href=""/coinages/websearch.php?Wd=I.L.U.&amp;Sj=0"">I.L.U.</a>)"	๒ มี.ค. ๒๕๔๕
ไอบีเอ็นอาร์ (เกิดแล้วยังไม่รายงาน)	"I.B.N.R. (<a href=""/coinages/websearch.php?Wd=incurred+but+not+reported&amp;Sj=0"">incurred but not reported </a>)"	๒ มี.ค. ๒๕๔๕
ไฟ	fire	๒ มี.ค. ๒๕๔๕
กรมธรรม์แม่	master policy	๒ มี.ค. ๒๕๔๕
กรมธรรม์รวม	combination policy	๒ มี.ค. ๒๕๔๕
กรมธรรม์ร่วม	"collective policy; <a href=""/coinages/websearch.php?Wd=combined+policy&amp;Sj=0"">combined policy</a>"	๒ มี.ค. ๒๕๔๕
กรมธรรม์ร่วมกำไร	with profits policy	๒ มี.ค. ๒๕๔๕
กรมธรรม์ยอมรับส่วนได้เสีย	policy proof of interest	๒ มี.ค. ๒๕๔๕
กรมธรรม์ภัยรวม	package policy	๒ มี.ค. ๒๕๔๕
กรมธรรม์ภัยผสม	hybrid policy	๒ มี.ค. ๒๕๔๕
กรมธรรม์รับรองเงินปันผล	guaranteed dividend policy	๒ มี.ค. ๒๕๔๕
กรมธรรม์มูลค่าส่วนเกิน	"excess value policy; <a href=""/coinages/websearch.php?Wd=increased+value+and+excess+liabilities+policy&amp;Sj=0"">increased value and excess liabilities policy</a>"	๒ มี.ค. ๒๕๔๕
กรมธรรม์เงินครบกำหนด	sums due policy	๒ มี.ค. ๒๕๔๕
กรมธรรม์แจ้งจำนวนสินค้าคงคลัง	stock declaration policy	๒ มี.ค. ๒๕๔๕
กรมธรรม์ใช้เงินสำเร็จ	paid-up policy	๒ มี.ค. ๒๕๔๕
กรมธรรม์เบ็ดเสร็จ	block policy	๒ มี.ค. ๒๕๔๕
กรมธรรม์เบ็ดเสร็จคุ้มครองผู้ค้าอัญมณี	jeweller’s block policy	๒ มี.ค. ๒๕๔๕
กรมธรรม์แบบระบุมูลค่าสินไหมทดแทน	values policy	๒ มี.ค. ๒๕๔๕
กรมธรรม์แบบระบุชื่อเรือ	named policy	๒ มี.ค. ๒๕๔๕
กรมธรรม์แบบร่วมชีวิต	joint-life policy	๒ มี.ค. ๒๕๔๕
กรมธรรม์แบบเกษียณอายุ	"retirement income policy; <a href=""/coinages/websearch.php?Wd=retirement+policy&amp;Sj=0"">retirement policy</a>"	๒ มี.ค. ๒๕๔๕
กรมธรรม์แบบเงินรายปีร่วม	joint-life annuity	๒ มี.ค. ๒๕๔๕
กรมธรรม์แบบเงินรายปีรุ่มปุนชีพ	joint life and survivorship annuity	๒ มี.ค. ๒๕๔๕
กรมธรรม์แบบเที่ยวเดินทาง	voyage policy	๒ มี.ค. ๒๕๔๕
กรมธรรม์แบบเบี้ยประกันภัยลด	reduced premium policy	๒ มี.ค. ๒๕๔๕
กรมธรรม์แบบไม่ได้กำหนดมูลค่า	unavlued policy	๒ มี.ค. ๒๕๔๕
กรมธรรม์แบบกำหนดเวลา	"period policy; <a href=""/coinages/websearch.php?Wd=time+policy&amp;Sj=0"">time policy</a>"	๒ มี.ค. ๒๕๔๕
กรมธรรม์เพื่อค้ำจุนครอบครัว	family maintenance contract	๒ มี.ค. ๒๕๔๕
กรมธรรม์หมู่	collective policy	๒ มี.ค. ๒๕๔๕
กรมธรรม์หมู่ยานพาหนะ	fleet policy	๒ มี.ค. ๒๕๔๕
กรมธรรม์สมบูรณ์แบบ	comprehensive policy	๒ มี.ค. ๒๕๔๕
กรมธรรม์ห้ามการบอกเลิก	non-cancellable policy	๒ มี.ค. ๒๕๔๕
กรมธรรม์สามัญรายเดือน	monthly debit ordinary	๒ มี.ค. ๒๕๔๕
กรมธรรม์สลิป	slip policy	๒ มี.ค. ๒๕๔๕
กรมธรรม์อัคคีภัยมาตรฐาน	standard fire policy	๒ มี.ค. ๒๕๔๕
กรมธรรม์ลอยตัว	"floated; <a href=""/coinages/websearch.php?Wd=floating+policy&amp;Sj=0"">floating policy</a>"	๒ มี.ค. ๒๕๔๕
กรมธรรม์ลอยตัวของผู้เดินทาง	tourist floated	๒ มี.ค. ๒๕๔๕
กรมธรรม์แบบกำหนดมูลค่า	"agreed value policy; <a href=""/coinages/websearch.php?Wd=valued+policy&amp;Sj=0"">valued policy</a>"	๒ มี.ค. ๒๕๔๕
กรมธรรม์แบบคุ้มครองทั้งครอบครัว	family plan policy	๒ มี.ค. ๒๕๔๕
กรมธรรม์แบบตั๋ว	ticket policy	๒ มี.ค. ๒๕๔๕
กรมธรรม์แบบประสม	intermediate policy	๒ มี.ค. ๒๕๔๕
กรมธรรม์เปิด	open policy	๒ มี.ค. ๒๕๔๕
กรมธรรม์แปลงอัตรา	modified life	๒ มี.ค. ๒๕๔๕
กรมธรรม์เพิ่มเงินปันผล	bonus reinforcement policy	๒ มี.ค. ๒๕๔๕
กรมธรรม์เพื่อรายได้ครอบครัว	family income contract	๒ มี.ค. ๒๕๔๕
กรมธรรม์ไม่ได้ร่วมกำไร	without profits policy	๒ มี.ค. ๒๕๔๕
กรมธรรม์กำหนดผลประโยชน์	benefit policy	๒ มี.ค. ๒๕๔๕
กรมธรรม์กลุ่มแบบเงินรายปี	group annuity	๒ มี.ค. ๒๕๔๕
กรมธรรม์ความเสียหายส่วนเกิน	excess of loss policy	๒ มี.ค. ๒๕๔๕
กรมธรรม์ความรับผิดรวม	combined liability policy	๒ มี.ค. ๒๕๔๕
กรมธรรม์ความรับผิดเฉพาะบุคคลภายนอก	third party only policy	๒ มี.ค. ๒๕๔๕
กรมธรรม์ความรับผิดแบบครอบคลุม	umbrella liability policy	๒ มี.ค. ๒๕๔๕
กรมธรรม์ค้ำประกัน	bond	๒ มี.ค. ๒๕๔๕
กรมธรรม์ค้ำประกันเงินได้	income bond	๒ มี.ค. ๒๕๔๕
กรมธรรม์ค้ำประกันศุลกากรและอากรสรรพสามิต	Customs and Excise bonds	๒ มี.ค. ๒๕๔๕
กรมธรรม์ค้ำประกันการเสร็จสมบูรณ์	completion bond	๒ มี.ค. ๒๕๔๕
กรมธรรม์ค้ำประกันการรับเหมา	performance bond	๒ มี.ค. ๒๕๔๕
กรมธรรม์ค้ำประกันการยึดหน่วง	retention bond	๒ มี.ค. ๒๕๔๕
กรมธรรม์ค้ำประกันการจ่ายเงินล่วงหน้า	advance payments bond	๒ มี.ค. ๒๕๔๕
กรมธรรม์ค้ำประกันการจัดการมรดก	administration bound	๒ มี.ค. ๒๕๔๕
กรมธรรม์ค้ำประกันการนำเข้าชั่วคราว	temporary importation bond	๒ มี.ค. ๒๕๔๕
กรมธรรม์ค้ำประกันการประมูล	"bid bond; <a href=""/coinages/websearch.php?Wd=tender+bond&amp;Sj=0"">tender bond</a>"	๒ มี.ค. ๒๕๔๕
กรมธรรม์ค้ำประกันความเสียหาย	"average bond; <a href=""/coinages/websearch.php?Wd=general+average+bond&amp;Sj=0"">general average bond</a>"	๒ มี.ค. ๒๕๔๕
กรมธรรม์ค้ำประกันคลังสินค้า	warehouse bond	๒ มี.ค. ๒๕๔๕
กรมธรรม์ค้ำประกันงานถนน	street works bond	๒ มี.ค. ๒๕๔๕
กรมธรรม์ค้ำประกันตำแหน่ง	positions bond	๒ มี.ค. ๒๕๔๕
กรมธรรม์ค้ำประกันผู้ชำระบัญชี	liquidator’s bond	๒ มี.ค. ๒๕๔๕
กรมธรรม์ค้ำประกันผู้ต้องหา	bail bond	๒ มี.ค. ๒๕๔๕
กรมธรรม์คุ้มครองรวม	"blanket policy; <a href=""/coinages/websearch.php?Wd=global+policy&amp;Sj=0"">global policy</a>"	๒ มี.ค. ๒๕๔๕
กรมธรรม์คุ้มครองการเลิกล้ม	abandonment policy	๒ มี.ค. ๒๕๔๕
กรมธรรม์คุ้มครองความต่างกันของเงื่อนไข	difference in conditions policy	๒ มี.ค. ๒๕๔๕
กรมธรรม์บริษัทร่วม	combined company policy	๒ มี.ค. ๒๕๔๕
กรมธรรม์บริจาค	donor policy	๒ มี.ค. ๒๕๔๕
กรมธรรม์ประกันภัย	policy	๒ มี.ค. ๒๕๔๕
กรมธรรม์ประกันภัยรายเดี่ยว	singleton policy	๒ มี.ค. ๒๕๔๕
กรมธรรม์ประกันภัยงานตกค้าง	residual risks policy	๒ มี.ค. ๒๕๔๕
กรมธรรม์ประกันภัยต่ำกว่ามูลค่า	undervalues policy	๒ มี.ค. ๒๕๔๕
กรมธรรม์ประกันการจัดหา	supply bond	๒ มี.ค. ๒๕๔๕
กรมธรรม์จ่ายเงินได้ประจำปี	income policy	๒ มี.ค. ๒๕๔๕
กรมธรรม์จ่ายผู้ถือ	bearer policy	๒ มี.ค. ๒๕๔๕
กรมธรรม์จำกัดเวลาชำระเบี้ยประกันภัย	limited payment policy	๒ มี.ค. ๒๕๔๕
กรมธรรม์จำกัดระวางเรือ	tonner policy	๒ มี.ค. ๒๕๔๕
กรมธรรม์จำกัดผู้ตาย	tonner policy	๒ มี.ค. ๒๕๔๕
กรมธรรม์ชนิดมีเงินปันผล	participating policy	๒ มี.ค. ๒๕๔๕
กรมธรรม์ชนิดไม่มีเงินปันผล	non-participating policy	๒ มี.ค. ๒๕๔๕
กรมธรรม์ชนิดคูปอง	coupon policy	๒ มี.ค. ๒๕๔๕
กรมธรรม์ด้วยเกียรติ	honour policy	๒ มี.ค. ๒๕๔๕
กรมธรรม์ตารางรายการ	schedule policy	๒ มี.ค. ๒๕๔๕
กรมธรรม์ประกันชีวิตแบบสามัญ	ordinary life policy	๒ มี.ค. ๒๕๔๕
กรมธรรม์ปลอดการร่วมเฉลี่ยค่าเสียหาย	non-average policy	๒ มี.ค. ๒๕๔๕
กรมธรรม์ผสม	mixed policy	๒ มี.ค. ๒๕๔๕
กรมธรรม์ผู้ให้บริการ	services rendered policy	๒ มี.ค. ๒๕๔๕
กรมธรรม์ผู้ขับขี่	rider policy	๒ มี.ค. ๒๕๔๕
กรมธรรม์พีแอนด์ไอ	certificate of entry	๒ มี.ค. ๒๕๔๕
กองทุนความเสียหายร่วม	general average fund	๒ มี.ค. ๒๕๔๕
กองทุนค้ำประกัน	guarantee fund	๒ มี.ค. ๒๕๔๕
กองทุนฉุกเฉิน	contingency fund	๒ มี.ค. ๒๕๔๕
กองทุนดุลยภาพ	emergency fund	๒ มี.ค. ๒๕๔๕
กองทุนประกันชีวิต	life fund	๒ มี.ค. ๒๕๔๕
การเรียกร้องค่าสินไหมทดแทน	claim	๒ มี.ค. ๒๕๔๕
การเริ่มเสี่ยงภัย	attachment of risk	๒ มี.ค. ๒๕๔๕
การโยนทิ้งทะเล	jettison	๒ มี.ค. ๒๕๔๕
การแยกประเภทอาชีพ	occupational classification	๒ มี.ค. ๒๕๔๕
การรวมกลุ่มรับประกันภัย	group underwriting	๒ มี.ค. ๒๕๔๕
การรวมบริษัท	merger	๒ มี.ค. ๒๕๔๕
การแวะพัก	touch and stay	๒ มี.ค. ๒๕๔๕
การเวนคืนเงินปันผล	surrender of bonuses	๒ มี.ค. ๒๕๔๕
การระบุมูลฐาน	basic specification	๒ มี.ค. ๒๕๔๕
การร่วมชดใช้ค่าสินไหมทดแทน	contribution	๒ มี.ค. ๒๕๔๕
การเหมาจ่าย	commutation	๒ มี.ค. ๒๕๔๕
การร่วมรับผิดตามสัดส่วน	rat(e)able contribution	๒ มี.ค. ๒๕๔๕
การเสียรายได้จากการรับจ้าง	loss of engagement	๒ มี.ค. ๒๕๔๕
การเสียสิทธิ์	forfeiture	๒ มี.ค. ๒๕๔๕
การเสียสละในความเสียหายร่วม	general average sacrifice	๒ มี.ค. ๒๕๔๕
การเสี่ยงภัย	adventure	๒ มี.ค. ๒๕๔๕
การเสี่ยงภัย	risk	๒ มี.ค. ๒๕๔๕
การเสี่ยงภัยระหว่างจอด	ground risk	๒ มี.ค. ๒๕๔๕
การเสี่ยงภัยระหว่างบิน	flight risk	๒ มี.ค. ๒๕๔๕
การเสี่ยงภัยเก็งกำไร	speculative risk	๒ มี.ค. ๒๕๔๕
การเสี่ยงภัยแท้จริง	pure risk	๒ มี.ค. ๒๕๔๕
การเสี่ยงภัยสูงสุด	peak risk	๒ มี.ค. ๒๕๔๕
การเสี่ยงภัยสูงกว่าปรกติ	"impaired risk; <a href=""/coinages/websearch.php?Wd=substandard+risk&amp;Sj=0"">substandard risk</a>"	๒ มี.ค. ๒๕๔๕
การเสี่ยงภัยคลังสินค้า	warehouse risk	๒ มี.ค. ๒๕๔๕
การเสี่ยงภัยจอดตรวจสอบ	grounding risk	๒ มี.ค. ๒๕๔๕
การเสี่ยงภัยทางธุรกิจ	business risk	๒ มี.ค. ๒๕๔๕
การเสี่ยงภัยน้อยกว่าปรกติ	preferred risk	๒ มี.ค. ๒๕๔๕
การเสี่ยงภัยปรกติ	standard risk	๒ มี.ค. ๒๕๔๕
การเสี่ยงภัยผิดปรกติ	abnormal risk	๒ มี.ค. ๒๕๔๕
การเสนอและการสนอง	offer and acceptance	๒ มี.ค. ๒๕๔๕
การเสนอเกิน	overplacing	๒ มี.ค. ๒๕๔๕
การเสนอครั้งที่สอง	second leaving	๒ มี.ค. ๒๕๔๕
การเสื่อมราคา	depreciation	๒ มี.ค. ๒๕๔๕
การเสื่อมสภาพในตัวเอง	inherent vice	๒ มี.ค. ๒๕๔๕
การโอนสิทธิ์บางส่วน	collateral assignment	๒ มี.ค. ๒๕๔๕
การโอนความเสี่ยงภัย	risk transfer	๒ มี.ค. ๒๕๔๕
การโอนสิทธิ์	assignment	๒ มี.ค. ๒๕๔๕
การโอนสิทธิ์สมบูรณ์	absolute assignment	๒ มี.ค. ๒๕๔๕
การเอาประกันภัยเพิ่ม	additional insurance	๒ มี.ค. ๒๕๔๕
การเอาประกันภัยสูงกว่ามูลค่า	over-insurance	๒ มี.ค. ๒๕๔๕
การโอนยอดรวม	"portfolio transfer; <a href=""/coinages/websearch.php?Wd=transfer+of+portfolio&amp;Sj=0"">transfer of portfolio</a>"	๒ มี.ค. ๒๕๔๕
การโอนเบี้ยประกันภัย	premium transfer	๒ มี.ค. ๒๕๔๕
การรับเสี่ยงภัยขึ้นอยู่กับการยอมรับเงื่อนไข	subject approval no risk	๒ มี.ค. ๒๕๔๕
การรับรองรับประกันภัยเพิ่ม	guaranteed insurability	๒ มี.ค. ๒๕๔๕
การรับเป็นกรรณีพิเศษ	special acceptance	๒ มี.ค. ๒๕๔๕
การรับประกันภัย	underwriting	๒ มี.ค. ๒๕๔๕
การรับประกันภัยโดยตรง	direct writing	๒ มี.ค. ๒๕๔๕
การรับผิดส่วนแรก	deductible; excess	๒ มี.ค. ๒๕๔๕
การรับผิดส่วนแรก	first loss	๒ มี.ค. ๒๕๔๕
การรับผิดส่วนแรกโดยสมัครใจ	voluntary excess	๒ มี.ค. ๒๕๔๕
การรับผิดส่วนแรกจำนวนคงที่	fixed sum excess	๒ มี.ค. ๒๕๔๕
การรับชดใช้จากแหล่งอื่น	indemnification aliunde	๒ มี.ค. ๒๕๔๕
การมีหรือไม่มีส่วนได้เสีย	interest or no interest	๒ มี.ค. ๒๕๔๕
การมีส่วนร่วม	contributory	๒ มี.ค. ๒๕๔๕
การเลื่อนข้าง	settlement	๒ มี.ค. ๒๕๔๕
การเลื่อนทรุด	subsidence	๒ มี.ค. ๒๕๔๕
การยึดหน่วง	lien	๒ มี.ค. ๒๕๔๕
การยกเว้นเบี้ยประกันภัยเพราะทุพพลภาพ	waiver of premium disability benefit	๒ มี.ค. ๒๕๔๕
การยกเลิก	reicssion	๒ มี.ค. ๒๕๔๕
การยกเลิกกรมธรรม์	cancellation	๒ มี.ค. ๒๕๔๕
การยกเลิกการเสี่ยงภัยสงคราม	war risk cancellation	๒ มี.ค. ๒๕๔๕
การเกยตื้นที่แหล่งประจำ	customary strandings	๒ มี.ค. ๒๕๔๕
การแก้คำรับรอง	opening the warranty	๒ มี.ค. ๒๕๔๕
การเข้าเสี่ยงภัย	risk assumption	๒ มี.ค. ๒๕๔๕
การแข่งขันและปฏิบัติที่ไม่เป็นธรรม	unfair competition and practice	๒ มี.ค. ๒๕๔๕
การแจ้งค่าแรง	wages declaration	๒ มี.ค. ๒๕๔๕
การแจ้งรายละเอียด	declaration	๒ มี.ค. ๒๕๔๕
การแจ้งเกิดวินาศภัย	notification of claim	๒ มี.ค. ๒๕๔๕
การเฉลี่ยค่าเสียหาย	average	๒ มี.ค. ๒๕๔๕
การใช้เงินปันผลเร่งให้สัญญาครบกำหนด	accelerated endowment	๒ มี.ค. ๒๕๔๕
การใช้เงินปันผลสบทบจนครบจำนวน	accelerated paid-up	๒ มี.ค. ๒๕๔๕
การใช้อนุญาโตตุลาการ	arbitration	๒ มี.ค. ๒๕๔๕
การแถลงข้อความเป็นเท็จ	misrepresentation	๒ มี.ค. ๒๕๔๕
การแถลงข้อความเป็นเท็จเพื่อฉ้อฉล	fraudulent misrepresentation	๒ มี.ค. ๒๕๔๕
การแถลงข้อความจริง	representation	๒ มี.ค. ๒๕๔๕
การแถลงอายุคลาดเคลื่อน	misstatement of age	๒ มี.ค. ๒๕๔๕
การแบ่งเขตความรับประกันภัย	zoning	๒ มี.ค. ๒๕๔๕
การเบี่ยงเส้นทาง	deviation	๒ มี.ค. ๒๕๔๕
การแบ่งผลกำไร	profit-sharing	๒ มี.ค. ๒๕๔๕
การเป็นตัวแทน	agency	๒ มี.ค. ๒๕๔๕
การเปิดเผยความจริง	disclosure	๒ มี.ค. ๒๕๔๕
การเปลี่ยนแปลงการประมาณค่าสินไหมทดแทน	"loss development; <a href=""/coinages/websearch.php?Wd=loss+lag&amp;Sj=0"">loss lag</a>"	๒ มี.ค. ๒๕๔๕
การแปลงเป็นแบบสหการ	mutualisation	๒ มี.ค. ๒๕๔๕
การเผาไหม้เกิดเอง	spontaneous combustion	๒ มี.ค. ๒๕๔๕
การเพิ่มใช้เงินสำเร็จ	paid-up addition	๒ มี.ค. ๒๕๔๕
การเพิ่มค่าใช้จ่าย	increase in cost of working	๒ มี.ค. ๒๕๔๕
การยืดเยื้อไม่ชำระหนี้	protracted default	๒ มี.ค. ๒๕๔๕
การยุบแฟบ	collapse	๒ มี.ค. ๒๕๔๕
การสวมสิทธิ์	subrogation	๒ มี.ค. ๒๕๔๕
การสะสมทรัพย์แท้จริง	pure eddowment	๒ มี.ค. ๒๕๔๕
การห้ามเข้าใช้อาคาร	denial of access	๒ มี.ค. ๒๕๔๕
การส่งมอบขาดจำนวน	short delivery	๒ มี.ค. ๒๕๔๕
การสำรวจตัวเรือร่วมกัน	joint hull survey	๒ มี.ค. ๒๕๔๕
การสิ้นสุดการเสี่ยงภัย	termination of adventure	๒ มี.ค. ๒๕๔๕
การสูญเสียอวัยวะแขนขา	loss of limb	๒ มี.ค. ๒๕๔๕
การสูญหาย	loss	๒ มี.ค. ๒๕๔๕
การสละสิทธิ์	waiver	๒ มี.ค. ๒๕๔๕
การสละทิ้ง	abandonment	๒ มี.ค. ๒๕๔๕
การสลักหลัง	endorsement	๒ มี.ค. ๒๕๔๕
การสลักหลังว่าด้วยการผิดคำรับรอง	breach of warranty endorsement	๒ มี.ค. ๒๕๔๕
การสึกหรือ	wear and tear	๒ มี.ค. ๒๕๔๕
การหลีกเลี่ยงภัย	risk avoidance	๒ มี.ค. ๒๕๔๕
การหน่วงเหนี่ยว	restraints	๒ มี.ค. ๒๕๔๕
การสนอง	acceptance	๒ มี.ค. ๒๕๔๕
การละเว้น	nonfeasance	๒ มี.ค. ๒๕๔๕
การลักเล็กขโมยน้อย	pilferage	๒ มี.ค. ๒๕๔๕
การลักทรัพย์	larceny	๒ มี.ค. ๒๕๔๕
การลดเบี้ยประกันภัย	rebating	๒ มี.ค. ๒๕๔๕
การไม่เรียกร้องค่าสินไหมทดแทนสำหรับอุบัติเหตุที่ได้รับแจ้งแล้ว	no claim for accident reported	๒ มี.ค. ๒๕๔๕
การไม่มีส่วนร่วม	non-contributory	๒ มี.ค. ๒๕๔๕
การไม่แบ่งคืนเบี้ยประกันภัย	indivisibility of premiums	๒ มี.ค. ๒๕๔๕
การไม่เปิดเผยข้อความจริง	non-disclosure	๒ มี.ค. ๒๕๔๕
การไถ่ถอนมูลค่า	amortization	๒ มี.ค. ๒๕๔๕
การกระจายความเสี่ยงภัย	spread of risk	๒ มี.ค. ๒๕๔๕
การกระทำผิดหน้าที่	breach of statutory duty	๒ มี.ค. ๒๕๔๕
การก่อวินาศกรรม	sabotage	๒ มี.ค. ๒๕๔๕
การกำหนดอัตรา	rating	๒ มี.ค. ๒๕๔๕
การกำหนดอัตราหมู่ยานพาหนะ	fleet rating	๒ มี.ค. ๒๕๔๕
การกำหนดอัตราตามความเป็นธรรม	merit rating	๒ มี.ค. ๒๕๔๕
การกำหนดอัตราตามดุลยพินิจ	judgement rating	๒ มี.ค. ๒๕๔๕
การกำหนดอัตราตามตารางรายการ	schedule rating	๒ มี.ค. ๒๕๔๕
การกำหนดอัตราตามประสบการณ์	"experience rating; <a href=""/coinages/websearch.php?Wd=prospective+rating&amp;Sj=0"">prospective rating</a>"	๒ มี.ค. ๒๕๔๕
การกำหนดอัตราตามผลย้อนหลัง	retrospective rating	๒ มี.ค. ๒๕๔๕
การกู้ภัย	salvage	๒ มี.ค. ๒๕๔๕
การขยายความคุ้มครอง	extension	๒ มี.ค. ๒๕๔๕
การขยายความคุ้มครองเครื่องจักรระหว่างขนย้าย	metal workers’ extension	๒ มี.ค. ๒๕๔๕
การขยายความคุ้มครองคดีความ	legal costs extension	๒ มี.ค. ๒๕๔๕
การขยายความคุ้มครองทรัพย์สินลูกค้า	customers’ extension	๒ มี.ค. ๒๕๔๕
การค้ำประกัน	bond	๒ มี.ค. ๒๕๔๕
การค้ำประกันการกู้ภัย	salvage guarantee	๒ มี.ค. ๒๕๔๕
การค้ำประกันการจำนอง	mortgage guarantee	๒ มี.ค. ๒๕๔๕
การคัดเลือก(ภัย)	selection	๒ มี.ค. ๒๕๔๕
การคัดเลือก(ภัย)	selection	๒ มี.ค. ๒๕๔๕
การคัดเลือกที่ขัดประโยชน์	"adverse selection; <a href=""/coinages/websearch.php?Wd=selection+against+the+insurer&amp;Sj=0"">selection against the insurer</a>"	๒ มี.ค. ๒๕๔๕
การคาดคะเนวินาศภัย	loss expectancy	๒ มี.ค. ๒๕๔๕
การคล้อยตามผู้รับประกันภัยนำ	follow the lead	๒ มี.ค. ๒๕๔๕
การคืนยอดรวม	portfolio return	๒ มี.ค. ๒๕๔๕
การคืนเบี้ยประกันภัยตามตกลง	agreed return	๒ มี.ค. ๒๕๔๕
การคุ้มกัน	protection	๒ มี.ค. ๒๕๔๕
การคุ้มกันให้พ้นอัคคีภัย	fire protection	๒ มี.ค. ๒๕๔๕
การจ่ายบ่วงหน้าค่าสินไหมทดแทนค้างจ่าย	outstanding claims adavance	๒ มี.ค. ๒๕๔๕
การจ้างเรือเพื่อบรรทุกสินค้า	affreightment	๒ มี.ค. ๒๕๔๕
การจัดสรรเงินส่วนเกิน	allocation of surplus	๒ มี.ค. ๒๕๔๕
การจัดสรรเงินปันผล	"allotment of bonus; <a href=""/coinages/websearch.php?Wd=bonus+allocation&amp;Sj=0"">bonus allocation</a>"	๒ มี.ค. ๒๕๔๕
การจัดสัดส่วน	apportionment	๒ มี.ค. ๒๕๔๕
การจัดการค่าสินไหมทดแทน	loss adjustment	๒ มี.ค. ๒๕๔๕
การจัดทดแทน	reinstatement	๒ มี.ค. ๒๕๔๕
การจับกุม หน่วงเหนี่ยว และกักขัง	arrests, restraints and detainments	๒ มี.ค. ๒๕๔๕
การจับกุมและยึดเอา	capture and seizure	๒ มี.ค. ๒๕๔๕
การจำนองอันดับถัดไป	second mortgage	๒ มี.ค. ๒๕๔๕
การจำกัดจำนวนความรับผิด	limitation of liability	๒ มี.ค. ๒๕๔๕
การชำระความรับผิดเด็ดขาด	cut-off	๒ มี.ค. ๒๕๔๕
การชดเชย	compensation	๒ มี.ค. ๒๕๔๕
การชดใช้สองเท่า	double indemnity	๒ มี.ค. ๒๕๔๕
การชดใช้ค่าสินไหมทอดแทนแท้จริง	pure indemnity	๒ มี.ค. ๒๕๔๕
การชดใช้ค่าสินไหมทดแทน	indemnity	๒ มี.ค. ๒๕๔๕
การชดใช้ค่าสินไหมทดแทนกรณีเอกสารสูญหาย	missing document indemnity	๒ มี.ค. ๒๕๔๕
การชดใช้ค่าสินไหมทดแทนกรณีผิดสัญญา	restrictive covenant indemnity	๒ มี.ค. ๒๕๔๕
การชดใช้ค่าสินไหมทดแทนกรณีผู้รับมรดกสาบสูญ	missing beneficiaries indemnity	๒ มี.ค. ๒๕๔๕
การชดใช้ค่าสินไหมทดแทนคืน	recourse indemnity	๒ มี.ค. ๒๕๔๕
การชดใช้ด้วยการุณย์	ex gratia payment	๒ มี.ค. ๒๕๔๕
การชน	collision	๒ มี.ค. ๒๕๔๕
การตรวจสุขภาพ	medical examination	๒ มี.ค. ๒๕๔๕
การต่ออายุ	renewal	๒ มี.ค. ๒๕๔๕
การต้องเฉลี่ยค่าเสียหาย	importation of average	๒ มี.ค. ๒๕๔๕
การตอบแทนกันและกัน	reciprocity	๒ มี.ค. ๒๕๔๕
การตายจริง	actual deaths	๒ มี.ค. ๒๕๔๕
การติดตื้นที่แหล่งประจำ	customary groundings	๒ มี.ค. ๒๕๔๕
การติดพัน	running off	๒ มี.ค. ๒๕๔๕
การตกลง	settlement	๒ มี.ค. ๒๕๔๕
การตกลงค่าสินไหมทดแทนในต่างประเทศ	Settlement of Claims Abroad	๒ มี.ค. ๒๕๔๕
การที่สามารถเอาประกันได้	insurability	๒ มี.ค. ๒๕๔๕
การทดแทน	compensation	๒ มี.ค. ๒๕๔๕
การทดแทนเป็นสิ่งขอ	replacement in kind	๒ มี.ค. ๒๕๔๕
การทุจริตของพนักงานเรือ	barratry	๒ มี.ค. ๒๕๔๕
การบรรเทาวินาศภัย	minimising a loss	๒ มี.ค. ๒๕๔๕
การบาดเจ็บเสียหายส่วนบุคคล	personal injury	๒ มี.ค. ๒๕๔๕
การบาดเจ็บโดยอุบัติเหตุ	accidental bodily injury	๒ มี.ค. ๒๕๔๕
การบาดเจ็บทางร่างกาย	bodily injury	๒ มี.ค. ๒๕๔๕
การบิดเบือน	twisting	๒ มี.ค. ๒๕๔๕
การประเมินภัย	risk assessment	๒ มี.ค. ๒๕๔๕
การประเมินค่า	valuation	๒ มี.ค. ๒๕๔๕
การประกันมหันตภัยต่อ	"catastrophe reinsurance; <a href=""/coinages/websearch.php?Wd=shock+loss+reinsurance&amp;Sj=0"">shock loss reinsurance</a>"	๒ มี.ค. ๒๕๔๕
การประกันภัย	"assurance; <a href=""/coinages/websearch.php?Wd=insurance&amp;Sj=0"">insurance</a>"	๒ มี.ค. ๒๕๔๕
การประกันภัยเรือยอช์ต	yacht insurance	๒ มี.ค. ๒๕๔๕
การประกันภัยเรือในท่า	port risks insurance	๒ มี.ค. ๒๕๔๕
การประกันภัยรวมผู้เกี่ยวข้อง	wrap-up insurance	๒ มี.ค. ๒๕๔๕
การประกันภัยระยะยาว	long term insurance	๒ มี.ค. ๒๕๔๕
การประกันภัยระยะสั้น	short term insurance	๒ มี.ค. ๒๕๔๕
การประกันภัยร่วม	"co-assurance; <a href=""/coinages/websearch.php?Wd=co-insurance&amp;Sj=0"">co-insurance</a>"	๒ มี.ค. ๒๕๔๕
การประกันภัยเหลื่อมกัน	overlapping insurance	๒ มี.ค. ๒๕๔๕
การประกันภัยเหตุการณ์ที่อาจเป็นได้	contingency insurance	๒ มี.ค. ๒๕๔๕
การประกันภัยรองรับ	underlying insurance	๒ มี.ค. ๒๕๔๕
การประกันภัยยอดรวมธุรกิจ	whole turnover insurance	๒ มี.ค. ๒๕๔๕
การประกันภัยเบี้ยประกันภัยที่ยังไม่ถือเป็นรายได้	unearned premium insurance	๒ มี.ค. ๒๕๔๕
การประกันภัยแบบร้อยละของความเสียหายอัคคีภัย	percentage of fire loss insurance	๒ มี.ค. ๒๕๔๕
การประกันภัยแบบสหการ	mutual insurance	๒ มี.ค. ๒๕๔๕
การประกันภัยแบบกำหนดมูลค่าสูงสุด	maximum value insurance	๒ มี.ค. ๒๕๔๕
การประกันภัยแบบตลอดไป	perpetual insurance	๒ มี.ค. ๒๕๔๕
การประกันภัยแบบประเมินเบี้ยการประกันภัย	assessment insurance	๒ มี.ค. ๒๕๔๕
การประกันภัยแผ่นดินไหว	earthquake insurance	๒ มี.ค. ๒๕๔๕
การประกันภัยหม้อกำเนิดไอน้ำ	boiler insurance	๒ มี.ค. ๒๕๔๕
การประกันภัยสภาพลมฟ้าอากาศ	"pluvius insurance; <a href=""/coinages/websearch.php?Wd=weather+insurance&amp;Sj=0"">weather insurance</a>"	๒ มี.ค. ๒๕๔๕
การประกันภัยมูลค่าของใหม่	replacement cost insurance	๒ มี.ค. ๒๕๔๕
การประกันภัยโจรกรรม	theft insurance	๒ มี.ค. ๒๕๔๕
การประกันภัยโดยตรง	direct insurance	๒ มี.ค. ๒๕๔๕
การประกันภัยเต็มมูลค่า	full value insurance	๒ มี.ค. ๒๕๔๕
การประกันภัยรถยนต์	motor insurance	๒ มี.ค. ๒๕๔๕
การประกันภัยรถจักรยาน	cycle insurance	๒ มี.ค. ๒๕๔๕
การประกันภัยเบ็ดเตล็ด	casualty insurance	๒ มี.ค. ๒๕๔๕
การประกันภัยใบอนุญาต	licence insurance	๒ มี.ค. ๒๕๔๕
การประกันภัยส่วนเกิน	excess insurance	๒ มี.ค. ๒๕๔๕
การประกันภัยหัวกระจายน้ำดับเพลิง	sprinkler insurance	๒ มี.ค. ๒๕๔๕
การประกันภัยสัตว์น้ำ	aquacultural insurance	๒ มี.ค. ๒๕๔๕
การประกันภัยสารพัน	omnibus insurance	๒ มี.ค. ๒๕๔๕
การประกันภัยสำหรับเจ้าของบ้าน	houseowners’ insurance	๒ มี.ค. ๒๕๔๕
การประกันภัยสำหรับผู้อยู่อาศัย	householders’ insurance	๒ มี.ค. ๒๕๔๕
การประกันภัยสิทธิในอุตสาหกรรม	industrial property rights insurance	๒ มี.ค. ๒๕๔๕
การประกันภัยสินเชื่อ	credit insurance	๒ มี.ค. ๒๕๔๕
การประกันภัยสินเชื่อผู้ส่งออก	export credit insurance	๒ มี.ค. ๒๕๔๕
การประกันภัยสินค้าระหว่างขนส่ง	goods-in-transit insurance	๒ มี.ค. ๒๕๔๕
การประกันภัยสินค้าขนส่ง	"cargo insurance; <a href=""/coinages/websearch.php?Wd=marine+cargo+insurance&amp;Sj=0"">marine cargo insurance</a>"	๒ มี.ค. ๒๕๔๕
การประกันภัยสงคราม	war risk insurance	๒ มี.ค. ๒๕๔๕
การประกันภัยหนี้ตามบัญชี	book debts insurance	๒ มี.ค. ๒๕๔๕
การประกันภัยอุบัติเหตุ	accident insurance	๒ มี.ค. ๒๕๔๕
การประกันภัยอุบัติเหตุและสุขภาพ	accident and health insurance	๒ มี.ค. ๒๕๔๕
การประกันภัยอุบัติเหตุเพิ่ม	supplementary accident insurance	๒ มี.ค. ๒๕๔๕
การประกันภัยอุบัติเหตุส่วนบุคคล	personal accident insurance	๒ มี.ค. ๒๕๔๕
การประกันภัยกำไร	profits insurance	๒ มี.ค. ๒๕๔๕
การประกันภัยกำไรที่คาดหมาย	advance profits insurance	๒ มี.ค. ๒๕๔๕
การประกันภัยกลุ่ม	group insurance	๒ มี.ค. ๒๕๔๕
การประกันภัยขยายเวลา	extended terms insurance	๒ มี.ค. ๒๕๔๕
การประกันภัยความเสียหายส่วนแรก	first loss insurance	๒ มี.ค. ๒๕๔๕
การประกันภัยความเสียหายส่วนเกิน, การประกันภัยความเสียหายส่วนที่สอง	second loss insurance	๒ มี.ค. ๒๕๔๕
การประกันภัยความเสียหายส่วนที่สอง, การประกันภัยความเสียหายส่วนเกิน	second loss insurance	๒ มี.ค. ๒๕๔๕
การประกันภัยความเสียหายสืบเนื่อง	consequential loss insurance	๒ มี.ค. ๒๕๔๕
การประกันภัยความเสียหายจากน้ำ	water damage insurance	๒ มี.ค. ๒๕๔๕
การประกันภัยความเสียประโยชน์การใช้	loss of use insurance	๒ มี.ค. ๒๕๔๕
การประกันภัยลักทรัพย์ในเคหสถาน	burglary insurance	๒ มี.ค. ๒๕๔๕
การประกันภัยไม่พ้องกัน	non-concurrent insurance	๒ มี.ค. ๒๕๔๕
การประกันภัยกรรมสิทธิ์	title insurance	๒ มี.ค. ๒๕๔๕
การประกันภัยกระจก	glass insurance	๒ มี.ค. ๒๕๔๕
การประกันภัยกันและกัน	reciprocal insurance	๒ มี.ค. ๒๕๔๕
การประกันภัยการเรียกค่าไถ่	ransom insurance	๒ มี.ค. ๒๕๔๕
การประกันภัยการรับเหมา	contract works insurance	๒ มี.ค. ๒๕๔๕
การประกันภัยการยับยั้งการชำระเงิน	claimright insurance	๒ มี.ค. ๒๕๔๕
การประกันภัยการยึดทรัพย์	confiscation insurance	๒ มี.ค. ๒๕๔๕
การประกันภัยการเก็บคืนผลิตภัณฑ์	recall of products insurance	๒ มี.ค. ๒๕๔๕
การประกันภัยการหมิ่นประมาท	"defamation insurance; <a href=""/coinages/websearch.php?Wd=libel+and+slander+insurance&amp;Sj=0"">libel and slander insurance</a>"	๒ มี.ค. ๒๕๔๕
การประกันภัยการหยุดชะงักทางวิศวกรรม	engineering interruption insurance	๒ มี.ค. ๒๕๔๕
การประกันภัยการสูญเสียกำไร	loss of profits insurance	๒ มี.ค. ๒๕๔๕
การประกันภัยการลักพาตัวเรียกค่าไถ่	kidnap and ransom insurance	๒ มี.ค. ๒๕๔๕
การประกันภัยการลงทุน	investment insurance	๒ มี.ค. ๒๕๔๕
การประกันภัยการขนส่งสินค้าภายในประเทศ	inland marine insurance	๒ มี.ค. ๒๕๔๕
การประกันภัยการค้ำประกันการบำรุงรักษา	maintenance bond insurance	๒ มี.ค. ๒๕๔๕
การประกันภัยการถูกถอนใบอนุญาต	loss-of-licence insurance	๒ มี.ค. ๒๕๔๕
การประกันภัยการบาดเจ็บจากอุตสาหกรรม	industrial injuries insurance	๒ มี.ค. ๒๕๔๕
การประกันภัยความรับผิดต่อทรัพย์สิน	property damage insurance	๒ มี.ค. ๒๕๔๕
การประกันภัยความรับผิดต่อบุคคลภายนอก	"third party insurance; <a href=""/coinages/websearch.php?Wd=third+party+liability+insurance&amp;Sj=0"">third party liability insurance</a>"	๒ มี.ค. ๒๕๔๕
การประกันภัยความซื่อสัตย์	"fidelity guarantee; <a href=""/coinages/websearch.php?Wd=fidelity+insurance&amp;Sj=0"">fidelity insurance</a>"	๒ มี.ค. ๒๕๔๕
การประกันภัยความผิดตกละเว้น	errors and omissions insurance	๒ มี.ค. ๒๕๔๕
การประกันภัยค่าระวาง	freight insurance	๒ มี.ค. ๒๕๔๕
การประกันภัยค่ารักษาพยาบาล	hospital and medical expenses insurance	๒ มี.ค. ๒๕๔๕
การประกันภัยค่ารักษาพยาบาลแบบเงินสด	hospital cash insurance	๒ มี.ค. ๒๕๔๕
การประกันภัยค่าแตกต่าง	difference insurance	๒ มี.ค. ๒๕๔๕
การประกันภัยค้ำประกัน	bonding	๒ มี.ค. ๒๕๔๕
การประกันภัยความรับผิด	liability insurance	๒ มี.ค. ๒๕๔๕
การประกันภัยความรับผิดส่วนบุคคล	personal liability insurance	๒ มี.ค. ๒๕๔๕
การประกันภัยความรับผิดของสนามบิน	airport owners’ and operators’ insurance	๒ มี.ค. ๒๕๔๕
การประกันภัยความรับผิดของกรรมการและพนักงานบริษัท	directors’ and officers’ liability insurance	๒ มี.ค. ๒๕๔๕
การประกันภัยความรับผิดของนายจ้าง	employer’s liability insurance	๒ มี.ค. ๒๕๔๕
การประกันภัยความรับผิดของผู้รับเก็บรักษาเครื่องบิน	hangarkeeper’s liability insurance	๒ มี.ค. ๒๕๔๕
การประกันภัยความรับผิดจากวิชาชีพ	professional indemnity insurance	๒ มี.ค. ๒๕๔๕
การประกันภัยความรับผิดจากผลิตภัณฑ์	products liability insurance	๒ มี.ค. ๒๕๔๕
การประกันภัยความรับผิดต่อสาธารณะ	public liability insurance	๒ มี.ค. ๒๕๔๕
การประกันภัยต่อเพื่อประโยชน์ร่วมกัน	common account	๒ มี.ค. ๒๕๔๕
การประกันภัยต่ออัตราค่าเสียหายส่วนเกิน	excess of loss ration reinsurance	๒ มี.ค. ๒๕๔๕
การประกันภัยต่อกำหนดค่าเสียหาย	self- insurance	๒ มี.ค. ๒๕๔๕
การประกันภัยต่อกำหนดค่าเสียหายโดยจำนวนรวม	aggregate stop loss reinsurance	๒ มี.ค. ๒๕๔๕
การประกันภัยต่อความเสียหายส่วนเกิน	excess of loss reinsurance	๒ มี.ค. ๒๕๔๕
การประกันภัยต่อความเสียหายส่วนเกินรวม	aggregated excess of loss reinsurance	๒ มี.ค. ๒๕๔๕
การประกันภัยต่อคละ	bouquet (of treaties)	๒ มี.ค. ๒๕๔๕
การประกันภัยต่อคงที่	flat line reinsurance	๒ มี.ค. ๒๕๔๕
การประกันภัยต่อช่วง	retrocession	๒ มี.ค. ๒๕๔๕
การประกันภัยค้ำประกันผลิตภัณฑ์	products guarantee	๒ มี.ค. ๒๕๔๕
การประกันภัยคลอดแฝด	multiple birth insurance	๒ มี.ค. ๒๕๔๕
การประกันภัยคดีความ	"legal (costs and expenses) insurance; <a href=""/coinages/websearch.php?Wd=legal+protection+insurance&amp;Sj=0"">legal protection insurance</a>"	๒ มี.ค. ๒๕๔๕
การประกันภัยจักรยานยนต์	motorcycle insurance	๒ มี.ค. ๒๕๔๕
การประกันภัยจำเพาะ	specific insurance	๒ มี.ค. ๒๕๔๕
การประกันภัยช่วงแรก	primary insurance	๒ มี.ค. ๒๕๔๕
การประกันภัยซ้ำซ้อน	double insurance	๒ มี.ค. ๒๕๔๕
การประกันภัยต่อร่วม	contributory reinsurance	๒ มี.ค. ๒๕๔๕
การประกันภัยต่อร่วมเกิน(ทางทะเล)	excess of line reinsurance	๒ มี.ค. ๒๕๔๕
การประกันภัยต่อร่วมเกิน(ทางทะเล)	excess of line reinsurance	๒ มี.ค. ๒๕๔๕
การประกันภัยต่อเฉพาะราย	"facultative reinsurance; <a href=""/coinages/websearch.php?Wd=specific+reinsurance&amp;Sj=0"">specific reinsurance</a>"	๒ มี.ค. ๒๕๔๕
การประกันภัยต่อโดยผูกพัน	obligatory reinsurance	๒ มี.ค. ๒๕๔๕
การประกันภัยต่อแบบรวม	combination plan reinsurance	๒ มี.ค. ๒๕๔๕
การประกันภัยต่อแบบส่วนเกิน	"excess of line reinsurance; <a href=""/coinages/websearch.php?Wd=surplus+reinsurance&amp;Sj=0"">surplus reinsurance</a>"	๒ มี.ค. ๒๕๔๕
การประกันภัยต่อแบบไม่กำหนดสัดส่วน	non-proportionate reinsurance	๒ มี.ค. ๒๕๔๕
การประกันภัยต่อแบบกระจายค่าเสียหาย	spread loss reinsurance	๒ มี.ค. ๒๕๔๕
การประกันภัยต่อแบบคาร์เพนเตอร์	Carpenter plan	๒ มี.ค. ๒๕๔๕
การประกันภัยต่อแบบตามสัดส่วน	"proportional reinsurance; <a href=""/coinages/websearch.php?Wd=pro+rata+reinsurance&amp;Sj=0"">pro rata reinsurance</a>"	๒ มี.ค. ๒๕๔๕
การประกันภัยตัวเครื่องบิน	"aircraft hull insurance; <a href=""/coinages/websearch.php?Wd=aviation+hull+insurance&amp;Sj=0"">aviation hull insurance</a>"	๒ มี.ค. ๒๕๔๕
การประกันภัยตามยอดรวม	portfolio reinsurance	๒ มี.ค. ๒๕๔๕
การประกันภัยตู้ขายสินค้าแบบหยอดเหรียญ	vending machine insurance	๒ มี.ค. ๒๕๔๕
การประกันภัยตนเอง	compulsory insurance	๒ มี.ค. ๒๕๔๕
การประกันภัยทรัพย์สิน	property insurance	๒ มี.ค. ๒๕๔๕
การประกันภัยทางวิศวกรรม	engineering insurance	๒ มี.ค. ๒๕๔๕
การประกันภัยทางทะเล	marine insurance	๒ มี.ค. ๒๕๔๕
การประกันภัยทางทะเล	ocean marine insurance	๒ มี.ค. ๒๕๔๕
การประกันภัยต่อตามส่วน	"quota share reinsurance; <a href=""/coinages/websearch.php?Wd=share+reinsurance&amp;Sj=0"">share reinsurance</a>"	๒ มี.ค. ๒๕๔๕
การประกันภัยต่อตามส่วนผสมส่วนเกิน	quota surplus reinsurance	๒ มี.ค. ๒๕๔๕
การประกันภัยต่อตามสัญญา	treaty reinsurance	๒ มี.ค. ๒๕๔๕
การประกันภัยต่อที่ไม่ได้รับอนุญาต	non-admitted reinsurance	๒ มี.ค. ๒๕๔๕
การประกันภัยต่อบัญชีร่วม	"reinsurance of common account; <a href=""/coinages/websearch.php?Wd=reinsurance+of+joint+account&amp;Sj=0"">reinsurance of joint account</a>"	๒ มี.ค. ๒๕๔๕
การประกันภัยต่ำกว่ามูลค่า	under-insurance	๒ มี.ค. ๒๕๔๕
การประกันภัยตัวเรือ	hull insurance	๒ มี.ค. ๒๕๔๕
การประกันภัยตัวเรือ	marine hull insurance	๒ มี.ค. ๒๕๔๕
การประกันภัยธุรกิจหยุดชะงัก	business interruption insurance	๒ มี.ค. ๒๕๔๕
การประกันภัยธุรกิจหยุดชะงักเนื่องจากอัคคีภัย	fire interruption insurance	๒ มี.ค. ๒๕๔๕
การประกันภัยน้ำท่วม	flood insurance	๒ มี.ค. ๒๕๔๕
การประกันภัยนักกอล์ฟ	golfer’s insurance	๒ มี.ค. ๒๕๔๕
การประกันภัยบริการถึงบ้าน	home service insurance	๒ มี.ค. ๒๕๔๕
การประกันภัยบัตรเครดิต	credit card insurance	๒ มี.ค. ๒๕๔๕
การประกันภัยบนถนน	road risk insurance	๒ มี.ค. ๒๕๔๕
การประกันภัยปศุสัตว์	livestock insurance	๒ มี.ค. ๒๕๔๕
การประกันภัยปฏิเสธนำเข้า	rejection risk insurance	๒ มี.ค. ๒๕๔๕
การประกันสรรพภัยในการติดตั้ง	erection all risks	๒ มี.ค. ๒๕๔๕
การประกันสรรพภัยของการรับเหมา	contractors’ all risks	๒ มี.ค. ๒๕๔๕
การประกันสังคม	social insurance	๒ มี.ค. ๒๕๔๕
การประกันสุขภาพ	health insurance	๒ มี.ค. ๒๕๔๕
การประกันชีวิตใช้เงินสำเร็จลดเงินเอาประกันภัย	reduced paid-up insurance	๒ มี.ค. ๒๕๔๕
การประกันชีวิตโดยหักเงินเดือน	salary savings insurance	๒ มี.ค. ๒๕๔๕
การประกันชีวิตโดยไม่ตรวจสุขภาพ	non-medical insurance	๒ มี.ค. ๒๕๔๕
การประกันชีวิตแบบสะสมทรัพย์ทวีคูณ	double endowment assurance	๒ มี.ค. ๒๕๔๕
การประกันชีวิตแบบสัญญาเปิด	assessment insurance	๒ มี.ค. ๒๕๔๕
การประกันชีวิตแบบกำหนดเวลา	fixed term assurance	๒ มี.ค. ๒๕๔๕
การประกันชีวิตแบบชั่วระยะเวลา	term insurance	๒ มี.ค. ๒๕๔๕
การประกันชีวิตแบบชั่วระยะเวลาเพิ่มเติม	supplemental term insurance	๒ มี.ค. ๒๕๔๕
การประกันชีวิตแบบชั่วระยะเวลาลดเงินเอาประกัน	decreasing term insurance	๒ มี.ค. ๒๕๔๕
การประกันชีวิตแบบชั่วระยะเวลาตามพยากรณ์ชีพ	life expectancy term insurance	๒ มี.ค. ๒๕๔๕
การประกันสุขภาพแบบถาวร	permanent health insurance	๒ มี.ค. ๒๕๔๕
การประกันอัคคีภัย	fire insurance	๒ มี.ค. ๒๕๔๕
การประกันอัคคีภัยอุตสาหกรรม	industrial fire insurance	๒ มี.ค. ๒๕๔๕
การประกันชีวิต	life insurance	๒ มี.ค. ๒๕๔๕
การประกันชีวิตมีเงื่อนไข	contingent assurance	๒ มี.ค. ๒๕๔๕
การประกันชีวิตมีเงื่อนไขทรงชีพ	contingent survivorship assurance	๒ มี.ค. ๒๕๔๕
การประกันภัยผู้เอาประกัน	first party insurance	๒ มี.ค. ๒๕๔๕
การประกันภัยผู้รับเหมาก่อสร้าง	builder’s risk	๒ มี.ค. ๒๕๔๕
การประกันภัยผู้โดยสารเครื่องบิน	aircraft passenger insurance	๒ มี.ค. ๒๕๔๕
การประกันภัยผู้สูงอายุ	"old age and survivors insurance (<a href=""/coinages/websearch.php?Wd=OASI&amp;Sj=0"">OASI</a>)"	๒ มี.ค. ๒๕๔๕
การประกันภัยผู้ไม่ดื่มของมึนเมา	abstainers insurance	๒ มี.ค. ๒๕๔๕
การประกันภัยผู้ต่อเรือ	builder’ s risk	๒ มี.ค. ๒๕๔๕
การประกันภัยฝน	rain insurance	๒ มี.ค. ๒๕๔๕
การประกันภัยพ้อง	concurrent insurance	๒ มี.ค. ๒๕๔๕
การประกันภัยพายุลูกเห็บ	hailstorm insurance	๒ มี.ค. ๒๕๔๕
การประกันภัยพืชผล	crop insurance	๒ มี.ค. ๒๕๔๕
การประกันชีวิตแบบชั่วระยะเวลาที่แปลงได้	convertible term assurance	๒ มี.ค. ๒๕๔๕
การประกันชีวิตเพื่อสินเชื่อ	creditor life assurance	๒ มี.ค. ๒๕๔๕
การประกันชีวิตเพื่อการศึกษา	educational insurance	๒ มี.ค. ๒๕๔๕
การประกันชีวิตเพื่อการศึกษาเพื่อเจ้าหนี้	school fees insurance	๒ มี.ค. ๒๕๔๕
การประกันชีวิตเพื่อซื้อบ้าน	house purchase assurance	๒ มี.ค. ๒๕๔๕
การประกันชีวิตเพื่อธุรกิจ	"business insurance; <a href=""/coinages/websearch.php?Wd=corporation+insurance&amp;Sj=0"">corporation insurance</a>; <a href=""/coinages/websearch.php?Wd=partnership+insurance&amp;Sj=0"">partnership insurance</a>"	๒ มี.ค. ๒๕๔๕
การประกันชีวิตคุ้มครองการจำนอง	mortgage insurance	๒ มี.ค. ๒๕๔๕
การประกันชีวิตชั่วคราว	temporary life assurance	๒ มี.ค. ๒๕๔๕
การประกันชีวิตบุคคลหลัก	keyman insurance	๒ มี.ค. ๒๕๔๕
การประกาศเงินปันผล	"bonus declaration; <a href=""/coinages/websearch.php?Wd=declaration+of+bonus&amp;Sj=0"">declaration of bonus</a>"	๒ มี.ค. ๒๕๔๕
การประกันชีวิตประเภทสามัญ	ordinary insurance	๒ มี.ค. ๒๕๔๕
การประกันชีวิตประเภทอุตสาหะ	industrial insurance	๒ มี.ค. ๒๕๔๕
การประกันชีวิตประเภทกลุ่ม	group life insurance	๒ มี.ค. ๒๕๔๕
การประกันชีวิตผู้เยาว์	Juvenile insurance	๒ มี.ค. ๒๕๔๕
การประกันชีวิตผู้เยาว์เลื่อนกำหนด	child’s deferred assurance	๒ มี.ค. ๒๕๔๕
การประกันชีวิตผู้ชำระเบี้ยประกันภัย	payor insurance	๒ มี.ค. ๒๕๔๕
การปรับอัตราร้อยละ	percentage adjustments	๒ มี.ค. ๒๕๔๕
การปรับค่าสูงขึ้น	escalation	๒ มี.ค. ๒๕๔๕
การป้องกันภัย	risk prevention	๒ มี.ค. ๒๕๔๕
การป้องกันวินาศภัย	loss prevention	๒ มี.ค. ๒๕๔๕
การป้องกัน	prevention	๒ มี.ค. ๒๕๔๕
การป้องกันอัคคีภัย	fire prevention	๒ มี.ค. ๒๕๔๕
การปิดการหาผู้รับประกันภัย	closed line	๒ มี.ค. ๒๕๔๕
การปกปิดข้อความจริง	concealment	๒ มี.ค. ๒๕๔๕
การปฏิบัติตาม	follow the fortunes	๒ มี.ค. ๒๕๔๕
การผิดคำรับรอง	breaking the warranty	๒ มี.ค. ๒๕๔๕
การฝากทรัพย์	bailment	๒ มี.ค. ๒๕๔๕
การพิสูจน์ความเสียหาย	proof of loss	๒ มี.ค. ๒๕๔๕
กำแพงร่วม	party wall	๒ มี.ค. ๒๕๔๕
กำแพงกั้นไฟ	fire wall	๒ มี.ค. ๒๕๔๕
การฟื้นสัญญา	reinstatement	๒ มี.ค. ๒๕๔๕
การฟื้นสัญญาโดยอัตโนมัติ	automatic reinstatement	๒ มี.ค. ๒๕๔๕
กำไรจากส่วนบวกเพิ่ม	loading profit	๒ มี.ค. ๒๕๔๕
กำไรจากกรมธรรม์ขาดอายุ	lapsation profit	๒ มี.ค. ๒๕๔๕
กำไรจากการรับประกันภัย	underwriting profit	๒ มี.ค. ๒๕๔๕
กำไรจากดอกเบี้ย	interest profit	๒ มี.ค. ๒๕๔๕
กลุ่มเสี่ยงภัย	pool	๒ มี.ค. ๒๕๔๕
กฎยอร์ก-แอนต์เวิร์ป	York-Antwerp Rules	๒ มี.ค. ๒๕๔๕
กฎเฮก-วิสบี	Hague-Visby Rules	๒ มี.ค. ๒๕๔๕
กฎว่าด้วยจำนวนมาก	law of large numbers	๒ มี.ค. ๒๕๔๕
กฎวิธีการปฏิบัติ	Rules of Practice	๒ มี.ค. ๒๕๔๕
กฎหมายจารีตประเพณี	common law	๒ มี.ค. ๒๕๔๕
กฎฮัมบูร์ก	Hamburg Rules	๒ มี.ค. ๒๕๔๕
กฎตามสัดส่วน	proportional rule	๒ มี.ค. ๒๕๔๕
กฎตามตัวเลข	Numbered Rule	๒ มี.ค. ๒๕๔๕
กฎตามตัวอักษร	Lettered Rules	๒ มี.ค. ๒๕๔๕
ข้อระบุ	stipulation	๒ มี.ค. ๒๕๔๕
ข้อยกเว้น	exception	๒ มี.ค. ๒๕๔๕
ข้อเพิ่มเติม	addendum	๒ มี.ค. ๒๕๔๕
ข้อกำหนด ๒๔ ชั่วโมง	twenty-four hours clause	๒ มี.ค. ๒๕๔๕
ข้อกำหนดเมมโมแรนดัม	memorandum clause	๒ มี.ค. ๒๕๔๕
ข้อกำหนดเรื่องอุณหภูมิเปลี่ยน	change in temperature clause	๒ มี.ค. ๒๕๔๕
ข้อกำหนดเรือไม่ต้องซ่อม	not under repair	๒ มี.ค. ๒๕๔๕
ข้อกำหนดเรือพี่น้อง	Sister Ship Clause	๒ มี.ค. ๒๕๔๕
ข้อกำหนดระมัดระวังตามควร	reasonable precautions clause	๒ มี.ค. ๒๕๔๕
ข้อกำหนดระหว่างการเดินทาง	transit clause	๒ มี.ค. ๒๕๔๕
ข้อกำหนด	clause	๒ มี.ค. ๒๕๔๕
ข้อกำหนดรับผิดโดยตรง	cut-through clause	๒ มี.ค. ๒๕๔๕
ข้อกำหนดภาวะหนี้สินล้นพ้นตัว	insolvency clause	๒ มี.ค. ๒๕๔๕
ข้อกำหนดภาษีเบี้ยประกันภัย	tax clause	๒ มี.ค. ๒๕๔๕
ข้อกำหนดมาตรฐานเรือ	classification clause	๒ มี.ค. ๒๕๔๕
ข้อกำหนดมูลค่าสูงสุด	peak value clause	๒ มี.ค. ๒๕๔๕
ข้อกำหนดมูลค่าทวิภาค	dual valuation clause	๒ มี.ค. ๒๕๔๕
ข้อกำหนดยกเว้นเนื่องจากน้ำแข็ง	ice exclusion clause	๒ มี.ค. ๒๕๔๕
ข้อกำหนดยกเว้นการจับกุมยึดหน่วง	free of capture and seizure clause	๒ มี.ค. ๒๕๔๕
ข้อกำหนดภัยสงคราม	war clause	๒ มี.ค. ๒๕๔๕
ข้อกำหนดภัยพิบัติร่วมกัน	common disaster clause	๒ มี.ค. ๒๕๔๕
ข้อกำหนดว่าด้วยเสถียรภาพ	"stabilisation clause; <a href=""/coinages/websearch.php?Wd=Stability+clause&amp;Sj=0"">Stability clause</a>"	๒ มี.ค. ๒๕๔๕
ข้อกำหนดว่าด้วยไฟฟ้า	electrical clause	๒ มี.ค. ๒๕๔๕
ข้อกำหนดเกี่ยวกับการประกันภัยอื่น ๆ	other insurance clause	๒ มี.ค. ๒๕๔๕
ข้อกำหนดเกี่ยวกับทุพพลภาพ	disability provision	๒ มี.ค. ๒๕๔๕
ข้อกำหนดเขตอำนาจศาล	jurisdiction clause	๒ มี.ค. ๒๕๔๕
ข้อกำหนดเคลื่อนย้ายซากทรัพย์	debris removal clause	๒ มี.ค. ๒๕๔๕
ข้อกำหนดเจ็ดวัน	seven day clause	๒ มี.ค. ๒๕๔๕
ข้อกำหนดแจนสัน	Janson clause	๒ มี.ค. ๒๕๔๕
ข้อกำหนดส่วนประกอบ(เครื่องบิน)	component parts clause	๒ มี.ค. ๒๕๔๕
ข้อกำหนดสารพัน	omnibus clause	๒ มี.ค. ๒๕๔๕
ข้อกำหนดสถานที่เก็บสินค้า	location clause	๒ มี.ค. ๒๕๔๕
ข้อกำหนดสถาบัน	Institute Clauses	๒ มี.ค. ๒๕๔๕
ข้อกำหนดสุดยอด	paramount clause	๒ มี.ค. ๒๕๔๕
ข้อกำหนดสุดยอดสำหรับภัยสงคราม(สินค้า)	Paramount War Clause (Cargo)	๒ มี.ค. ๒๕๔๕
ข้อกำหนดสุดยอดสำหรับภัยสงคราม(สินค้า)	Paramount War Clause (Cargo)	๒ มี.ค. ๒๕๔๕
ข้อกำหนดสุดยอดสำหรับตัวเรือ	Hull Paramount Clauses	๒ มี.ค. ๒๕๔๕
ข้อกำหนดอำนาจศาลต่างประเทศ	foreign jurisdiction clause	๒ มี.ค. ๒๕๔๕
ข้อกำหนดการยกเว้นภัยสงคราม	war exclusion clause	๒ มี.ค. ๒๕๔๕
ข้อกำหนดการยกเลิกกรมธรรม์	cancellation clause	๒ มี.ค. ๒๕๔๕
ข้อกำหนดการเคลื่อนย้ายชั่วคราว	temporary removal clause	๒ มี.ค. ๒๕๔๕
ข้อกำหนดการเฉลี่ยค่าเสียหาย	average clause	๒ มี.ค. ๒๕๔๕
ข้อกำหนดการใช้อนุญาโตตุลาการ	arbitration clause	๒ มี.ค. ๒๕๔๕
ข้อกำหนดการเบี่ยงเส้นทาง	deviation clause	๒ มี.ค. ๒๕๔๕
ข้อกำหนดการเบี่ยงเส้นทางเนื่องจากน้ำแข็ง	ice deviation clause	๒ มี.ค. ๒๕๔๕
ข้อกำหนดการเปลี่ยนแปลงเส้นทาง	change of voyage clause	๒ มี.ค. ๒๕๔๕
ข้อกำหนดสภาวะพิเศษ	exceptional circumstances clause	๒ มี.ค. ๒๕๔๕
ข้อกำหนดสมาชิกในครอบครัว	relationship clause	๒ มี.ค. ๒๕๔๕
ข้อกำหนดหมุนเวียน	rotation clause	๒ มี.ค. ๒๕๔๕
ข้อกำหนดส่วนรับผิด	binding clause	๒ มี.ค. ๒๕๔๕
ข้อกำหนดส่วนประกอบ(เครื่องบิน)	component parts clause	๒ มี.ค. ๒๕๔๕
ข้อกำหนดอินช์มารี	Inchmaree Clause	๒ มี.ค. ๒๕๔๕
ข้อกำหนดไม่ให้ประโยชน์	Not to Inure clause	๒ มี.ค. ๒๕๔๕
ข้อกำหนดไม่โต้แย้ง	incontestable clause	๒ มี.ค. ๒๕๔๕
ข้อกำหนดไม่เปลี่ยนแปลงเบี้ยประกันภัยต่อ	reinsurance waiver clause	๒ มี.ค. ๒๕๔๕
ข้อกำหนดกระจายการชดใช้	spreader clause	๒ มี.ค. ๒๕๔๕
ข้อกำหนดการเรียกค่าเสียหายและการปฏิบัติการ	sue and labour clause	๒ มี.ค. ๒๕๔๕
ข้อกำหนดการเหมาจ่าย	commutation clause	๒ มี.ค. ๒๕๔๕
ข้อกำหนดการเปลี่ยนชิ้นส่วน	replacement clause	๒ มี.ค. ๒๕๔๕
ข้อกำหนดการเพิ่มหรือคืนเบี้ยประกันภัยจำนวนเล็กน้อย	small additional or return premiums clause	๒ มี.ค. ๒๕๔๕
ข้อกำหนดการสวมสิทธิ์	subrogation clause	๒ มี.ค. ๒๕๔๕
ข้อกำหนดการสิ้นสุดลงทันที	sudden death clause	๒ มี.ค. ๒๕๔๕
ข้อกำหนดการสิ้นสุดการเสี่ยงภัย	termination of adventure clause	๒ มี.ค. ๒๕๔๕
ข้อกำหนดการสละสิทธิ์	waiver clause	๒ มี.ค. ๒๕๔๕
ข้อกำหนดการลากจูงและช่วยเหลือ	Tow and Assist Clause	๒ มี.ค. ๒๕๔๕
ข้อกำหนดการลงนามประทับตรา	attestation clause	๒ มี.ค. ๒๕๔๕
ข้อกำหนดการไม่ร่วมชดใช้	non-contribution clause	๒ มี.ค. ๒๕๔๕
ข้อกำหนดการกำหนดมูลค่า	Valuation clause	๒ มี.ค. ๒๕๔๕
ข้อกำหนดการกู้ภัยและส่วนรับคืน	salvage and recovery clause	๒ มี.ค. ๒๕๔๕
ข้อกำหนดการขาดทุน	deficit clause	๒ มี.ค. ๒๕๔๕
ข้อกำหนดการควบคุมการรับประกันภัยและการเรียกร้องค่าสินไหมทดแทน	underwriting and claims control clause	๒ มี.ค. ๒๕๔๕
ข้อกำหนดการจ่ายพร้อมกัน	simultaneous payments clause	๒ มี.ค. ๒๕๔๕
ข้อกำหนดการจัดการจัดทดแทน	"reinstatement clause; <a href=""/coinages/websearch.php?Wd=reinstatement+memorandum&amp;Sj=0"">reinstatement memorandum</a>"	๒ มี.ค. ๒๕๔๕
ข้อกำหนดการชน	"collision clause; <a href=""/coinages/websearch.php?Wd=running+down+clause&amp;Sj=0"">running down clause</a>"	๒ มี.ค. ๒๕๔๕
ข้อกำหนดการตรวจสอบ	inspection clause	๒ มี.ค. ๒๕๔๕
ข้อกำหนดการต่ออายุกรมธรรม์โดยนัย	tacit renewal clause	๒ มี.ค. ๒๕๔๕
ข้อกำหนดการถูกปิดกั้น	frustration clause	๒ มี.ค. ๒๕๔๕
ข้อกำหนดการประมูล	tender clause	๒ มี.ค. ๒๕๔๕
ข้อกำหนดการประกันภัยต่อเต็มที่	full reinsurance clause	๒ มี.ค. ๒๕๔๕
ข้อกำหนดการประกันภัยต่อความเสียหายสิ้นเชิงเท่านั้น	total loss only reinsurance clause	๒ มี.ค. ๒๕๔๕
ข้อกำหนดการประกันภัยทางทะเลมาตรฐาน	standard marine clause	๒ มี.ค. ๒๕๔๕
ข้อกำหนดการปรับค่า	"escalator clause; <a href=""/coinages/websearch.php?Wd=Up+and+Down+clause&amp;Sj=0"">Up and Down clause</a>"	๒ มี.ค. ๒๕๔๕
ข้อกำหนดการฟ้องคดี	prosecution clause	๒ มี.ค. ๒๕๔๕
ข้อกำหนดกีดกันความสุรุ่ยสุร่าย	spendthrift clause	๒ มี.ค. ๒๕๔๕
ข้อกำหนดกุญแจ	keys clause	๒ มี.ค. ๒๕๔๕
ข้อกำหนดของเจ้าของ	owners’ clause	๒ มี.ค. ๒๕๔๕
ข้อกำหนดความเสมอภาค	parity clause	๒ มี.ค. ๒๕๔๕
ข้อกำหนดความร่วมมือเรื่องค่าสินไหมทดแทน	claims cooperation clause	๒ มี.ค. ๒๕๔๕
ข้อกำหนดความเสียหายต่อครั้ง	one disaster or casualty clause	๒ มี.ค. ๒๕๔๕
ข้อกำหนดความรับผิดต่อผู้เอาประกันภัยเริ่มแรก	primary insurance clause	๒ มี.ค. ๒๕๔๕
ข้อกำหนดความคุมครองโดยอัตโนมัติ	automatic cover clause	๒ มี.ค. ๒๕๔๕
ข้อกำหนดความคุ้มครอง	operative clause	๒ มี.ค. ๒๕๔๕
ข้อกำหนดความประมาทเลินเล่อ	Negligence Clause	๒ มี.ค. ๒๕๔๕
ข้อกำหนดความผิดสองฝ่าย	Both to Blame Collision Clause	๒ มี.ค. ๒๕๔๕
ข้อกำหนดค่าใช้จ่าย	disbursements clause	๒ มี.ค. ๒๕๔๕
ข้อกำหนดค่าใช้จ่ายคงที่ที่ไม่ได้เอาประกันภัย	Uninsured Standing Charges clause	๒ มี.ค. ๒๕๔๕
ข้อกำหนดค่ากู้ภัย	salvage charges clause	๒ มี.ค. ๒๕๔๕
ข้อกำหนดคำสั่งทางการ	Public Authority clause	๒ มี.ค. ๒๕๔๕
ข้อกำหนดคู่และชุด	pair and set clause	๒ มี.ค. ๒๕๔๕
ข้อกำหนดคลองสุเอซ	Suez Canal Clause	๒ มี.ค. ๒๕๔๕
ข้อกำหนดคนกลาง	intermediaries clause	๒ มี.ค. ๒๕๔๕
ข้อกำหนดคนงาน	workmen’s clause	๒ มี.ค. ๒๕๔๕
ข้อกำหนดคุ้มครองทุนเพิ่ม	capital additions clause	๒ มี.ค. ๒๕๔๕
ข้อกำหนดปฏิบัติการโดยพลันตามควร	reasonable despatch clause	๒ มี.ค. ๒๕๔๕
ข้อกำหนดผู้เอาประกันภัยร่วม	joint insured clause	๒ มี.ค. ๒๕๔๕
ข้อกำหนดผู้รับจำนอง	mortgage clause	๒ มี.ค. ๒๕๔๕
ข้อกำหนดผู้รับฝากทรัพย์	bailee clause	๒ มี.ค. ๒๕๔๕
ข้อกำหนดผลิตภัณฑ์เป็นรุ่น	batch clause	๒ มี.ค. ๒๕๔๕
ข้อกำหนดพิเศษประสบการณ์ความเสียหาย	special records clause	๒ มี.ค. ๒๕๔๕
ข้อกำหนดดัชนี	index clause	๒ มี.ค. ๒๕๔๕
ข้อกำหนดต่อท้าย	rider	๒ มี.ค. ๒๕๔๕
ข้อกำหนดตัวแดง	red line clause	๒ มี.ค. ๒๕๔๕
ข้อกำหนดนักบัญชี	accountants clause	๒ มี.ค. ๒๕๔๕
ข้อกำหนดบอกเลิกสัญญา	escape clause	๒ มี.ค. ๒๕๔๕
ข้อกำหนดจ่ายค่าสินไหมทดแทนบางส่วน	partial indemnity clause	๒ มี.ค. ๒๕๔๕
ข้อกำหนดจำนวนชั่วโมง	hours clause	๒ มี.ค. ๒๕๔๕
ข้อกำหนดฉลากสินค้า	label clause	๒ มี.ค. ๒๕๔๕
ข้อกำหนดฉบับต้น	original terms	๒ มี.ค. ๒๕๔๕
ข้อกำหนดชดใช้ตามสัญญาซื้อขาย	contract price clause	๒ มี.ค. ๒๕๔๕
ข้อกำหนดญาติทางสายเลือด	"blood relative clause; <a href=""/coinages/websearch.php?Wd=Da+Costa+clause&amp;Sj=0"">Da Costa clause</a>"	๒ มี.ค. ๒๕๔๕
ข้อกำหนดฐานราก	foundation clause	๒ มี.ค. ๒๕๔๕
ข้อกำหนดดอกเบี้ย	interest clause	๒ มี.ค. ๒๕๔๕
ข้อความจริงอันเป็นสาระสำคัญ	material fact	๒ มี.ค. ๒๕๔๕
ข้อจำกัดความคุ้มครอง	exclusion	๒ มี.ค. ๒๕๔๕
ข้อจำกัดความคุ้มครองภัยนิวเคลียร์	Nuclear Exclusion	๒ มี.ค. ๒๕๔๕
ข้อจำกัดความคุ้มครองจำเพาะ	specific exclusion	๒ มี.ค. ๒๕๔๕
ข้อตกลงไม่เรียกร้องต่อกัน	knock-for-knock agreement	๒ มี.ค. ๒๕๔๕
ข้อตกลงไขว้	cross purchase agreement	๒ มี.ค. ๒๕๔๕
ข้อตกลงการเสี่ยงภัยสงคราม	war risks agreement	๒ มี.ค. ๒๕๔๕
ข้อตกลงการแบ่งภาระค่าสินไหมทดแทน	claims sharing agreement	๒ มี.ค. ๒๕๔๕
ข้อตกลงเงื่อนไขทอง	Gold Clause Agreement	๒ มี.ค. ๒๕๔๕
ข้อตกลงในสลิป	slip agreement	๒ มี.ค. ๒๕๔๕
ข้อตกลงแบ่งครึ่ง	halving agreement	๒ มี.ค. ๒๕๔๕
ข้อตกลงระยะยาว	long-term agreement	๒ มี.ค. ๒๕๔๕
ข้อตกลงรับชดใช้	hold-harmless agreement	๒ มี.ค. ๒๕๔๕
ข้อตกลงการกู้ภัย	salvage agreement	๒ มี.ค. ๒๕๔๕
ข้อตกลงของทรัสต์	trust agreement	๒ มี.ค. ๒๕๔๕
ข้อตกลงความเสียหายร่วม	general average agreement	๒ มี.ค. ๒๕๔๕
ข้อตกลงคุ้มครองบนพื้นน้ำ	Waterborne Agreement	๒ มี.ค. ๒๕๔๕
ข้อตกลงต่ออายุ	renewal agreement	๒ มี.ค. ๒๕๔๕
ข้อตกลงผู้รับประกันภัยนำ	Leading Underwriter’s Agreement	๒ มี.ค. ๒๕๔๕
ข้อบกพร่องแฝง	latent defect	๒ มี.ค. ๒๕๔๕
ข่าวสารสถาบันลอยด์	Lloyd’s List	๒ มี.ค. ๒๕๔๕
ข่าวสารการเดินเรือของสถาบันลอยด์	Lloyd’s Shipping Index	๒ มี.ค. ๒๕๔๕
ของใหม่แทนของเก่า	new for old	๒ มี.ค. ๒๕๔๕
ขาดอายุ	lapse	๒ มี.ค. ๒๕๔๕
ขีดการจ่ายหมด	datum level	๒ มี.ค. ๒๕๔๕
ขีดความสามารถของตลาดรับประกันภัย	market capacity	๒ มี.ค. ๒๕๔๕
ขีดจำกัด	limit	๒ มี.ค. ๒๕๔๕
ขีดจำกัดเก็บสินค้า	name limit	๒ มี.ค. ๒๕๔๕
ขีดจำกัดในเขตรับประกันภัย	block limit	๒ มี.ค. ๒๕๔๕
ขีดจำกัดเบี้ยประกันภัย	premium limit	๒ มี.ค. ๒๕๔๕
ขีดจำกัดส่วนเก็บไว้	retention limits	๒ มี.ค. ๒๕๔๕
ขีดจำกัดสถานที่เก็บสินค้า	location limit	๒ มี.ค. ๒๕๔๕
ขีดจำกัดการชดใช้ค่าสินไหมทดแทน	limit of indemnity	๒ มี.ค. ๒๕๔๕
ขีดจำกัดความรับผิด	limit of liability	๒ มี.ค. ๒๕๔๕
ขีดปลอดความรับผิด	franchise	๒ มี.ค. ๒๕๔๕
ขึ้นอยู่กับการเฉลี่ยค่าเสียหาย	subject to average	๒ มี.ค. ๒๕๔๕
ขึ้นอยู่กับการสำรวจ	subject to survey	๒ มี.ค. ๒๕๔๕
คระผู้ร่วมรับประกันภัยตัวเรือ	hull syndicate	๒ มี.ค. ๒๕๔๕
ครบกำหนด	maturity	๒ มี.ค. ๒๕๔๕
ความเสียหายเฉพาะ	particular average (loss)	๒ มี.ค. ๒๕๔๕
ความเสียหายสิ้นเชิง	total loss	๒ มี.ค. ๒๕๔๕
ความเสียหายสิ้นเชิงเฉพาะส่วน	total loss of part	๒ มี.ค. ๒๕๔๕
ความเสียหายสิ้นเชิงเท่านั้น	total loss only	๒ มี.ค. ๒๕๔๕
ความเสียหายสิ้นเชิงแท้จริง	actual total loss	๒ มี.ค. ๒๕๔๕
ความเสียหายสิ้นเชิงของตัวเรือเท่านั้น	total loss of vessel only	๒ มี.ค. ๒๕๔๕
ความเสียหายสิ้นเชิงตามตกลง	arranged total loss	๒ มี.ค. ๒๕๔๕
ความเสียหาย	average	๒ มี.ค. ๒๕๔๕
ความเสียหายร่วม	general average	๒ มี.ค. ๒๕๔๕
ความเสียหายจากการสั่นสะเทือนเพราะแผ่นดินไหว	earthquake shock damage	๒ มี.ค. ๒๕๔๕
ความเสียหายจากการกระแทก	contact damage	๒ มี.ค. ๒๕๔๕
ความเสียหายจากการกลั่นแกล้ง	malicious damage	๒ มี.ค. ๒๕๔๕
ความเสียหายจากการดูดสิ่งแปลกปลอม	ingestion damage	๒ มี.ค. ๒๕๔๕
ความเสียหายจากการถูกกระแทก	impact damage	๒ มี.ค. ๒๕๔๕
ความเสียหายจากควัน	smoke damage	๒ มี.ค. ๒๕๔๕
ความเสียหายจากผลกระทบ	sympathetic damage	๒ มี.ค. ๒๕๔๕
ความเสียหายฉับพลันโดยไม่คาดคิด	sudden and unforeseen damage	๒ มี.ค. ๒๕๔๕
ความเสียหายสูงสุดโดยประมาณ	estimated maximum loss	๒ มี.ค. ๒๕๔๕
ความเสียหายสูงสุดที่อาจเกิดขึ้น	"maximum possible loss; <a href=""/coinages/websearch.php?Wd=possible+maximum+loss&amp;Sj=0"">possible maximum loss</a>"	๒ มี.ค. ๒๕๔๕
ความเสียหายสูงสุดที่น่าจะเป็น	"maximum probable loss; <a href=""/coinages/websearch.php?Wd=probable+maximum+loss&amp;Sj=0"">probable maximum loss</a>"	๒ มี.ค. ๒๕๔๕
ความเสียหายสืบจากท้องถิ่น	country damage	๒ มี.ค. ๒๕๔๕
ความเสียหายสุทธิขั้นสุดท้าย	ultimate net loss	๒ มี.ค. ๒๕๔๕
ความเสียหายไกลกว่าเหตุ	remoteness of damage	๒ มี.ค. ๒๕๔๕
ความเสียหายของรถที่เอาประกันภัย	own damage	๒ มี.ค. ๒๕๔๕
ความเสียหายจากอัคคีภัย	fire loss	๒ มี.ค. ๒๕๔๕
ความเสียหายจากไฟเพราะแผ่นดินไหว	earthquake fire damage	๒ มี.ค. ๒๕๔๕
ความเสียหายทีเกิดขึ้นแล้ว	incurred losses	๒ มี.ค. ๒๕๔๕
ความเสียหายที่เสมือนเสียหายสิ้นเชิง	constructive total loss	๒ มี.ค. ๒๕๔๕
ความเสียหายบางส่วน	partial loss	๒ มี.ค. ๒๕๔๕
ความเสี่ยงภัยเชิงวัตถุวิสัย	objective risk	๒ มี.ค. ๒๕๔๕
ความเสี่ยงภัยเชิงจิตวิสัย	subjective risk	๒ มี.ค. ๒๕๔๕
ความรับผิดมีเงื่อนไข	contingent liability	๒ มี.ค. ๒๕๔๕
ความรับผิดเดี่ยว	single liability	๒ มี.ค. ๒๕๔๕
ความรับผิดสิ้นเชิง	strict liability	๒ มี.ค. ๒๕๔๕
ความรับผิดของเจ้าของ	owner’s liability	๒ มี.ค. ๒๕๔๕
ความรับผิดของเจ้าของโรงแรม	innkeeper’s liability	๒ มี.ค. ๒๕๔๕
ความรับผิดของเจ้าของเรือ	shipowner’s liability	๒ มี.ค. ๒๕๔๕
ความรับผิดของผู้เช่า	tenant’s liability	๒ มี.ค. ๒๕๔๕
ความรับผิดของผู้ลงนามแทน	subscription	๒ มี.ค. ๒๕๔๕
ความรับผิดต่อผู้โดยสาร	passenger liability	๒ มี.ค. ๒๕๔๕
ความรับผิดตามสัญญา	contractual liability	๒ มี.ค. ๒๕๔๕
ความรับผิดติดพัน	run-off liability	๒ มี.ค. ๒๕๔๕
ความรับผิดปฏิพันธ์	cross liability	๒ มี.ค. ๒๕๔๕
ความรุนแรงของอุบัติเหตุ	accident severity	๒ มี.ค. ๒๕๔๕
ความสะดวกในการจ่ายเงิน	facility of payment	๒ มี.ค. ๒๕๔๕
ความสิ้นสภาพ	loss of specie	๒ มี.ค. ๒๕๔๕
ความสูญเสีย	loss	๒ มี.ค. ๒๕๔๕
ความสูญเสียค่าทางใจ	sentimental loss	๒ มี.ค. ๒๕๔๕
ความสูญเสียจากซากทรัพย์	salvage loss	๒ มี.ค. ๒๕๔๕
ความสุจริตใจ	good faith	๒ มี.ค. ๒๕๔๕
ความสุจริตใจอย่างยิ่ง	"uberrima fides; <a href=""/coinages/websearch.php?Wd=utmost+gook+faith&amp;Sj=0"">utmost gook faith</a>"	๒ มี.ค. ๒๕๔๕
ความไม่สมประกอบ	invalidity	๒ มี.ค. ๒๕๔๕
ความคุ้มครอง	"coverage; <a href=""/coinages/websearch.php?Wd=protection&amp;Sj=0"">protection</a>"	๒ มี.ค. ๒๕๔๕
ความคุ้มครองเมื่อตรวจพบ	discovery cover	๒ มี.ค. ๒๕๔๕
ความคุ้มครองภาษีมูลค่าเพิ่ม	Value Added Tax cover	๒ มี.ค. ๒๕๔๕
ความคุ้มครองการส่งมอบ	delivery guarantee cover	๒ มี.ค. ๒๕๔๕
ความคุ้มครองการจ่ายเงินล่วงหน้า	anticipatory credit cover	๒ มี.ค. ๒๕๔๕
ความคุ้มครองการจี้ปล้น	hold-up cover	๒ มี.ค. ๒๕๔๕
ความคุ้มครองการผิดสัญญา	breach of contract cover	๒ มี.ค. ๒๕๔๕
ความคุ้มครองงานที่ดำเนินอยู่	work in progress cover	๒ มี.ค. ๒๕๔๕
ความคุ้มครองจ่ายหมดเมื่อถึงขีด	datum line cover	๒ มี.ค. ๒๕๔๕
ความคุ้มครองช่วงชั้นปรกติ	working cover	๒ มี.ค. ๒๕๔๕
ความคุ้มครองต้นฉบับ	original cover	๒ มี.ค. ๒๕๔๕
ความคุ้มครองต้นทุนเพิ่ม	cost escalation cover	๒ มี.ค. ๒๕๔๕
ความคุ้มครองมูลค่าจัดทดแทน	notional reinstatement value cover	๒ มี.ค. ๒๕๔๕
ความคุ้มครองโดยอัตโนมัติ	automatic cover	๒ มี.ค. ๒๕๔๕
ความคุ้มครองแบบครอบคลุม	umbrella cover	๒ มี.ค. ๒๕๔๕
ความคุ้มครองเปิด	open cover	๒ มี.ค. ๒๕๔๕
ความคุ้มครองวินาศภัยตามสัญญา	loss sustained cover	๒ มี.ค. ๒๕๔๕
ความคุ้มครองสองเท่า	double protection	๒ มี.ค. ๒๕๔๕
ความคุ้มครองอัตราแลกเปลี่ยนล่วงหน้า	forward exchange rate cover	๒ มี.ค. ๒๕๔๕
ความคุ้มครองการรับประกันภัย	underwriting cover	๒ มี.ค. ๒๕๔๕
ความดูแลรักษาและควบคุม	custody and control	๒ มี.ค. ๒๕๔๕
ความต้านทางอัคคีภัย	fire resistance	๒ มี.ค. ๒๕๔๕
ความถี่ของอุบัติเหตุ	accident frequency	๒ มี.ค. ๒๕๔๕
ความน่าจะเป็นแบบมีเงื่อนไข	conditional probability	๒ มี.ค. ๒๕๔๕
ความประพฤติผิดโดยจงใจ	wilful misconduct	๒ มี.ค. ๒๕๔๕
ความประมาทร่วม	contributory negligence	๒ มี.ค. ๒๕๔๕
ค่าระวางที่คาดไว้	anticipated freight	๒ มี.ค. ๒๕๔๕
ค่าระวางปรกติ	ordinary freight	๒ มี.ค. ๒๕๔๕
ค่าเสียเวลา	demurrage	๒ มี.ค. ๒๕๔๕
ค่าเสียหาย	damages	๒ มี.ค. ๒๕๔๕
ค่าเสียหายแท้จริง	pure burning cost	๒ มี.ค. ๒๕๔๕
ค่าเสียหายพื้นฐาน	burning cost	๒ มี.ค. ๒๕๔๕
ค่าใช้จ่ายเฉพาะ	particular charges	๒ มี.ค. ๒๕๔๕
ค่าใช้จ่ายในการสู้คดี	litigation costs and expenses	๒ มี.ค. ๒๕๔๕
ค่าใช้จ่ายในการขาย	acquisition cost	๒ มี.ค. ๒๕๔๕
ค่าใช้จ่ายสำหรับแผน	scheme charges	๒ มี.ค. ๒๕๔๕
ค่าใช้จ่ายการเดินเรือ	disbursements	๒ มี.ค. ๒๕๔๕
ค่าใช้จ่ายความเสียหายร่วม	general average expenditure	๒ มี.ค. ๒๕๔๕
ค่าใช้จ่ายคงที่	standing charges	๒ มี.ค. ๒๕๔๕
ค่าใช้จ่ายที่ไม่ได้เอาประกันภัย	uninsured working expenses	๒ มี.ค. ๒๕๔๕
ค่าใช้จ่ายบวกเพิ่ม	expense loading	๒ มี.ค. ๒๕๔๕
ค่าใช้จ่ายประจำ	oncost	๒ มี.ค. ๒๕๔๕
ค่าใช้จ่ายปรับสภาพ	reconditioning charges	๒ มี.ค. ๒๕๔๕
ค่าสินไหมทดแทน	"claim; <a href=""/coinages/websearch.php?Wd=loss&amp;Sj=0"">loss</a>"	๒ มี.ค. ๒๕๔๕
ค่าสินไหมทดแทนเรียกคืนทันที	cash loss	๒ มี.ค. ๒๕๔๕
ค่าสินไหมทดแทนยืดเยื้อ	long-tail claims	๒ มี.ค. ๒๕๔๕
ค่ากู้ภัย	salvage; salvage charges	๒ มี.ค. ๒๕๔๕
ค่าขนส่งต่อ	forwarding charges	๒ มี.ค. ๒๕๔๕
ค่าจัดการค่าสินไหมทดแทน	claims expenses	๒ มี.ค. ๒๕๔๕
ค่าต่างตอบแทน	consideration	๒ มี.ค. ๒๕๔๕
ค่าต่างตอบแทนลมเหลว	failure of consideration	๒ มี.ค. ๒๕๔๕
ค่าตอบแทนจัดหาประกันภัย	procuration fee	๒ มี.ค. ๒๕๔๕
ค่าธรรมเนียมกรมธรรม์	policy fee	๒ มี.ค. ๒๕๔๕
ค่าบำเหน็จ	commission	๒ มี.ค. ๒๕๔๕
ค่าบำเหน็จรับสินไหมทดแทน	collecting commission	๒ มี.ค. ๒๕๔๕
ค่าบำเหน็จกำไร	profit commission	๒ มี.ค. ๒๕๔๕
ค่าบำเหน็จกำไรเพิ่มพิเศษ	super profit commission	๒ มี.ค. ๒๕๔๕
ค่าบำเหน็จจ่ายคืน	return commission	๒ มี.ค. ๒๕๔๕
ค่าบำเหน็จนายหน้า	brokerage	๒ มี.ค. ๒๕๔๕
ค่าบำเหน็จนายหน้าอัตราเลื่อน	sliding scale commission	๒ มี.ค. ๒๕๔๕
ค่าประกันภัย	cost of insurance	๒ มี.ค. ๒๕๔๕
คำรับรอง	warrant	๒ มี.ค. ๒๕๔๕
คำรับรองเรือ ๒ ลำ	two vessel warranty	๒ มี.ค. ๒๕๔๕
คำรับรองภัย ๒ ราย	two risks warranty	๒ มี.ค. ๒๕๔๕
คำรับรองเขตเส้นทาง	trading warranties	๒ มี.ค. ๒๕๔๕
คำรับรองเครื่องบิน ๒ ลำ	two plane warranty	๒ มี.ค. ๒๕๔๕
คำรับรองโดยนัย	implied warranty	๒ มี.ค. ๒๕๔๕
คำรับรองแท่นเจาะ ๒ แท่น	two rig warranty	๒ มี.ค. ๒๕๔๕
คำรับรองเป็นลายลักษณ์อักษร	express warranty	๒ มี.ค. ๒๕๔๕
คำรับรองสถาบัน	Institute Warranties	๒ มี.ค. ๒๕๔๕
คำรับรองอเมริกาเหนือ	North American Warranty	๒ มี.ค. ๒๕๔๕
คำรับรองการเดินเรือ	sailing warranty	๒ มี.ค. ๒๕๔๕
คำรับรองความเสียหายทรัพย์สิน	material damage warranty	๒ มี.ค. ๒๕๔๕
คำแถลง	declaration	๒ มี.ค. ๒๕๔๕
คำยืนยันแน่นอน	definite advice	๒ มี.ค. ๒๕๔๕
คำขอเอาประกัน	"application; <a href=""/coinages/websearch.php?Wd=proposal&amp;Sj=0"">proposal</a>"	๒ มี.ค. ๒๕๔๕
คำชี้ขาด	award	๒ มี.ค. ๒๕๔๕
คู่มือ	manual	๒ มี.ค. ๒๕๔๕
คู่มือการรับประกันภัย	manual underwriting	๒ มี.ค. ๒๕๔๕
คลื่นสึนามิ	tsunami	๑๐ ม.ค. ๒๕๔๘
คณะกรรมการแห่งลอยด์	Committee of Lloyd’s	๒ มี.ค. ๒๕๔๕
คณะผู้ร่วม(รับประกัน)	Syndicate	๒ มี.ค. ๒๕๔๕
คณะผู้ร่วม(รับประกัน)	Syndicate	๒ มี.ค. ๒๕๔๕
คณะผู้ร่วมรับประกันภัยของสถาบันลอยด์	Lloyd’s Syndicate	๒ มี.ค. ๒๕๔๕
คนกลาง	intermediary	๒ มี.ค. ๒๕๔๕
คนชาติศัตรู	alien enemy	๒ มี.ค. ๒๕๔๕
งบความรับผิดติดพัน	run-off statement	๒ มี.ค. ๒๕๔๕
จ่ายตามสินค้า	to pay as cargo	๒ มี.ค. ๒๕๔๕
จำนวนมรณะที่คาดหมาย	expected mortality	๒ มี.ค. ๒๕๔๕
จำนวนเงินเสี่ยงภัย	amount at risk	๒ มี.ค. ๒๕๔๕
จำนวนเงินเสี่ยงภัยสุทธิ	net amount at risk	๒ มี.ค. ๒๕๔๕
จำนวนเงินเอาประกันภัย	face amount	๒ มี.ค. ๒๕๔๕
จำนวนเงินก้อน	capital sum	๒ มี.ค. ๒๕๔๕
จำนวนเงินประกันภัยที่จ่าย	proceeds	๒ มี.ค. ๒๕๔๕
จำนวนสุทธิสัมบูรณ์	net absolute(ly)	๒ มี.ค. ๒๕๔๕
จำนวนค่าสินไหมทดแทน	pure lost cost	๒ มี.ค. ๒๕๔๕
จำนวนจำกัดความรับผิดรวม	aggregated limit of indemnity	๒ มี.ค. ๒๕๔๕
จดหมายสนองรับ	acceptance letter	๒ มี.ค. ๒๕๔๕
ชมรมความคุ้มครองและการชดใช้ (ชมรมพีแอนด์ไอ)	Protection and Indemnity Club	๒ มี.ค. ๒๕๔๕
ชมรมประกันภัยกันและกัน	reciprocal exchange	๒ มี.ค. ๒๕๔๕
ชมรมพีแอนด์ไอ (ชมรมความคุ้มครองและการชดใช้)	Protection and Indemnity Club	๒ มี.ค. ๒๕๔๕
ช่วงเวลารับผิดส่วนแรก	time excess	๒ มี.ค. ๒๕๔๕
ช่วงเวลาไม่ใช่อัตราปรกติ	apprehensive period	๒ มี.ค. ๒๕๔๕
ช่วงเวลาปลอดประโยชน์	blackout period	๒ มี.ค. ๒๕๔๕
ช่วงเสียเวลา	demurrage	๒ มี.ค. ๒๕๔๕
ช่วงชั้นความรับผิด	layer	๒ มี.ค. ๒๕๔๕
ช่วงชั้นปรกติ	working layer	๒ มี.ค. ๒๕๔๕
ชีวิตต่ำกว่ามาตรฐาน	substandard life	๒ มี.ค. ๒๕๔๕
ชำรุดเสียหาย	breakdown	๒ มี.ค. ๒๕๔๕
ชีวิตที่เอาประกันภัย	life assured	๒ มี.ค. ๒๕๔๕
ซากทรัพย์	salvage	๒ มี.ค. ๒๕๔๕
ดอกเบี้ยส่วนเกิน	excess interest	๒ มี.ค. ๒๕๔๕
ดัชนีสถานที่ตั้ง	situation index	๒ มี.ค. ๒๕๔๕
ดัชนีการเสี่ยงภัย	risk index	๒ มี.ค. ๒๕๔๕
ตะปูถึงตะปู	nail to nail	๒ มี.ค. ๒๕๔๕
ต่ำกว่าส่วนตกลง	short closing	๒ มี.ค. ๒๕๔๕
ต้นทุนสุทธิ	net cost	๒ มี.ค. ๒๕๔๕
ตัวแทน	agent	๒ มี.ค. ๒๕๔๕
ตัวแทนเรียกร้องส่วนรับคืน	recovery agent	๒ มี.ค. ๒๕๔๕
ตัวแทนรอง	sub-agent	๒ มี.ค. ๒๕๔๕
ตัวแทนรับประกันภัย	underwriting agent	๒ มี.ค. ๒๕๔๕
ตัวแทนเครดิต	credit agent	๒ มี.ค. ๒๕๔๕
ตัวแทนเงินเชื่อ	account agent	๒ มี.ค. ๒๕๔๕
ตัวแทนเงินสด	cash agent	๒ มี.ค. ๒๕๔๕
ตัวแทนสถาบัน	Institute Agent	๒ มี.ค. ๒๕๔๕
ตัวแทนไม่เต็มเวลา	part time agent	๒ มี.ค. ๒๕๔๕
ตัวแทนของสถาบันลอยด์	Lloyd’s Agent	๒ มี.ค. ๒๕๔๕
ตัวแทนค่าสินไหมทดแทน	claim agent	๒ มี.ค. ๒๕๔๕
ตัวแทนจัดการความเสียหาย	average agent	๒ มี.ค. ๒๕๔๕
ตัวแทนจัดการค่าสินไหมทดแทน	claims-settling agent	๒ มี.ค. ๒๕๔๕
ตัวแทนตกลงค่าสินไหมทดแทน	settling agent	๒ มี.ค. ๒๕๔๕
ตัวแทนประกันภัย	insurance agent	๒ มี.ค. ๒๕๔๕
ตัวแทนผู้รับประกันภัยของสถาบันลอยด์	Lloyd’s Underwriter Agent	๒ มี.ค. ๒๕๔๕
ตัวการ	principal	๒ มี.ค. ๒๕๔๕
ตัวปรับตามเงินเฟ้อ	inflation factor	๒ มี.ค. ๒๕๔๕
ตามสัดส่วน	with proportion	๒ มี.ค. ๒๕๔๕
ตารางมรณวิสัยซีเอสโอ ๑๙๔๑	Commissioners’ 1941 Standard Ordinary Table	๒ มี.ค. ๒๕๔๕
ตารางมรณวิสัยซีเอสโด ๑๙๕๘	Commissioners’ 1958 Standard Ordinary Table	๒ มี.ค. ๒๕๔๕
ตารางรายการ	select mortality	๒ มี.ค. ๒๕๔๕
ตารางมรณวิสัย	mortality table	๒ มี.ค. ๒๕๔๕
ตารางมรณวิสัยของสหรัฐอเมริกา	American Experience Table of Mortality	๒ มี.ค. ๒๕๔๕
ตารางมรณวิสัยคัดเลือก	select mortality table	๒ มี.ค. ๒๕๔๕
ตารางอัตราทุพพลภาพ	disability percentage table	๒ มี.ค. ๒๕๔๕
ตารางกรมธรรม์	schedule	๒ มี.ค. ๒๕๔๕
ตารางขีดจำกัด	table of limits	๒ มี.ค. ๒๕๔๕
ตารางความเจ็บป่วย	"morbidity table; <a href=""/coinages/websearch.php?Wd=sickness+table&amp;Sj=0"">sickness table</a>"	๒ มี.ค. ๒๕๔๕
ตารางส่วนรับประกันภัย	line sheet	๒ มี.ค. ๒๕๔๕
ตารางน้ำหนักและส่วนสูง	weight and height table	๒ มี.ค. ๒๕๔๕
ตารางผู้รับประกันภัย	signing table	๒ มี.ค. ๒๕๔๕
ตามกรมธรรม์ฉบับต้น	as original	๒ มี.ค. ๒๕๔๕
ถือว่าคุ้มครองแล้ว	held covered	๒ มี.ค. ๒๕๔๕
ทรัสต์	trust	๒ มี.ค. ๒๕๔๕
ทรัสต์มีผลระหว่างมีชีวิต	inter-vivos trust	๒ มี.ค. ๒๕๔๕
ทรัสต์ที่เปลี่ยนแปลงไม่ได้	irrevocable trust	๒ มี.ค. ๒๕๔๕
ทรัสต์ที่ไม่ตั้งกองทุน	unfunded trust	๒ มี.ค. ๒๕๔๕
ทรัสต์ประกันชีวิต	life insurance trust	๒ มี.ค. ๒๕๔๕
ทรัสตี	trustee	๒ มี.ค. ๒๕๔๕
ทรัพย์สินสละทิ้ง	made good	๒ มี.ค. ๒๕๔๕
ทรัพย์สินที่มีตัวตน	material property	๒ มี.ค. ๒๕๔๕
ท่าเรืออนุญาต	sufferance wharf	๒ มี.ค. ๒๕๔๕
ท่าถึงท่า	"port to port; <a href=""/coinages/websearch.php?Wd=quay+to+quay&amp;Sj=0"">quay to quay</a>"	๒ มี.ค. ๒๕๔๕
ทั่วโลก	World to World	๒ มี.ค. ๒๕๔๕
ทางสื่อไฟ	communication	๒ มี.ค. ๒๕๔๕
ทุนสำรองสุดท้าย	"clean-up fund; <a href=""/coinages/websearch.php?Wd=final+expenses+fund&amp;Sj=0"">final expenses fund</a>"	๒ มี.ค. ๒๕๔๕
ทุพพลภาพสิ้นเชิง	total disablement	๒ มี.ค. ๒๕๔๕
ทุพพลภาพชั่วคราว	temporary disablement	๒ มี.ค. ๒๕๔๕
ทุพพลภาพถาวร	permanent disablement	๒ มี.ค. ๒๕๔๕
ทุพพลภาพบางส่วน	partial disablement	๒ มี.ค. ๒๕๔๕
ธุรกิจใหม่	new business	๒ มี.ค. ๒๕๔๕
ธุรกิจเอาประกันภัยต่อ	outwards reinsurance	๒ มี.ค. ๒๕๔๕
ธุรกิจรับประกันภัยต่อ	inwards reinsurance	๒ มี.ค. ๒๕๔๕
ธุรกิจเกื้อกูล	accommodation business	๒ มี.ค. ๒๕๔๕
ธุรกิจโดยตรง	direct business	๒ มี.ค. ๒๕๔๕
ธุรกิจตัวแทน	agency	๒ มี.ค. ๒๕๔๕
ธุรกิจผ่านคนกลาง	indirect business	๒ มี.ค. ๒๕๔๕
น้ำหนักเพิ่ม	overage	๒ มี.ค. ๒๕๔๕
น้ำค้างแข็ง	frost	๒ มี.ค. ๒๕๔๕
นักคณิตศาสตร์ประกันภัย	actuary	๒ มี.ค. ๒๕๔๕
นายหน้า	broker	๒ มี.ค. ๒๕๔๕
นายหน้าประกันภัย	insurance broker	๒ มี.ค. ๒๕๔๕
นายหน้าประกันภัยของสถาบันลอยด์	Lloyd’s Broker	๒ มี.ค. ๒๕๔๕
นายหน้าประกันภัยต่อ	reinsurance broker	๒ มี.ค. ๒๕๔๕
นามผู้รับประกันภัยแห่งสถาบันลอยด์	Name	๒ มี.ค. ๒๕๔๕
บริษัทรวมหุ้น	stock company	๒ มี.ค. ๒๕๔๕
บริษัทเอาประกันภัยต่อ	ceding company	๒ มี.ค. ๒๕๔๕
บริษัทเอกเทศ	independent company	๒ มี.ค. ๒๕๔๕
บริษัทประกันภัยแบบสหการ	mutual insurance company	๒ มี.ค. ๒๕๔๕
บริษัทประกันภัยค้ำประกัน	surety company	๒ มี.ค. ๒๕๔๕
บริษัทประกันชีวิต	life insurance company	๒ มี.ค. ๒๕๔๕
บริษัทประกันชีวิตแบบรวม	combination company	๒ มี.ค. ๒๕๔๕
บริษัทประกันชีวิตแบบสหการ	mutual life insurance company	๒ มี.ค. ๒๕๔๕
บริษัทประกันชีวิตแบบผสม	mixed company	๒ มี.ค. ๒๕๔๕
บริษัทต่างรัฐ	foreign company	๒ มี.ค. ๒๕๔๕
บริษัทต่างประเทศ	alien company	๒ มี.ค. ๒๕๔๕
บริษัทที่ไม่ได้รับอนุญาต	non-admitted company	๒ มี.ค. ๒๕๔๕
บริษัทที่ไม่ได้เป็นสมาชิกของสถาบัน	non-Institute company	๒ มี.ค. ๒๕๔๕
บริษัทนอกพิกัดอัตรา	non-tariff company	๒ มี.ค. ๒๕๔๕
บริษัทประกันภัยในอาณัติ	captive insurance company	๒ มี.ค. ๒๕๔๕
บริษัทรับหน้า	fronting company	๒ มี.ค. ๒๕๔๕
บริษัทรับประกันภัยต่อ	assuming company	๒ มี.ค. ๒๕๔๕
บริษัทภายในประเทศ	domestic company	๒ มี.ค. ๒๕๔๕
บริษัทใช้พิกัดอัตรา	tariff company	๒ มี.ค. ๒๕๔๕
บัญชีระบบรวม	gross system	๒ มี.ค. ๒๕๔๕
บัญชีย่อยจ่าย	deferred account	๒ มี.ค. ๒๕๔๕
บัญชีรายชื่อคณะผู้ร่วม(รับประกันภัย)	Syndicate List	๒ มี.ค. ๒๕๔๕
บัญชีรายชื่อคณะผู้ร่วม(รับประกันภัย)	Syndicate List	๒ มี.ค. ๒๕๔๕
บัญชีเงินสำรอง	reserve account	๒ มี.ค. ๒๕๔๕
บัญชีสามปี	three-year accounting	๒ มี.ค. ๒๕๔๕
บัญญัติหนังสือสัญญา	statue of frauds	๒ มี.ค. ๒๕๔๕
บัตรเขียว	green card	๒ มี.ค. ๒๕๔๕
บัตรเงินรายปี	annuity bond	๒ มี.ค. ๒๕๔๕
บันทึกแจ้งเบี้ยประกันภัย	premium advice note	๒ มี.ค. ๒๕๔๕
บันทึกของผู้เจรจาตกลง	adjusters’ note	๒ มี.ค. ๒๕๔๕
บันทึกงบประกันภัยต่อ	bordereau	๒ มี.ค. ๒๕๔๕
บางส่วน	part of	๒ มี.ค. ๒๕๔๕
บทนำกรมธรรม์	"preamble; <a href=""/coinages/websearch.php?Wd=recital+clause&amp;Sj=0"">recital clause</a>"	๒ มี.ค. ๒๕๔๕
บทบัญญัติ	provision	๒ มี.ค. ๒๕๔๕
บุคคลภายนอก	third party	๒ มี.ค. ๒๕๔๕
บุคคลสมทบ	counter life	๒ มี.ค. ๒๕๔๕
ประเภทของการประกันภัย	line	๒ มี.ค. ๒๕๔๕
ปราศจากขีดปลอดความผิด	"irrespective of percentage (<a href=""/coinages/websearch.php?Wd=i.o.p.&amp;Sj=0"">i.o.p.</a>)"	๒ มี.ค. ๒๕๔๕
ปีกรมธรรม์	policy year	๒ มี.ค. ๒๕๔๕
ปีปลอดเบี้ยประกันภัย	year free of premium	๒ มี.ค. ๒๕๔๕
ปลอดความเสียหายเฉพาะ	free of particular average	๒ มี.ค. ๒๕๔๕
ผู้เอาประกันภัย	"assured; <a href=""/coinages/websearch.php?Wd=insured&amp;Sj=0"">insured</a>"	๒ มี.ค. ๒๕๔๕
ผู้เอาประกันภัยเดิม	original insured	๒ มี.ค. ๒๕๔๕
ผู้เอาประกันภัยต่อ	"cedant; <a href=""/coinages/websearch.php?Wd=cedent&amp;Sj=0"">cedent</a>; <a href=""/coinages/websearch.php?Wd=reassured&amp;Sj=0"">reassured</a>; <a href=""/coinages/websearch.php?Wd=reinsured&amp;Sj=0"">reinsured</a>"	๒ มี.ค. ๒๕๔๕
ผู้เอาประกันภัยต่อช่วง	"retrocedant; <a href=""/coinages/websearch.php?Wd=retrocedent&amp;Sj=0"">retrocedent</a>; <a href=""/coinages/websearch.php?Wd=retrocessionaire&amp;Sj=0"">retrocessionaire</a>"	๒ มี.ค. ๒๕๔๕
ผู้รับเงินรายปี	annuitant	๒ มี.ค. ๒๕๔๕
ผู้รับการค้ำประกัน	obligee	๒ มี.ค. ๒๕๔๕
ผู้โอนสิทธิ์	addingnor	๒ มี.ค. ๒๕๔๕
ผู้รับประโยชน์	beneficiary	๒ มี.ค. ๒๕๔๕
ผู้รับประโยชน์มีเงื่อนไข	contingent beneficiary	๒ มี.ค. ๒๕๔๕
ผู้รับประโยชน์เปลี่ยนไม่ได้	irrevocable beneficiary	๒ มี.ค. ๒๕๔๕
ผู้รับโอนสิทธิ์	assignee	๒ มี.ค. ๒๕๔๕
ผู้รับประกันภัยต่อ	"reassurer; <a href=""/coinages/websearch.php?Wd=reinsurer&amp;Sj=0"">reinsurer</a>"	๒ มี.ค. ๒๕๔๕
ผู้รับประกันภัยต่อโดยตรง	direct reinsurer	๒ มี.ค. ๒๕๔๕
ผู้รับประกันภัยต่ออาชีพ	professional reinsurer	๒ มี.ค. ๒๕๔๕
ผู้รับประกันภัยนำ	"lead; <a href=""/coinages/websearch.php?Wd=leading+underwriter&amp;Sj=0"">leading underwriter</a>"	๒ มี.ค. ๒๕๔๕
ผู้รับฝากทรัพย์	bailee	๒ มี.ค. ๒๕๔๕
ผู้รับประโยชน์เปลี่ยนได้	revocable beneficiary	๒ มี.ค. ๒๕๔๕
ผู้รับประกันภัย	"assurer; <a href=""/coinages/websearch.php?Wd=carrier&amp;Sj=0"">carrier</a>; <a href=""/coinages/websearch.php?Wd=insurer&amp;Sj=0"">insurer</a>; <a href=""/coinages/websearch.php?Wd=underwriter&amp;Sj=0"">underwriter</a>"	๒ มี.ค. ๒๕๔๕
ผู้รับประกันภัยรวม	composite company	๒ มี.ค. ๒๕๔๕
ผู้รับประกันภัยร่วม	"co-assurer; <a href=""/coinages/websearch.php?Wd=co-insurer&amp;Sj=0"">co-insurer</a>"	๒ มี.ค. ๒๕๔๕
ผู้รับประกันภัยหลายประเภท	multiple line insurer	๒ มี.ค. ๒๕๔๕
ผู้รับประกันภัยค้ำประกัน	"suraty; <a href=""/coinages/websearch.php?Wd=surety&amp;Sj=0"">surety</a>"	๒ มี.ค. ๒๕๔๕
ผู้รับประกันภัยค้ำประกันร่วม	co-surety	๒ มี.ค. ๒๕๔๕
ผู้มีภาระผูกพัน	obligor	๒ มี.ค. ๒๕๔๕
ผู้เก็บเงิน	collector	๒ มี.ค. ๒๕๔๕
ผู้เจรจาตกลง	adjuster	๒ มี.ค. ๒๕๔๕
ผู้เจรจาตกลงวินาศภัยทางทะเล	average adjuster	๒ มี.ค. ๒๕๔๕
ผู้เจรจาตกลงความเสียหายชาร์เตอร์	Chatered loss adjuster	๒ มี.ค. ๒๕๔๕
ผู้เจรจาตกลงค่าสินไหมทดแทน	"claims adjuster; <a href=""/coinages/websearch.php?Wd=loss+adjuster&amp;Sj=0"">loss adjuster</a>"	๒ มี.ค. ๒๕๔๕
ผู้เจรจาตกลงทั่วไป	public adjuster	๒ มี.ค. ๒๕๔๕
ผู้สำรวจ	surevyor	๒ มี.ค. ๒๕๔๕
ผู้สำรวจความเสี่ยงอัคคีภัย	fire surveyor	๒ มี.ค. ๒๕๔๕
ผู้หาประกันภัย	producer	๒ มี.ค. ๒๕๔๕
ผู้กู้ภัย	salvor	๒ มี.ค. ๒๕๔๕
ผู้ขนส่ง	carrier	๒ มี.ค. ๒๕๔๕
ผู้ขนส่งสาธารณะ	common carrier	๒ มี.ค. ๒๕๔๕
ผู้ค้ำประกันส่วนบุคคล	personal surety	๒ มี.ค. ๒๕๔๕
ผู้จัดการมรดก	administrator	๒ มี.ค. ๒๕๔๕
ผู้จัดการมรดก(มีพินัยกรรม)	executor	๒ มี.ค. ๒๕๔๕
ผู้จัดการมรดก(มีพินัยกรรม)	executor	๒ มี.ค. ๒๕๔๕
ผู้ดูแลผลประโยชน์	fiduciary	๒ มี.ค. ๒๕๔๕
ผู้ตายไม่มีพินัยกรรม	intestate	๒ มี.ค. ๒๕๔๕
ผู้ถือกรมธรรม	"policyholder; <a href=""/coinages/websearch.php?Wd=policy-holder&amp;Sj=0"">policy-holder</a>"	๒ มี.ค. ๒๕๔๕
ผู้ทำพินัยกรรม	testator	๒ มี.ค. ๒๕๔๕
ผู้ประเมิน(ความเสียหาย)	assessor	๒ มี.ค. ๒๕๔๕
ผู้ประเมิน(ความเสียหาย)	assessor	๒ มี.ค. ๒๕๔๕
ผู้ฝากทรัพย์	bailor	๒ มี.ค. ๒๕๔๕
ผู้พิจารณารับประกันภัยของสถาบันลอยด์	Lloyd’s Underwriter	๒ มี.ค. ๒๕๔๕
ผู้พิจารณาการรับประกันภัย	underwriter	๒ มี.ค. ๒๕๔๕
ผลประโยชน์	benefit	๒ มี.ค. ๒๕๔๕
ผลประโยชน์เมื่อถึงแก่กรรม	death benefit	๒ มี.ค. ๒๕๔๕
ผลประโยชน์เมื่อถึงแก่กรรมโดยอุบัติเหตุ	accidental death benefit	๒ มี.ค. ๒๕๔๕
ผลประโยชน์เมื่อถึงแก่กรรมในหน้าที่	death-in-sevive benefit	๒ มี.ค. ๒๕๔๕
ผลประโยชน์ในการประกันภัย	benefit of insurance	๒ มี.ค. ๒๕๔๕
ผลประโยชน์เป็นเงินก้อน	capital benefit	๒ มี.ค. ๒๕๔๕
ผลประโยชน์เพิ่ม	additional benefit	๒ มี.ค. ๒๕๔๕
ผลประโยชน์เพื่อทุพพลภาพ	disablement benefit	๒ มี.ค. ๒๕๔๕
ผลประโยชน์หญิงม่าย	winow’s benefit	๒ มี.ค. ๒๕๔๕
ผลประโยชน์ซากทรัพย์	benefit of salvage	๒ มี.ค. ๒๕๔๕
ผลประโยชน์ตามสัดส่วน	proportional benefit	๒ มี.ค. ๒๕๔๕
ผลประโยชน์ตามบัญชี	book interest	๒ มี.ค. ๒๕๔๕
ผลประโยชน์ที่เลือกได้	elective benefit	๒ มี.ค. ๒๕๔๕
ผลประโยชน์ทุพพลภาพ	disability benefit	๒ มี.ค. ๒๕๔๕
พระราชบัญญัติสถาบันลอยด์	Lloyd’s Acts	๒ มี.ค. ๒๕๔๕
พยากรณ์ชีพ	life expectancy	๒ มี.ค. ๒๕๔๕
พหุภัย	plurality of risk	๒ มี.ค. ๒๕๔๕
พิสัยความรับผิดโดยเอกเทศ	independent range	๒ มี.ค. ๒๕๔๕
พินัยกรรม	will	๒ มี.ค. ๒๕๔๕
