-ยนต์, มอเตอร์	motor	๑๒ มี.ค. ๒๕๔๕
A/F ratio; air-fuel ratio	อัตราส่วนเอ/เอฟ, อัตราส่วนอากาศต่อเชื้อเพลิง	๑๒ มี.ค. ๒๕๔๕
เม็ดกลม; ลูกปืน	ball	๑๒ มี.ค. ๒๕๔๕
แม่แรง	jack	๑๒ มี.ค. ๒๕๔๕
แม่แรงประจำรถ	hand jack	๑๒ มี.ค. ๒๕๔๕
แม่ปั๊ม	master cylinder	๑๒ มี.ค. ๒๕๔๕
แม่ปั๊มเบรกแบบสองตอน	tandem master cylinder	๑๒ มี.ค. ๒๕๔๕
แม่ปั๊มเบรกคู่	dual master cylinder	๑๒ มี.ค. ๒๕๔๕
เร่งไฟหนีศูนย์กลาง	centrifugal advance	๑๒ มี.ค. ๒๕๔๕
โมลิบดีนัมไดซัลไฟด์	molybdenum disulphide	๑๒ มี.ค. ๒๕๔๕
เรขาคณิตล้อหน้า	front-end geometry	๑๒ มี.ค. ๒๕๔๕
เรขาคณิตบังคับเลี้ยว	steering geometry	๑๒ มี.ค. ๒๕๔๕
แรงม้า (เอชพี)	horsepower (hp)	๑๒ มี.ค. ๒๕๔๕
แรงม้าเสียดทาน (เอฟเอชพี)	friction horsepower (fhp)	๑๒ มี.ค. ๒๕๔๕
แรงม้าเพลา (บีเอชพี)	brake horsepower (bhp)	๑๒ มี.ค. ๒๕๔๕
แรงม้าเพลารวบยอดเอสเออี (บีเอชพีรวบยอดเอสเออ)	SAE gross brake horsepower (SAE gross bhp)	๑๒ มี.ค. ๒๕๔๕
แรงม้าเพลาสุทธิเอสเออี (บีเอชพีสุทธิเอสเออี)	SAE net brake horsepower (SAE net bhp)	๑๒ มี.ค. ๒๕๔๕
แรงม้าเพลาดีน (บีเอชพีดีน)	DIN brake horsepower (DIN bhp)	๑๒ มี.ค. ๒๕๔๕
แรงม้าสุทธิ	net horsepower	๑๒ มี.ค. ๒๕๔๕
แรงม้าบ่งชี้ (ไอเอชพี)	indicated horsepower (ihp)	๑๒ มี.ค. ๒๕๔๕
แรงเลี้ยวรถ	cornering force	๑๒ มี.ค. ๒๕๔๕
แรงเคลื่อนไฟฟ้าทุติยภูมิผลิตได้	secondary available voltage	๑๒ มี.ค. ๒๕๔๕
แรงเบรก	braking force	๑๒ มี.ค. ๒๕๔๕
แรงฉุดลาก	traction	๑๒ มี.ค. ๒๕๔๕
แรงต้านลม; ความต้านลม	air resistance	๑๒ มี.ค. ๒๕๔๕
แรงบิด, ทอร์ก	torque	๑๒ มี.ค. ๒๕๔๕
เรซินสังเคราะห์	synthetic resin	๑๒ มี.ค. ๒๕๔๕
เรซินอะคริลิก	acrylic resin	๑๒ มี.ค. ๒๕๔๕
เรดาร์เตือนการชน	anticollision radar	๑๒ มี.ค. ๒๕๔๕
เรือนคลัตช์, เสื้อคลัตช์	clutch housing	๑๒ มี.ค. ๒๕๔๕
ABDC (after bottom dead center)	เอบีดีซี (หลังศูนย์ตายล่าง)	๑๒ มี.ค. ๒๕๔๕
ABS (antilock brake system)	เอบีเอส (ระบบเบรกกันล้อล็อก)	๑๒ มี.ค. ๒๕๔๕
abrasion resistance	ความต้านทานการขัดถู	๑๒ มี.ค. ๒๕๔๕
abrasive	สารขัดถู	๑๒ มี.ค. ๒๕๔๕
abrasive coating	การฉาบสารขัดถู	๑๒ มี.ค. ๒๕๔๕
absolute pressure	ความดันสัมบูรณ์	๑๒ มี.ค. ๒๕๔๕
absolute zero	ศูนย์สัมบูรณ์	๑๒ มี.ค. ๒๕๔๕
AC (alternating current)	เอซี (กระแสสลับ)	๑๒ มี.ค. ๒๕๔๕
acceleration	ความเร่ง	๑๒ มี.ค. ๒๕๔๕
accelerator; accelerator pedal	คันเร่ง	๑๒ มี.ค. ๒๕๔๕
accelerator cable	สายคันเร่ง	๑๒ มี.ค. ๒๕๔๕
accelerator pedal; accelerator	คันเร่ง	๑๒ มี.ค. ๒๕๔๕
accelerator pump	เครื่องสูบเร่ง	๑๒ มี.ค. ๒๕๔๕
accumulator	๑. หม้อสะสมไฟฟ้า๒. ถังสะสม	๑๒ มี.ค. ๒๕๔๕
acid core solder	ลวดบัดกรีไส้กรด	๑๒ มี.ค. ๒๕๔๕
Ackermann steering	ระบบบังคับเลี้ยวแบบอัคเคอร์มันน์	๑๒ มี.ค. ๒๕๔๕
acrylic resin	เรซินอะคริลิก	๑๒ มี.ค. ๒๕๔๕
active ride	ระบบรองรับอัตโนมัติ	๑๒ มี.ค. ๒๕๔๕
เวนจูริ, คอคอด	venturi	๑๒ มี.ค. ๒๕๔๕
ระยะเหวี่ยง	throw	๑๒ มี.ค. ๒๕๔๕
ระยะเหวี่ยง; สลักข้อเหวี่ยงพร้อมแขน	crank throw	๑๒ มี.ค. ๒๕๔๕
ระยะรุน	end-float: end play	๑๒ มี.ค. ๒๕๔๕
ระยะว่าง	free play; lash; play	๑๒ มี.ค. ๒๕๔๕
ระยะว่างคันเหยียบ	free pedal; free travel	๑๒ มี.ค. ๒๕๔๕
ระยะหยุด	stopping distance	๑๒ มี.ค. ๒๕๔๕
ระยะส่าย	lateral runout	๑๒ มี.ค. ๒๕๔๕
ระยะเบรก	braking distance	๑๒ มี.ค. ๒๕๔๕
ระยะห่าง	clearance	๑๒ มี.ค. ๒๕๔๕
ระยะห่างรองลื่น	bearing clearance	๑๒ มี.ค. ๒๕๔๕
ระยะห่างลูกสูบ	piston clearance	๑๒ มี.ค. ๒๕๔๕
ระยะห่างน้ำมันหล่อลื่น	oil clearance	๑๒ มี.ค. ๒๕๔๕
ระยะสำรองคันเหยียบ	pedal reserve	๑๒ มี.ค. ๒๕๔๕
ระยะสลักถึงหัวลูกสูบ	piston compression height	๑๒ มี.ค. ๒๕๔๕
ระยะอัดรองลื่น	bearing crush	๑๒ มี.ค. ๒๕๔๕
ระยะล้อ	track	๑๒ มี.ค. ๒๕๔๕
ระยะล้อ; ดอกยาง	tread	๑๒ มี.ค. ๒๕๔๕
ระยะคลอน	backlash	๑๒ มี.ค. ๒๕๔๕
ระยะชัก; จังหวะ	stroke	๑๒ มี.ค. ๒๕๔๕
ระยะตั้งลิ้น	rocker clearance; valve clearance; valve lash	๑๒ มี.ค. ๒๕๔๕
ระยะถ่างรองลื่น	bearing spread	๑๒ มี.ค. ๒๕๔๕
ระยะปากแหวน	piston ring gap; ring gap	๑๒ มี.ค. ๒๕๔๕
ระยะฟรีพวงมาลัย	steering play	๑๒ มี.ค. ๒๕๔๕
additive	สารเติมแต่ง	๑๒ มี.ค. ๒๕๔๕
adiabatic engine	เครื่องยนต์แอเดียแบติก	๑๒ มี.ค. ๒๕๔๕
advanced spark; advanced ignition	การจุดระเบิดก่อน, ไฟแก่	๑๒ มี.ค. ๒๕๔๕
advancing-line speedometer	มาตราอัตราเร็วแบบแถบเลื่อน	๑๒ มี.ค. ๒๕๔๕
advance mechanism; ignition advance mechanism; spark advance mechanism	กลไกเร่งไฟ	๑๒ มี.ค. ๒๕๔๕
advanced ignition; advanced spark	การจุดระเบิดก่อน, ไฟแก่	๑๒ มี.ค. ๒๕๔๕
advertised power	กำลังตามโฆษณา	๑๒ มี.ค. ๒๕๔๕
ระดับลูกลอย	float level	๑๒ มี.ค. ๒๕๔๕
ระบบระบายอากาศห้องข้อเหวี่ยงแบบปิด	closed crankcase ventilation system	๑๒ มี.ค. ๒๕๔๕
ระบบรองรับล้อหน้า	front suspension	๑๒ มี.ค. ๒๕๔๕
ระบบรองรับล้อหน้าแบบอิสระ (ไอเอฟเอส)	independent front suspension (IFS)	๑๒ มี.ค. ๒๕๔๕
ระบบรองรับไฮโดรลาสติก	hydrolastic suspension	๑๒ มี.ค. ๒๕๔๕
ระบบแสดงปัญหาขัดข้อง	self-diagnostic system	๑๒ มี.ค. ๒๕๔๕
ระบบรองรับ	suspension; suspension system	๑๒ มี.ค. ๒๕๔๕
ระบบรองรับแบบแม็กเฟอร์สัน	MacPherson strut; MacPherson suspension	๑๒ มี.ค. ๒๕๔๕
ระบบรองรับแบบใช้ลม	pneumatic suspension	๑๒ มี.ค. ๒๕๔๕
ระบบรองรับแบบสปริงขด	full coil suspension	๑๒ มี.ค. ๒๕๔๕
ระบบรองรับแบบอิสระ	independent suspension	๑๒ มี.ค. ๒๕๔๕
ระบบรองรับแบบลูกหมาก	ball-joint suspension	๑๒ มี.ค. ๒๕๔๕
ระบบรองรับแบบปีกนกสั้น-ยาว	short-arm long-arm suspension	๑๒ มี.ค. ๒๕๔๕
ระบบรองรับอัตโนมัติ	active ride	๑๒ มี.ค. ๒๕๔๕
ระบบรองรับล้อหลัง	rear suspension	๑๒ มี.ค. ๒๕๔๕
ระบบรองรับล้อหลังแบบอิสระ (ไออาร์เอส)	independent rear suspension (IRS)	๑๒ มี.ค. ๒๕๔๕
ระบบเบรก	brake system	๑๒ มี.ค. ๒๕๔๕
ระบบเบรกแยกวงจร	split brake system	๑๒ มี.ค. ๒๕๔๕
ระบบเบรกวงจรไขว้	diagonally split braking system	๑๒ มี.ค. ๒๕๔๕
ระบบเบรกสองวงจร	dual-brake system; dual braking system	๑๒ มี.ค. ๒๕๔๕
ระบบเบรกไฮดรอลิก	hydraulic brake system	๑๒ มี.ค. ๒๕๔๕
ระบบเบรกกันล้อล็อก (เอบีเอส)	antilock brake system (ABS)	๑๒ มี.ค. ๒๕๔๕
ระบบเผาไหม้ไอดีบางโดยอิเล็กทรอนิกส์, ระบบอีแอลบี	electronic lean-burn system; ELB system	๑๒ มี.ค. ๒๕๔๕
ระบบเชื้อเพลิง	fuel system	๑๒ มี.ค. ๒๕๔๕
ระบบเซอร์โว	servo system	๑๒ มี.ค. ๒๕๔๕
ระบบเซอร์โวสุญญากาศ	vacuum servo	๑๒ มี.ค. ๒๕๔๕
ระบบเดินเบา	idle system	๑๒ มี.ค. ๒๕๔๕
ระบบส่งแรงขับแบบฮอตช์คิสส์	Hotchkiss drive	๑๒ มี.ค. ๒๕๔๕
ระบบอีเอฟอี, ระบบทำให้เชื้อเพลิงระเหยก่อน	EFE system; ealry fuel evaporation system	๑๒ มี.ค. ๒๕๔๕
ระบบอีเอฟไอ, ระบบฉีดเชื้อเพลิงแบบอิเล็กทรอนิกส์	EFI system; electronid fuel-injection system	๑๒ มี.ค. ๒๕๔๕
ระบบอุ่นอากาศเข้า	regeneration system	๑๒ มี.ค. ๒๕๔๕
ระบบอัตราเร็วสูง	high-speed system	๑๒ มี.ค. ๒๕๔๕
ระบบอีแอลบี, ระบบเผาไหม้ไอดีบางโดยอิเล็กทรอนิกส์	ELB system; electronic lean-burn system	๑๒ มี.ค. ๒๕๔๕
ระบบหล่อลื่น	lubrication system	๑๒ มี.ค. ๒๕๔๕
ระบบหล่อลื่นแบบวิดสาดน้ำมัน	splash-feed oil system	๑๒ มี.ค. ๒๕๔๕
ระบบหล่อลื่นแบบความดัน	pressure-feed oil system	๑๒ มี.ค. ๒๕๔๕
ระบบหลักควบคุมน้ำมัน	main-metering system	๑๒ มี.ค. ๒๕๔๕
ระบบลูกลอย	float system	๑๒ มี.ค. ๒๕๔๕
ระบบ(ท่อร่วม)ไอดีแบบปรับแต่ง	tuned intake system	๑๒ มี.ค. ๒๕๔๕
ระบบไฟสองสาย	insulated-return system; two-wire system	๑๒ มี.ค. ๒๕๔๕
ระบบไฟสายเดี่ยว	one-wire system	๑๒ มี.ค. ๒๕๔๕
ระบบกันหน้ารถทิ่ม	anti-dive suspension geometry	๑๒ มี.ค. ๒๕๔๕
ระบบกันกาลักน้ำ	antisiphon system	๑๒ มี.ค. ๒๕๔๕
ระบบกันท้ายรถต่ำ	anti-squat suspension geometry	๑๒ มี.ค. ๒๕๔๕
ระบบกันน้ำแข็งจับ	anti-icing system	๑๒ มี.ค. ๒๕๔๕
ระบบขับเคลื่อนล้อหลัง	rear-wheel drive	๑๒ มี.ค. ๒๕๔๕
ระบบขับเคลื่อนล้อหน้า	front-end drive; front-wheel drive	๑๒ มี.ค. ๒๕๔๕
ระบบควบคุม	control system	๑๒ มี.ค. ๒๕๔๕
ระบบควบคุมไนโตรเจนออกไซด์	NOx control system	๑๒ มี.ค. ๒๕๔๕
ระบบไฟกะพริบฉุกเฉิน	emergency signal system; hazard system	๑๒ มี.ค. ๒๕๔๕
ระบบไฟฟ้า	electrical system; electric system	๑๒ มี.ค. ๒๕๔๕
ระบบควบคุมการระเหย	evaporative control system; fuel-vapour recovery system; vapour-recovery system; vapour-saver system; vehicle vapour recovery	๑๒ มี.ค. ๒๕๔๕
ระบบจ่ายไอดี	fuel-induction system	๑๒ มี.ค. ๒๕๔๕
ระบบจุดระเบิดแบบเหนี่ยวนำ	inductive ignition system	๑๒ มี.ค. ๒๕๔๕
ระบบจุดระเบิดแบบเคตเทอริง	Kettering ignition system	๑๒ มี.ค. ๒๕๔๕
ระบบจุดระเบิดแบบสารกึ่งตัวนำ	semi-conductor ignition system	๑๒ มี.ค. ๒๕๔๕
ระบบจุดระเบิดแบบอิเล็กทรอนิกส์	electronic ignition system	๑๒ มี.ค. ๒๕๔๕
ระบบจุดระเบิดแบบทองขาว	breaker point ignition system; contact-point ignition system	๑๒ มี.ค. ๒๕๔๕
ระบบจุดระเบิดคู่	dual ignition system	๑๒ มี.ค. ๒๕๔๕
ระบบจุดระเบิดพลังงานสูง (เอชอีไอ)	high-energy ignition system (HEI)	๑๒ มี.ค. ๒๕๔๕
ระบบจุดระเบิด	ignition system	๑๒ มี.ค. ๒๕๔๕
ระบบฉีดเชื้อเพลิง	fuel-injection system	๑๒ มี.ค. ๒๕๔๕
ระบบฉีดเชื้อเพลิงแบบอิเล็กทรอนิกส์, ระบบอีเอฟไอ	electronic fuel-injection system; EFI system	๑๒ มี.ค. ๒๕๔๕
ระบบฉีดอากาศ	air-injection system; thermactor	๑๒ มี.ค. ๒๕๔๕
ระบบทำให้เชื้อเพลิงระเหยก่อน, ระบบอีเอฟอี	early fuel evaporation system; EFE system	๑๒ มี.ค. ๒๕๔๕
ระบบ(ท่อร่วม)ไอดีแบบปรับแต่ง	tuned intake system	๑๒ มี.ค. ๒๕๔๕
ระบบทำให้เย็น	cooling system	๑๒ มี.ค. ๒๕๔๕
ระบบปรับอากาศใช้คลัตช์	cycling-clutch system	๑๒ มี.ค. ๒๕๔๕
ระบบป้อนอากาศ	air-aspirator system	๑๒ มี.ค. ๒๕๔๕
ระบบบังคับเลี้ยว	steering system	๑๒ มี.ค. ๒๕๔๕
ระบบบังคับเลี้ยวแบบอัคเคอร์มันน์	Ackermann steering	๑๒ มี.ค. ๒๕๔๕
ระบบบังคับเลี้ยวสี่ล้อ	four-wheel steering	๑๒ มี.ค. ๒๕๔๕
ระบบพวงมาลัยเสริมกำลัง	power steering	๑๒ มี.ค. ๒๕๔๕
ระบบพวงมาลัยเสริมกำลังแบบอัตราทดแปรผันได้	variable-ratio power steering	๑๒ มี.ค. ๒๕๔๕
ระบบพวงมาลัยเสริมกำลังแบบก้านต่อ	linkage power steering	๑๒ มี.ค. ๒๕๔๕
แหวนอัด	compression ring	๑๒ มี.ค. ๒๕๔๕
แหวนอัด	head-land ring	๑๒ มี.ค. ๒๕๔๕
แหวนอัดปาดขอบใน	counterbored ring	๑๒ มี.ค. ๒๕๔๕
แหวนล็อก	locking washer; lockwasher	๑๒ มี.ค. ๒๕๔๕
แหวนล็อกสลัก	circlip	๑๒ มี.ค. ๒๕๔๕
แหวนรองกันรุน	thrust washer	๑๒ มี.ค. ๒๕๔๕
แหวนเคลือบ	coated ring	๑๒ มี.ค. ๒๕๔๕
แหวนร้อยสาย	grommet	๑๒ มี.ค. ๒๕๔๕
แหวนช่วยการเข้าเกียร์	balk ring; baulk ring	๑๒ มี.ค. ๒๕๔๕
แหวนชุบโครเมียม	chrome-plated ring	๑๒ มี.ค. ๒๕๔๕
แหวนบ่าลิ้น	valve-seat insert	๑๒ มี.ค. ๒๕๔๕
แหวนลูกสูบ	piston ring	๑๒ มี.ค. ๒๕๔๕
แหวนกวาดน้ำมันเครื่อง	oil-control ring; oil ring; oil scraper ring; scraper ring	๑๒ มี.ค. ๒๕๔๕
แหวนกันรั่ว	sealing washer	๑๒ มี.ค. ๒๕๔๕
แหวนกันหลุด	snap ring	๑๒ มี.ค. ๒๕๔๕
เส้นแดง	red line	๑๒ มี.ค. ๒๕๔๕
เส้นประกายไฟ	spark line	๑๒ มี.ค. ๒๕๔๕
เส้นตีเกลียวเสริมยาง	cord	๑๒ มี.ค. ๒๕๔๕
เส้นผ่านศูนย์กลางวงเลี้ยวแคบสุด	turning circle	๑๒ มี.ค. ๒๕๔๕
ร่องแหวนลูกสูบ	piston ring groove; ring groove	๑๒ มี.ค. ๒๕๔๕
ร้อยละความชัน	percent of grade	๑๒ มี.ค. ๒๕๔๕
ร่องรองลื่น	bearing groove	๑๒ มี.ค. ๒๕๔๕
ร่องยาง	tire groove; tyre groove	๑๒ มี.ค. ๒๕๔๕
ร่องกันความร้อน	heat dam	๑๒ มี.ค. ๒๕๔๕
ร่องดอกละเอียด	knife cuts; sipes	๑๒ มี.ค. ๒๕๔๕
ร่องลิ่ม	key bed; keyseat; keyway	๑๒ มี.ค. ๒๕๔๕
ร่องฟัน	spline	๑๒ มี.ค. ๒๕๔๕
เสียงยางบดถนน	road roar	๑๒ มี.ค. ๒๕๔๕
เสียงลูกสูบตบข้าง	piston slap	๑๒ มี.ค. ๒๕๔๕
aerofoil; airfoil	แพนอากาศ	๑๒ มี.ค. ๒๕๔๕
aerobic gasket material; room-temperature-vulcanising sealant; RTV sealant	วัสดุปะเก็นแอโรบิก	๑๒ มี.ค. ๒๕๔๕
aerobumper	กันชนเพรียวลม	๑๒ มี.ค. ๒๕๔๕
aerodynamic drag coefficient	สัมประสิทธิ์แรงต้านอากาศพลศาสตร์	๑๒ มี.ค. ๒๕๔๕
aerodynamics	อากาศพลศาสตร์	๑๒ มี.ค. ๒๕๔๕
เหล็กขูด	scraper	๑๒ มี.ค. ๒๕๔๕
แสงตั้งไฟ	timing light	๑๒ มี.ค. ๒๕๔๕
เสถียรภาพการบังคับรถ	handling	๑๒ มี.ค. ๒๕๔๕
แหนบอัดซ้อน	laminated spring	๑๒ มี.ค. ๒๕๔๕
แหนบกึ่งวงรี	semi-elliptic spring	๑๒ มี.ค. ๒๕๔๕
แหนบเสริม	auxiliary spring	๑๒ มี.ค. ๒๕๔๕
แหนบแผ่น	leaf spring	๑๒ มี.ค. ๒๕๔๕
เสื้อเพลา	axle casing	๑๒ มี.ค. ๒๕๔๕
เสื้อสูบ	cylinder block; engine block	๑๒ มี.ค. ๒๕๔๕
เสื้อสูบแบบหล่อชิ้นเดียว	en-block; in-block; monobloc; mono-block	๑๒ มี.ค. ๒๕๔๕
เสื้อคลัตช์, เรือนคลัตช์	clutch housing	๑๒ มี.ค. ๒๕๔๕
after bottom dead center (ABDC)	หลังศูนย์ตายล่าง (เอบีดีซี)	๑๒ มี.ค. ๒๕๔๕
afterburner	อุปกรณ์เผาไหม้เสริม	๑๒ มี.ค. ๒๕๔๕
afterburning	การเผาไหม้เสริม	๑๒ มี.ค. ๒๕๔๕
afterfire	การจุดระเบิดในท่อไอเสีย	๑๒ มี.ค. ๒๕๔๕
afterrunning; dieseling; running-on; run-on	เครื่องเดินค้าง	๑๒ มี.ค. ๒๕๔๕
after top dead center (ATDC)	หลังศูนย์ตายบน (เอทีดีซี)	๑๒ มี.ค. ๒๕๔๕
afterboil	การเดือดค้าง	๑๒ มี.ค. ๒๕๔๕
แอมมิเตอร์	ammeter	๑๒ มี.ค. ๒๕๔๕
แอมแปร์	ampere	๑๒ มี.ค. ๒๕๔๕
แอร์แดม	air dam	๑๒ มี.ค. ๒๕๔๕
โอเอ็น (เลขออกเทน)	ON (octane number)	๑๒ มี.ค. ๒๕๔๕
มอเตอร์, -ยนต์	motor	๑๒ มี.ค. ๒๕๔๕
มอเตอร์แบบสุญญากาศ	vacuum motor	๑๒ มี.ค. ๒๕๔๕
มอเตอร์สตาร์ต, มอเตอร์ติดเครื่อง	cranking motor; starter; starter motor; starting motor	๑๒ มี.ค. ๒๕๔๕
มอเตอร์ติดเครื่อง, มอเตอร์สตาร์ต	cranking motor; starter; starter motor; starting motor	๑๒ มี.ค. ๒๕๔๕
เอ็มโอเอ็น (เลขออกเทนเครื่องยนต์)	MON (motor octane number)	๑๒ มี.ค. ๒๕๔๕
เอสเออี (สมาคมวิศวกรยานยนต์)	SAE (Society of Automotive Engineers)	๑๒ มี.ค. ๒๕๔๕
เอสดีวี (ลิ้นหน่วงการเกิดประกายไฟ)	SDV (spark delay valve)	๑๒ มี.ค. ๒๕๔๕
aiming screw	สกรูปรับไฟหน้า	๑๒ มี.ค. ๒๕๔๕
air brake	เบรกลม	๑๒ มี.ค. ๒๕๔๕
air cleaner; air filter	หม้อกรองอากาศ	๑๒ มี.ค. ๒๕๔๕
air bag	ถุงลม	๑๒ มี.ค. ๒๕๔๕
air bleed	๑. ช่องอากาศเดินเบา๒. ช่องไล่อากาศ	๑๒ มี.ค. ๒๕๔๕
air comperssor	เครื่องอัดอากาศ	๑๒ มี.ค. ๒๕๔๕
air dam	แอร์แดม	๑๒ มี.ค. ๒๕๔๕
air dry	ปล่อยแห้ง	๑๒ มี.ค. ๒๕๔๕
air filter; air cleaner	หม้อกรองอากาศ	๑๒ มี.ค. ๒๕๔๕
air horn	๑. แตรลม๒. ท่ออากาศเข้าคาร์บูเรเตอร์	๑๒ มี.ค. ๒๕๔๕
air spring	สปริงลม	๑๒ มี.ค. ๒๕๔๕
air vent; vent	รูลม, รูหายใจ	๑๒ มี.ค. ๒๕๔๕
air lock	อากาศอุด	๑๒ มี.ค. ๒๕๔๕
air nozzle	หัวฉีดลม	๑๒ มี.ค. ๒๕๔๕
air pollution	มลพิษทางอากาศ	๑๒ มี.ค. ๒๕๔๕
air pressure	ความดันอากาศ	๑๒ มี.ค. ๒๕๔๕
air pump	เครื่องสูบลม	๑๒ มี.ค. ๒๕๔๕
air risistance	๑. ความต้านลม๒. แรงต้านลม	๑๒ มี.ค. ๒๕๔๕
air-cooled engine	เครื่องยนต์ระบายความร้อนด้วยอากาศ	๑๒ มี.ค. ๒๕๔๕
air-fuel mixture; fuel mixture; mixture	ไอดี, สารผสมอากาศกับเชื้อเพลิง	๑๒ มี.ค. ๒๕๔๕
air-fuel ratio; A/F ratio	อัตราส่วนอากาศต่อเชื้อเพลิง, อัตราส่วนเอ/เอฟ	๑๒ มี.ค. ๒๕๔๕
air-injection system; thermactor	ระบบฉีดอากาศ	๑๒ มี.ค. ๒๕๔๕
air-starting valve	ลิ้นติดเครื่องด้วยลม	๑๒ มี.ค. ๒๕๔๕
airflow meter	มาตรอากาศไหล	๑๒ มี.ค. ๒๕๔๕
airfoil; aerofoil	แพนอากาศ	๑๒ มี.ค. ๒๕๔๕
air-aspirator system	ระบบป้อนอากาศ	๑๒ มี.ค. ๒๕๔๕
air-bleed nipple; air-bleed screw	สกรูไล่อากาศ	๑๒ มี.ค. ๒๕๔๕
air-bleed screw; air-bleed nipple	สกรูไล่อากาศ	๑๒ มี.ค. ๒๕๔๕
air-bleed valve	ลิ้นไล่อากาศ	๑๒ มี.ค. ๒๕๔๕
ait gap	ช่องอากาศ	๑๒ มี.ค. ๒๕๔๕
แอลพีแก๊ส (แก๊สปิโตรเลียมเหลว), แอลพีจี 	LPG; LP-GAS (liquefied petroleum gas)	๑๒ มี.ค. ๒๕๔๕
แอลพีจี, แอลพีแก๊ส (แก๊สปิโตรเลียมเหลว)	LPG; LP-GAS (liquefied petroleum gas)	๑๒ มี.ค. ๒๕๔๕
รอก	pulley	๑๒ มี.ค. ๒๕๔๕
รองลื่น	plain bearing	๑๒ มี.ค. ๒๕๔๕
รองลื่น; ตลับลูกปืน	bearing	๑๒ มี.ค. ๒๕๔๕
รองลื่นแบบเสียดทาน	friction bearing	๑๒ มี.ค. ๒๕๔๕
รองลื่นสองฝา	shell bearing	๑๒ มี.ค. ๒๕๔๕
รองลื่นสำเร็จรูป	precision-insert bearing; slip-in bearing	๑๒ มี.ค. ๒๕๔๕
รองลื่นหลัก	main bearing	๑๒ มี.ค. ๒๕๔๕
รองลื่นสปิน	bearing spin	๑๒ มี.ค. ๒๕๔๕
รองลื่นก้านสูบ	connecting-rod bearing; rod bearing	๑๒ มี.ค. ๒๕๔๕
รองลื่นกันรุน; ตลับลูกปืนกันรุน	thrust bearing	๑๒ มี.ค. ๒๕๔๕
เอชอีไอ (ระบบจุดระเบิดพลังงานสูง)	HEI (high-energy ignition system)	๑๒ มี.ค. ๒๕๔๕
เอชพี (แรงม้า)	hp (horsepower)	๑๒ มี.ค. ๒๕๔๕
เอซี (กระแสสลับ)	AC (alternating current)	๑๒ มี.ค. ๒๕๔๕
เฮดเดอร์	header	๑๒ มี.ค. ๒๕๔๕
มอดูลควบคุมแบบอิเล็กทรอนิกส์ (อีซีเอ็ม)	electronic control module (ECM)	๑๒ มี.ค. ๒๕๔๕
มอดูลจุดระเบิด	ignition module	๑๒ มี.ค. ๒๕๔๕
เอทีดีซี (หลังศูนย์ตายบน)	ATDC (after top dead center)	๑๒ มี.ค. ๒๕๔๕
รอบเดินเบา	slow-running	๑๒ มี.ค. ๒๕๔๕
เอบีเอส (ระบบเบรกกันล้อล็อก)	ABS (antilock brake system)	๑๒ มี.ค. ๒๕๔๕
เอบีดีซี (หลังศูนย์ตายล่าง)	ABDC (after bottom dead center)	๑๒ มี.ค. ๒๕๔๕
เอฟเอชพี (แรงม้าเสียดทาน)	fhp (friction horsepower)	๑๒ มี.ค. ๒๕๔๕
aligning torque; self-aligning torque	ทอร์กคืนศูนย์	๑๒ มี.ค. ๒๕๔๕
alignment	การปรับแนว	๑๒ มี.ค. ๒๕๔๕
alternating current (AC)	กระแสสลับ (เอซี)	๑๒ มี.ค. ๒๕๔๕
alternator	เครื่องกำเนิดไฟฟ้าสลับ	๑๒ มี.ค. ๒๕๔๕
altimeter	มาตรความสูง	๑๒ มี.ค. ๒๕๔๕
ammeter	มาตรกระแสไฟฟ้า, แอมมิเตอร์	๑๒ มี.ค. ๒๕๔๕
amperage	จำนวนแอมแปร์	๑๒ มี.ค. ๒๕๔๕
ampere	แอมแปร์	๑๒ มี.ค. ๒๕๔๕
ampere-hour capacity	ความจุแอมแปร์-ชั่วโมง	๑๒ มี.ค. ๒๕๔๕
anaerobic sealant	สารกันรั่วไม่ใช้อากาศ	๑๒ มี.ค. ๒๕๔๕
anchor pin; brake anchor	สลักเบรก	๑๒ มี.ค. ๒๕๔๕
รัศมีเลี้ยว	turning radius	๑๒ มี.ค. ๒๕๔๕
รัศมีการกลิ้ง	rolling radius	๑๒ มี.ค. ๒๕๔๕
annulus	วงแหวนเฟืองใน	๑๒ มี.ค. ๒๕๔๕
anti-dive suspension geometry	ระบบกันหน้ารถทิ่ม	๑๒ มี.ค. ๒๕๔๕
anti-icing system	ระบบกันน้ำแข็งจับ	๑๒ มี.ค. ๒๕๔๕
anti-squat suspension geometry	ระบบกันท้ายรถต่ำ	๑๒ มี.ค. ๒๕๔๕
anticollision radar	เรดาร์เตือนการชน	๑๒ มี.ค. ๒๕๔๕
antibackfire valve; backfire-suppressor valve; gulp valve	ลิ้นกันการจุดระเบิดย้อนกลับ	๑๒ มี.ค. ๒๕๔๕
antiburst lock	ล็อกพิเศษกันประตูเปิด	๑๒ มี.ค. ๒๕๔๕
antidieseling solenoid	โซเลนอยด์กันเครื่องเดินค้าง	๑๒ มี.ค. ๒๕๔๕
antilock brake system (ABS)	ระบบเบรกกันล้อล็อก (เอบีเอส)	๑๒ มี.ค. ๒๕๔๕
antifreeze	สารกันเยือกแข็ง	๑๒ มี.ค. ๒๕๔๕
antifroth baffle	แผ่นกันเกิดฟอง	๑๒ มี.ค. ๒๕๔๕
antiknock compound	สารกันน็อก	๑๒ มี.ค. ๒๕๔๕
antiknock index	ดรรชนีกันน็อก	๑๒ มี.ค. ๒๕๔๕
antiknock rating	ค่าประเมินกันน็อก	๑๒ มี.ค. ๒๕๔๕
antipercolator	ช่องลดความดัน	๑๒ มี.ค. ๒๕๔๕
antirattle spring	สปริงลดการสั่น	๑๒ มี.ค. ๒๕๔๕
antiroll bar; stabilizer; stabilizer bar; sway bar	ท่อนกันโคลง	๑๒ มี.ค. ๒๕๔๕
antiseize compound	สารกันการยึดติด	๑๒ มี.ค. ๒๕๔๕
antisiphon system	ระบบกันกาลักน้ำ	๑๒ มี.ค. ๒๕๔๕
antismog device	อุปกรณ์ลดหมอกควัน	๑๒ มี.ค. ๒๕๔๕
มัดสายไฟ	wiring harness; wiring loom	๑๒ มี.ค. ๒๕๔๕
รันอิน	run-in	๑๒ มี.ค. ๒๕๔๕
มีรอยขูดขีด	scored	๑๒ มี.ค. ๒๕๔๕
รีเลย์	relay	๑๒ มี.ค. ๒๕๔๕
รีเลย์สะพานไฟ	cutout relay	๑๒ มี.ค. ๒๕๔๕
รีเลย์สตาร์ต	starter relay	๑๒ มี.ค. ๒๕๔๕
รีเลย์ขดลวดสนามแม่เหล็ก	field relay	๑๒ มี.ค. ๒๕๔๕
รีลักเตอร์	reluctor	๑๒ มี.ค. ๒๕๔๕
ยาขัดสี	cutting compound; rubbing compound	๑๒ มี.ค. ๒๕๔๕
ยางสูบลม	pneumatic tire; pneumatic tyre	๑๒ มี.ค. ๒๕๔๕
ยางหล่อดอก	recapped tire; retreaded tire	๑๒ มี.ค. ๒๕๔๕
ยางหน้ากว้าง	low profile tire; low profile tyre	๑๒ มี.ค. ๒๕๔๕
รางลูกปืน	race	๑๒ มี.ค. ๒๕๔๕
ยางไร้ยางใน	tubeless tire; tubeless tyre	๑๒ มี.ค. ๒๕๔๕
ยางกันโคลน	mud flap	๑๒ มี.ค. ๒๕๔๕
ยางซิลิโคน	silicone rubber	๑๒ มี.ค. ๒๕๔๕
ยางธรรมดา	bias-ply tire; bias-ply tyre; cross-ply tire; cross-ply tyre	๑๒ มี.ค. ๒๕๔๕
ยางน้ำมัน,ขี้น้ำมัน	gum	๑๒ มี.ค. ๒๕๔๕
ยางเรเดียล	radial-ply tire; radial-ply tyre; radial tire; radial tyre	๑๒ มี.ค. ๒๕๔๕
ยางเสริมเข็มขัดรัด	belted-bias tire; belted-bias tyre; bias-belted tire; bias-belted tyre	๑๒ มี.ค. ๒๕๔๕
ยางใน	inner tube; tire tube; tyre tube	๑๒ มี.ค. ๒๕๔๕
มาตรอัตราเร็ว	speedometer	๑๒ มี.ค. ๒๕๔๕
มาตรอัตราเร็วแบบแถบเลื่อน	advancing-line speedometer	๑๒ มี.ค. ๒๕๔๕
มาตรอัตรารอบ	tachometer	๑๒ มี.ค. ๒๕๔๕
มาตรอากาศไหล	airflow meter	๑๒ มี.ค. ๒๕๔๕
มาตรระยะทาง	mileometer; odometer	๑๒ มี.ค. ๒๕๔๕
มาตรเดินทาง	trip meter; trip odometer; trip recorder	๑๒ มี.ค. ๒๕๔๕
มาตรมุมดเวลล์	dwell meter	๑๒ มี.ค. ๒๕๔๕
มาตรความสูง	altimeter	๑๒ มี.ค. ๒๕๔๕
มาตรความหนืด	viscometer; viscosimeter	๑๒ มี.ค. ๒๕๔๕
มาตรกระแสไฟฟ้า, แอมมิเตอร์	ammeter	๑๒ มี.ค. ๒๕๔๕
มาตรกระแสไฟฟ้า	ammeter	๑๒ มี.ค. ๒๕๔๕
มาตรฐานไอเสีย	emission standard	๑๒ มี.ค. ๒๕๔๕
ยานยนต์	motor vehicle	๑๒ มี.ค. ๒๕๔๕
aquaplaning	การไถลบนพื้นเปียก	๑๒ มี.ค. ๒๕๔๕
armature	อาร์มาเจอร์	๑๒ มี.ค. ๒๕๔๕
aspect ratio	อัตราส่วนลักษณะยาง	๑๒ มี.ค. ๒๕๔๕
aspirator; vacuum pump	ปั๊มสุญญากาศ	๑๒ มี.ค. ๒๕๔๕
ATDC (after top dead center)	เอทีดีซี (หลังศูนย์ตายบน)	๑๒ มี.ค. ๒๕๔๕
atomizer	ตัวทำละออง	๑๒ มี.ค. ๒๕๔๕
atomization	การทำให้เป็นละออง	๑๒ มี.ค. ๒๕๔๕
attitude angle	มุมเบนออก	๑๒ มี.ค. ๒๕๔๕
ยูแอลจี (แกโซลีนไร้สารตะกั่ว)	ULG (unleaded gasolene)	๑๒ มี.ค. ๒๕๔๕
ยูแอลพี (เบนซินไร้สารตะกั่ว)	ULP (unleaded petrol)	๑๒ มี.ค. ๒๕๔๕
รูเล็ก	orifice	๑๒ มี.ค. ๒๕๔๕
รูหายใจ, รูลม	air vent; vent	๑๒ มี.ค. ๒๕๔๕
auto mechanic; automotive mechanic	ช่างยนต์	๑๒ มี.ค. ๒๕๔๕
autobody	ตัวถังรถ	๑๒ มี.ค. ๒๕๔๕
automatic advance	การปรับไฟแก่อัตโนมัติ	๑๒ มี.ค. ๒๕๔๕
autoignition	การจุดระเบิดเอง	๑๒ มี.ค. ๒๕๔๕
automatic level control	ชุดควบคุมระดับอัตโนมัติ	๑๒ มี.ค. ๒๕๔๕
automatic cut-out	สะพานไฟอัตโนมัติ	๑๒ มี.ค. ๒๕๔๕
automatic advance and retard coupling; automatic advance and retard unit	ชุดปรับไฟอัตโนมัติ	๑๒ มี.ค. ๒๕๔๕
automatic advance and retard unit; automatic advance and retard coupling	ชุดปรับไฟอัตโนมัติ	๑๒ มี.ค. ๒๕๔๕
automatic choke	โช้กอัตโนมัติ	๑๒ มี.ค. ๒๕๔๕
automatic transmission	ชุดส่งกำลังอัตโนมัติ, เกียร์อัตโนมัติ	๑๒ มี.ค. ๒๕๔๕
automatic steering effect	การคืนล้อสู่แนวตรงอัตโนมัติ	๑๒ มี.ค. ๒๕๔๕
automotive mechanic; auto mechanic	ช่างยนต์	๑๒ มี.ค. ๒๕๔๕
automotive mechanics	วิชายานยนต์	๑๒ มี.ค. ๒๕๔๕
autronic eye	อุปกรณ์ปรับไฟหน้าอัตโนมัติ	๑๒ มี.ค. ๒๕๔๕
auxiliary spring	แหนบเสริม	๑๒ มี.ค. ๒๕๔๕
รูลม, รูหายใจ	air vent; vent	๑๒ มี.ค. ๒๕๔๕
axle	เพลา	๑๒ มี.ค. ๒๕๔๕
axle breather	ช่องหายใจเพลา, ลิ้นระบายความดันเพลา	๑๒ มี.ค. ๒๕๔๕
axle casing	เสื้อเพลา	๑๒ มี.ค. ๒๕๔๕
axle ratio	อัตราทดเพลา	๑๒ มี.ค. ๒๕๔๕
axle stand	ขาตั้งรับเพลา	๑๒ มี.ค. ๒๕๔๕
axle tramp	เพลาเต้น	๑๒ มี.ค. ๒๕๔๕
เลขออกเทน (โอเอ็น)	octane number (ON)	๑๒ มี.ค. ๒๕๔๕
เลขออกเทนเครื่องยนต์ (เอ็มโอเอ็น)	motor octane number (MON)	๑๒ มี.ค. ๒๕๔๕
เลขออกเทนวิจัย (อาร์โอเอ็น)	research octane number (RON)	๑๒ มี.ค. ๒๕๔๕
เลขซีเทน	octane number	๑๒ มี.ค. ๒๕๔๕
เลขตัวถัง (วีไอเอ็น)	vehicle identification number (VIN)	๑๒ มี.ค. ๒๕๔๕
มลพิษทางอากาศ	air pollution	๑๒ มี.ค. ๒๕๔๕
แกโซฮอล	gasohol	๑๒ มี.ค. ๒๕๔๕
แกโซลีน	gasolene; gasoline	๑๒ มี.ค. ๒๕๔๕
แกโซลีนมีสารตะกั่ว	leaded gasolene	๑๒ มี.ค. ๒๕๔๕
แกโซลีนไร้สารตะกั่ว	nonleaded gasolene	๑๒ มี.ค. ๒๕๔๕
แกโซลีนไร้สารตะกั่ว (ยูแอลจี)	unleaded gasolene (ULG)	๑๒ มี.ค. ๒๕๔๕
เกรดน้ำมันหล่อลื่นเอสเออี	SAE oil grade	๑๒ มี.ค. ๒๕๔๕
แก้มยางรถ	sidewall	๑๒ มี.ค. ๒๕๔๕
แก๊สรั่ว	blow-by	๑๒ มี.ค. ๒๕๔๕
แก๊สปิโตรเลียมเหลว (แอลพีจี, แอลพีแก๊ส)	liquefied petroleum gas (LPG; LP-GAS)	๑๒ มี.ค. ๒๕๔๕
เกียร์, เฟือง	gear	๑๒ มี.ค. ๒๕๔๕
เกียร์อัตโนมัติ, ชุดส่งกำลังอัตโนมัติ	automatic transmission	๑๒ มี.ค. ๒๕๔๕
เกจ	gage; gauge	๑๒ มี.ค. ๒๕๔๕
เกจโครงรถ	frame gauge	๑๒ มี.ค. ๒๕๔๕
เกจเชื้อเพลิง	fuel gauge	๑๒ มี.ค. ๒๕๔๕
เกจเทอร์มอสแตต	thermostatic gauge	๑๒ มี.ค. ๒๕๔๕
เกจแผ่นสอด	feeler gauge	๑๒ มี.ค. ๒๕๔๕
เกจวัดการอัด	compression gauge	๑๒ มี.ค. ๒๕๔๕
เกจหัวเทียน	spark plug gauge	๑๒ มี.ค. ๒๕๔๕
เกจสุญญากาศ	vacuum gauge	๑๒ มี.ค. ๒๕๔๕
เกจอุณหภูมิน้ำ	water-temperature gauge	๑๒ มี.ค. ๒๕๔๕
เกจลวดสอด	wire feeler gauge	๑๒ มี.ค. ๒๕๔๕
เกจขดลวดดุล	balancing-coil gauge	๑๒ มี.ค. ๒๕๔๕
เกจขนาดกระบอกสูบ	cylinder bore gauge	๑๒ มี.ค. ๒๕๔๕
เกจความดันน้ำมันเครื่อง	oil-pressure gauge	๑๒ มี.ค. ๒๕๔๕
แกซาฮอล	gasahol	๑๒ มี.ค. ๒๕๔๕
แกนล้อ	stub axle	๑๒ มี.ค. ๒๕๔๕
แกนล้อเลี้ยว	steering spindle	๑๒ มี.ค. ๒๕๔๕
แกนหัวเทียน	center electrode	๑๒ มี.ค. ๒๕๔๕
เข็มลูกลอย	float needle; needle valve	๑๒ มี.ค. ๒๕๔๕
แกนบังคับเลี้ยว	steering axis	๑๒ มี.ค. ๒๕๔๕
แกนพวงมาลัย	steering column; steering shaft	๑๒ มี.ค. ๒๕๔๕
เกือบเบรกนำ, ฝักเบรกนำ	leading shoe	๑๒ มี.ค. ๒๕๔๕
แกนพวงมาลัยยืดหดได้แบบกระบอก	telescopic steering column	๑๒ มี.ค. ๒๕๔๕
แกนพวงมาลัยยุบตัวได้	collapsible steering column	๑๒ มี.ค. ๒๕๔๕
เกือกเบรก, ฝักเบรก	brake shoe; shoe	๑๒ มี.ค. ๒๕๔๕
เกือกเบรกตาม, ฝักเบรกตาม	trailing shoe	๑๒ มี.ค. ๒๕๔๕
เข็มขัดรัดหน้ายาง; สายพาน	belt	๑๒ มี.ค. ๒๕๔๕
เข็มขัดนิรภัย	safety belt; seat belt	๑๒ มี.ค. ๒๕๔๕
เข็มขัดนิรภัยรัดหน้าตัก	lap belt; lap strap	๑๒ มี.ค. ๒๕๔๕
เขี้ยวหัวเทียน, ขั้วดิน	earth electrode	๑๒ มี.ค. ๒๕๔๕
แขนยึด	radius arm; radius rod	๑๒ มี.ค. ๒๕๔๕
แขนไอเดลอร์	idler arm	๑๒ มี.ค. ๒๕๔๕
แขนข้อเหวี่ยง	crank web	๑๒ มี.ค. ๒๕๔๕
แขนคล้อยหลัง	semi-trailing arm	๑๒ มี.ค. ๒๕๔๕
แขนบังคับเลี้ยว	steering arm	๑๒ มี.ค. ๒๕๔๕
แขนปัดน้ำฝน	wiper arm	๑๒ มี.ค. ๒๕๔๕
แขนพิตแมน	pitman arm	๑๒ มี.ค. ๒๕๔๕
โครงย่อย	sub-frame	๑๒ มี.ค. ๒๕๔๕
โครงยาง	carcass; tire carcass; tire casing; tyre carcass; tyre casing	๑๒ มี.ค. ๒๕๔๕
โครงรถ	frame	๑๒ มี.ค. ๒๕๔๕
โครงกระจังหน้ารถ	cowl	๑๒ มี.ค. ๒๕๔๕
โครงขดลวดสนามแม่เหล็ก	field-frame assembly	๑๒ มี.ค. ๒๕๔๕
โครงคุ้มกัน	rool bar	๑๒ มี.ค. ๒๕๔๕
เครื่องเจียหน้าลิ้น	valve refacer	๑๒ มี.ค. ๒๕๔๕
เครื่องเจียผิวราบ	surface grinder	๑๒ มี.ค. ๒๕๔๕
เครื่องเดินค้าง	afterrunning; dieseling; running-on; run-on	๑๒ มี.ค. ๒๕๔๕
เครื่องยนต์	engine	๑๒ มี.ค. ๒๕๔๕
เครื่องยนต์โรทารี	rotary engine	๑๒ มี.ค. ๒๕๔๕
เครื่องยนต์ระบายความร้อนด้วยอากาศ	air-cooled engine	๑๒ มี.ค. ๒๕๔๕
เครื่องยนต์ระบายความร้อนด้วยของเหลว	liquid-cooled engine	๑๒ มี.ค. ๒๕๔๕
เครื่องยนต์ระบายความร้อนด้วยน้ำ	water-cooled engine	๑๒ มี.ค. ๒๕๔๕
เครื่องยนต์โอเอชวี, เครื่องยนต์แบบลิ้นเหนือสูบ	OHV engine; overhead-valve engine	๑๒ มี.ค. ๒๕๔๕
เครื่องยนต์โอเอชซี, เครื่องยนต์แบบเพลาลูก เบี้ยวเหนือสูบ	OHC engine; overhead-camshaft engine	๑๒ มี.ค. ๒๕๔๕
เครื่องยนต์แอเดียแบติก	adiabatic engine	๑๒ มี.ค. ๒๕๔๕
เครื่องยนต์เอสไอ, เครื่องยนต์จุดระเบิดด้วย ประกายไฟ	SI engine; spark-ignition engine	๑๒ มี.ค. ๒๕๔๕
เครื่องยนต์แกโซลีน	gasolene engine	๑๒ มี.ค. ๒๕๔๕
เครื่องยนต์แก๊ส	gas engine	๑๒ มี.ค. ๒๕๔๕
เครื่องยนต์ใช้เชื้อเพลิงสองชนิด	dual fuel engine	๑๒ มี.ค. ๒๕๔๕
เครื่องยนต์เดินผิดปรกติ	hunting	๑๒ มี.ค. ๒๕๔๕
เครื่องยนต์แต่ง	modified engine	๑๒ มี.ค. ๒๕๔๕
เครื่องยนต์เบนซิน	petrol engine	๑๒ มี.ค. ๒๕๔๕
เครื่องยนต์แบบรูปตัววี	V-engine; V-type engine	๑๒ มี.ค. ๒๕๔๕
เครื่องยนต์แบบเผาไหม้ไอดีบาง	lean-burn engine; lean-burning engine	๑๒ มี.ค. ๒๕๔๕
เครื่องยนต์แบบเพลาลูกเบี้ยวเหนือสูบ, เครื่องยนต์โอเอชซี	overhead-camshaft engine; OHC engine	๑๒ มี.ค. ๒๕๔๕
เครื่องยนต์แบบเพลาลูกเบี้ยวคู่เหนือสูบ, เครื่องยนต์ดีโอเอชซี	double-overhead-camshaft engine; DOHC engine	๑๒ มี.ค. ๒๕๔๕
เครื่องยนต์แบบหัวรูปตัวแอล	L-head engine	๑๒ มี.ค. ๒๕๔๕
เครื่องยนต์แบบหัวรูปตัวเอฟ	F-head engine	๑๒ มี.ค. ๒๕๔๕
เครื่องยนต์แบบหัวรูปตัวไอ	I-head engine	๑๒ มี.ค. ๒๕๔๕
เครื่องยนต์แบบหัวแบน	flat-head engine	๑๒ มี.ค. ๒๕๔๕
เครื่องยนต์แบบลิ้นเหนือสูบ, เครื่องยนต์โอเอชวี	overhead-valve engine; OHV engine	๑๒ มี.ค. ๒๕๔๕
เครื่องยนต์แบบลิ้นในฝาสูบ	valve-in-head engine	๑๒ มี.ค. ๒๕๔๕
เครื่องยนต์แบบลิ้นข้าง	side-valve engine	๑๒ มี.ค. ๒๕๔๕
เครื่องยนต์แปดหรือหกสูบเรียงแถว	straight eight/six	๑๒ มี.ค. ๒๕๔๕
เครื่องยนต์เผาไหม้ภายใน, เครื่องยนต์ไอซี	internal combustion engine; IC engine	๑๒ มี.ค. ๒๕๔๕
เครื่องยนต์วังเกล	Wankel engine; Wankel rotary engine	๑๒ มี.ค. ๒๕๔๕
เครื่องยนต์หมดกำลัง; ลิ้นเบี่ยงไอเสีย; สะพานไฟ	cut-out	๑๒ มี.ค. ๒๕๔๕
เครื่องยนต์สเตอร์ลิง	Stirling engine	๑๒ มี.ค. ๒๕๔๕
เครื่องยนต์สะดุดดับ	stall	๑๒ มี.ค. ๒๕๔๕
เครื่องยนต์ส่วนหลัก	short block; short engine; short motor	๑๒ มี.ค. ๒๕๔๕
เครื่องยนต์สองจังหวะ	two cycle engine; two-stroke cycle engine; two-stroke engine	๑๒ มี.ค. ๒๕๔๕
เครื่องยนต์สี่จังหวะ	four-cycle engine; four-stroke cycle engine; four-stroke engine	๑๒ มี.ค. ๒๕๔๕
เครื่องยนต์สูบเรียง	in-line engine	๑๒ มี.ค. ๒๕๔๕
เครื่องยนต์สูบนอนยันกัน	boxer engine; flat engine; horizontally opposed engine; pancake engine	๑๒ มี.ค. ๒๕๔๕
เครื่องยนต์ลิ้นไอดีเหนือลิ้นไอเสีย	inlet over exhaust	๑๒ มี.ค. ๒๕๔๕
เครื่องยนต์ลูกสูบ	piston engine; reciprocating engine	๑๒ มี.ค. ๒๕๔๕
เครื่องยนต์ไฮโดรคาร์บอน	hydrocarbon engine	๑๒ มี.ค. ๒๕๔๕
เครื่องยนต์ไอซี, เครื่องยนต์เผาไหมภายใน	IC engine; internal combustion engine	๑๒ มี.ค. ๒๕๔๕
เครื่องยนต์กระบอกสูบเอียง	slant engine	๑๒ มี.ค. ๒๕๔๕
เครื่องยนต์กังหันแก๊ส	gas turbine engine	๑๒ มี.ค. ๒๕๔๕
เครื่องยนต์จุดระเบิดด้วยการอัด, เครื่องยนต์ซีไอ	compression-ignition engine; CI engine	๑๒ มี.ค. ๒๕๔๕
เครื่องยนต์จุดระเบิดด้วยประกายไฟ, เครื่องยนต์เอสไอ	spark-ignition engine; SI engine	๑๒ มี.ค. ๒๕๔๕
เครื่องยนต์ช่วงชักยาว	undersquare engine	๑๒ มี.ค. ๒๕๔๕
เครื่องยนต์ช่วงชักเท่า	square engine	๑๒ มี.ค. ๒๕๔๕
เครื่องยนต์ช่วงชักสั้น	oversquare engine	๑๒ มี.ค. ๒๕๔๕
เครื่องยนต์ซีไอ, เครื่องยนต์จุดระเบิดด้วยการอัด	CI engine; compression-ignition engine	๑๒ มี.ค. ๒๕๔๕
เครื่องยนต์ดีโอเอชซี, เครื่องยนต์แบบเพลาลูกเบี้ยวคู่เหนือสูบ	DOHC engine; double-overhead- camshaft engine	๑๒ มี.ค. ๒๕๔๕
เครื่องยนต์ดีเซล	diesel engine	๑๒ มี.ค. ๒๕๔๕
เครื่องยนต์ติดยากขณะเย็น	cold hard start	๑๒ มี.ค. ๒๕๔๕
เครื่องยนต์ติดยากขณะร้อน	hot hard start	๑๒ มี.ค. ๒๕๔๕
เครื่องยนต์ธรรมดา	normally aspirated engine	๑๒ มี.ค. ๒๕๔๕
เครื่องมือถอนสลักขาด	stud extractor	๑๒ มี.ค. ๒๕๔๕
เครื่องวิเคราะห์ไอเสีย	exhaust-gas analyser	๑๒ มี.ค. ๒๕๔๕
เครื่องหมายตั้งจังหวะ	timing mark	๑๒ มี.ค. ๒๕๔๕
เครื่องหมายที่ล้อตุนกำลัง	flywheel markings	๑๒ มี.ค. ๒๕๔๕
เครื่องสูบเชื้อเพลิงไฟฟ้า, ปั๊มเชื้อเพลิงไฟฟ้า	electric fuel pump	๑๒ มี.ค. ๒๕๔๕
เครื่องสูบเบนซิน, ปั๊มเบนซิน	petrol pump	๑๒ มี.ค. ๒๕๔๕
เครื่องสูบเฟือง, ปั๊มเฟือง	gear pump; gear-type pump	๑๒ มี.ค. ๒๕๔๕
เครื่องสูบลม	air pump	๑๒ มี.ค. ๒๕๔๕
เครื่องสูบไดอะแฟรม, ปั๊มไดอะแฟรม	diaphragm pump	๑๒ มี.ค. ๒๕๔๕
เครื่องสูบ, ปั๊ม	pump	๑๒ มี.ค. ๒๕๔๕
เครื่องสูบเร่ง	accelerator pump	๑๒ มี.ค. ๒๕๔๕
เครื่องสูบน้ำมันเครื่อง, ปั๊มน้ำมันเครื่อง	oil pump	๑๒ มี.ค. ๒๕๔๕
เครื่องสูบน้ำมันเครื่องแบบตัวหมุน, ปั๊มน้ำมันเครื่องแบบตัวหมุน	rotor oil pump	๑๒ มี.ค. ๒๕๔๕
เครื่องสูบป้อนเชื้อเพลิง, ปั๊มป้อนเชื้อเพลิง	fuel feed pump; fuel pump	๑๒ มี.ค. ๒๕๔๕
เครื่องอัดอากาศ	air compressor	๑๒ มี.ค. ๒๕๔๕
เครื่องอัดน้ำมันเบรก	pressure bleeder	๑๒ มี.ค. ๒๕๔๕
เครื่องกรองและแยก	filter separator	๑๒ มี.ค. ๒๕๔๕
เครื่องกำเนิดไฟฟ้า	generator	๑๒ มี.ค. ๒๕๔๕
เครื่องกำเนิดไฟฟ้าสลับ	alternator	๑๒ มี.ค. ๒๕๔๕
เครื่องกลึงเบรก	drum lathe	๑๒ มี.ค. ๒๕๔๕
เครื่องขัดกระบอก	cylinder hone	๑๒ มี.ค. ๒๕๔๕
เครื่องขจัดผิวมันลื่น	glaze breaker	๑๒ มี.ค. ๒๕๔๕
เครื่องคว้านกระบอกสูบ	cylinder boring machine	๑๒ มี.ค. ๒๕๔๕
เครื่องชี้บอกความดันน้ำมันเครื่อง	oil-pressure indicator	๑๒ มี.ค. ๒๕๔๕
เครื่องดับ	die out	๑๒ มี.ค. ๒๕๔๕
เครื่องดับเพราะเย็น	fade-out	๑๒ มี.ค. ๒๕๔๕
เครื่องถ่วงล้อ	wheel balancer	๑๒ มี.ค. ๒๕๔๕
เครื่องทดสอบการรั่วของกระบอกสูบ	cylinder leakage tester	๑๒ มี.ค. ๒๕๔๕
เครื่องทดสอบการอัดในกระบอกสูบ	compression tester; cylinder compression tester	๑๒ มี.ค. ๒๕๔๕
เครื่องทดสอบความดัน	pressure tester	๑๒ มี.ค. ๒๕๔๕
เครื่องประจุแบตเตอรี่	battery charger	๑๒ มี.ค. ๒๕๔๕
เครื่องประจุแบตเตอรี่แบบเร็ว	quick charger	๑๒ มี.ค. ๒๕๔๕
เครื่องปาดขอบในของกระบอกสูบ	cylinder ridge reamer; ridge reamer; ring-ridge remover	๑๒ มี.ค. ๒๕๔๕
เครื่องปฏิกรณ์อุณหภาพ	thermal reactor	๑๒ มี.ค. ๒๕๔๕
เครื่องฟอกไอเสียเชิงเร่งปฏิกิริยา, แคทาลิติกคอนเวอร์เตอร์	catalytic converter	๑๒ มี.ค. ๒๕๔๕
เครื่องฟอกไอเสียเชิงเร่งปฏิกิริยาสองส่วน, แคทาลิติกคอนเวอร์เตอร์สองส่วน	dual-bed catalytic converter	๑๒ มี.ค. ๒๕๔๕
เครื่องฟอกไอเสียเชิงเร่งปฏิกิริยาสามทาง, แคทาลิติกคอนเวอร์เตอร์สามทาง (ทีดับเบิลยูซี)	three-way catalytic converter (TWC)	๑๒ มี.ค. ๒๕๔๕
เครื่องฟอกไอเสียเชิงเร่งปฏิกิริยาออกซิเดชัน, แคทาลิติกคอนเวอร์เตอร์แบบออกซิเดชัน	oxidation catalytic converter	๑๒ มี.ค. ๒๕๔๕
เครื่องฟังตรวจ	stethoscope	๑๒ มี.ค. ๒๕๔๕
โคลนน้ำมันเครื่อง	sludge	๑๒ มี.ค. ๒๕๔๕
แคทาลิติกคอนเวอร์เตอร์, เครื่องฟอก ไอเสียเชิงเร่งปฏิกิริยา	catalytic converter	๑๒ มี.ค. ๒๕๔๕
แคทาลิติกคอนเวอร์เตอร์แบบออกซิเดชัน, เครื่อง ฟอกไอเสียเชิงเร่งปฏิกิริยาออกซิเดชัน	oxidation catalytic converter	๑๒ มี.ค. ๒๕๔๕
แคทาลิติกคอนเวอร์เตอร์สองส่วน, เครื่องฟอกไอเสียเชิงเร่งปฏิกิริยาสองส่วน	dual-bed catalytic converter	๑๒ มี.ค. ๒๕๔๕
แคทาลิติกคอนเวอร์เตอร์สามทาง, เครื่องฟอกไอเสียเชิงเร่งปฏิกิริยา สามทาง (ทีดับเบิลยูซี)	three-way catalytic converter (TWC)	๑๒ มี.ค. ๒๕๔๕
โคน	heel	๑๒ มี.ค. ๒๕๔๕
แง่ลูกเบี้ยว	cam lobe	๑๒ มี.ค. ๒๕๔๕
เจอร์นัล, ข้อสัมผัส	journal	๑๒ มี.ค. ๒๕๔๕
เจอร์นัลหลัก, ข้อสัมผัสหลัก	main journal	๑๒ มี.ค. ๒๕๔๕
แฉลบ	wander	๑๒ มี.ค. ๒๕๔๕
โช้ก	choke; strangler	๑๒ มี.ค. ๒๕๔๕
โช้กอัตโนมัติ	automatic choke	๑๒ มี.ค. ๒๕๔๕
โช้กไฟฟ้า	electric-assist choke	๑๒ มี.ค. ๒๕๔๕
แชสซี	chassis	๑๒ มี.ค. ๒๕๔๕
แชสซีไดนาโมมิเตอร์	chassis dynamometer	๑๒ มี.ค. ๒๕๔๕
เชื้อเพลิง	fuel	๑๒ มี.ค. ๒๕๔๕
เชื้อเพลิงมวลชีวภาพ	biomass fuel	๑๒ มี.ค. ๒๕๔๕
เชื้อเพลิงฟอสซิล	fossil fuel	๑๒ มี.ค. ๒๕๔๕
โซ่เพลาลูกเบี้ยว	timing chain	๑๒ มี.ค. ๒๕๔๕
เซอร์โว	servo	๑๒ มี.ค. ๒๕๔๕
เซรามิก	ceramic	๑๒ มี.ค. ๒๕๔๕
โซเลนอยด์	solenoid	๑๒ มี.ค. ๒๕๔๕
โซเลนอยด์กันเครื่องเดินค้าง	antidieseling solenoid	๑๒ มี.ค. ๒๕๔๕
โซเลนอยด์ควบคุมตำแหน่งลิ้นปีกผีเสื้อ	throttle solenoid positioner	๑๒ มี.ค. ๒๕๔๕
โซเลนอยด์คลัตช์	clutch solenoid	๑๒ มี.ค. ๒๕๔๕
เซลล์เชื้อเพลิง	fuel cell	๑๒ มี.ค. ๒๕๔๕
เดินเบา	idle; idling; tick-over	๑๒ มี.ค. ๒๕๔๕
เดินเบารอบสูง	fast idle	๑๒ มี.ค. ๒๕๔๕
เดินเบาไม่เรียบ	rough idle	๑๒ มี.ค. ๒๕๔๕
เดินเบาไม่สม่ำเสมอ	loping idle; rolling idle	๑๒ มี.ค. ๒๕๔๕
เดินเบาขณะเครื่องร้อน	curb idle	๑๒ มี.ค. ๒๕๔๕
แดชพอต	dashpot	๑๒ มี.ค. ๒๕๔๕
เดือยบังคับเลี้ยว	steering pivot; steering swivel	๑๒ มี.ค. ๒๕๔๕
แตร	horn	๑๒ มี.ค. ๒๕๔๕
แตรลม; ท่ออากาศเข้าคาร์บูเรเตอร์	air horn	๑๒ มี.ค. ๒๕๔๕
เดือย	spigot	๑๒ มี.ค. ๒๕๔๕
เต้น	bounce; flutter	๑๒ มี.ค. ๒๕๔๕
โตงเตง, ห่วงยึดแหนบ	shackle; spring shackle	๑๒ มี.ค. ๒๕๔๕
รถเก๋ง	saloon; sedan	๑๒ มี.ค. ๒๕๔๕
รถเก๋งมีประตูท้าย	hatchback	๑๒ มี.ค. ๒๕๔๕
รถเก๋งหรูสมรรถนะสูง (จีที)	Grand Touring; Gran Turismo (GT)	๑๒ มี.ค. ๒๕๔๕
รถเก๋งท้ายยก	liftback	๑๒ มี.ค. ๒๕๔๕
รถเก๋งท้ายหยัก	notchback	๑๒ มี.ค. ๒๕๔๕
รถเก๋งท้ายลาด	fastback	๑๒ มี.ค. ๒๕๔๕
รถแทรกเตอร์; หัวลาก	tractor	๑๒ มี.ค. ๒๕๔๕
รถยนต์นั่ง	passenger car	๑๒ มี.ค. ๒๕๔๕
รถเปิดประทุน	convertible	๑๒ มี.ค. ๒๕๔๕
รถกึ่งพ่วงปรับความยาวได้	pole trailer	๑๒ มี.ค. ๒๕๔๕
รถคูเป	coupé	๑๒ มี.ค. ๒๕๔๕
รถชุดควบคุมคู่	dual control car	๑๒ มี.ค. ๒๕๔๕
รถตรวจการ	estate car; station wagon	๑๒ มี.ค. ๒๕๔๕
รถลีมูซีน	limousine	๑๒ มี.ค. ๒๕๔๕
รถกึ่งพ่วง	semi trailer	๑๒ มี.ค. ๒๕๔๕
แถบเบรก	brake band	๑๒ มี.ค. ๒๕๔๕
แถบกาวปิดกันสี	masking tape	๑๒ มี.ค. ๒๕๔๕
รถพ่วง	trailer	๑๒ มี.ค. ๒๕๔๕
รถพิกอัป	pickup truck	๑๒ มี.ค. ๒๕๔๕
โทเอาต์	toe-out	๑๒ มี.ค. ๒๕๔๕
โทเอาต์ขณะเลี้ยว	toe-out on turns	๑๒ มี.ค. ๒๕๔๕
เท้าค้ำยัน	landing gear; landing leg	๑๒ มี.ค. ๒๕๔๕
แท่งบิด, ทอร์ชันบาร์	torsion bar; torsion-bar spring	๑๒ มี.ค. ๒๕๔๕
แท่นยึดหูแหนบ	hanger bracket; spring hanger	๑๒ มี.ค. ๒๕๔๕
แท่นวางลิ้น	valve rack	๑๒ มี.ค. ๒๕๔๕
แท่นอัด	press	๑๒ มี.ค. ๒๕๔๕
แท่นอัดไฮดรอลิก	hydraulic press	๑๒ มี.ค. ๒๕๔๕
เทอร์มอไซฟอน	thermo-syphon	๑๒ มี.ค. ๒๕๔๕
โทอิน	toe-in	๑๒ มี.ค. ๒๕๔๕
เททระเอทิลเลด	TEL (tetraethyl lead)	๑๒ มี.ค. ๒๕๔๕
เทอร์มอสแตต	thermostat	๑๒ มี.ค. ๒๕๔๕
-ยนต์, มอเตอร์	motor	๑๒ มี.ค. ๒๕๔๕
เบรก, ห้ามล้อ	brake	๑๒ มี.ค. ๒๕๔๕
เบรกเสริมกำลัง	power brake	๑๒ มี.ค. ๒๕๔๕
เบรกเสริมกำลังแบบหม้อสุญญากาศ	vacuum-suspended power brake	๑๒ มี.ค. ๒๕๔๕
เบรกเสียดสี	brake drag	๑๒ มี.ค. ๒๕๔๕
เบรกเท้า	foot brake	๑๒ มี.ค. ๒๕๔๕
เบรกแบบเกือกนำสองตัว	two-leading-shoe brakes	๑๒ มี.ค. ๒๕๔๕
เบรกมือ	handbrake	๑๒ มี.ค. ๒๕๔๕
เบรกสาย	cable brake	๑๒ มี.ค. ๒๕๔๕
เบรกหนัก	hard pedal	๑๒ มี.ค. ๒๕๔๕
เบรกลม	air brake	๑๒ มี.ค. ๒๕๔๕
เบรกลื่น	brake fade	๑๒ มี.ค. ๒๕๔๕
เบรกกลไฮโดร	hydro-mechanical brake	๑๒ มี.ค. ๒๕๔๕
เบรกจอด	parking brake	๑๒ มี.ค. ๒๕๔๕
เบรกจานชนิดก้ามปูลอย	floating-caliper disc brake	๑๒ มี.ค. ๒๕๔๕
เบรกจานชนิดก้ามปูคงที่	fixed-caliper disc brake	๑๒ มี.ค. ๒๕๔๕
เบรกฉุกเฉิน	emergency brake	๑๒ มี.ค. ๒๕๔๕
เบรกดุม	drum brake	๑๒ มี.ค. ๒๕๔๕
เบาะนั่งกระชับ	bucket seat	๑๒ มี.ค. ๒๕๔๕
แบตเตอรี่	battery	๑๒ มี.ค. ๒๕๔๕
แบตเตอรี่ประจุแห้ง	dry-charged battery	๑๒ มี.ค. ๒๕๔๕
แบตเตอรี่ปลอดการบำรุงรักษา	maintenance-free battery	๑๒ มี.ค. ๒๕๔๕
เบนซิน	petrol	๑๒ มี.ค. ๒๕๔๕
เบนซินไร้สารตะกั่ว (ยูแอลพี)	unleaded petrol (ULP)	๑๒ มี.ค. ๒๕๔๕
แบบคลื่นเรียงแนวตั้ง	raster pattern; stacked pattern	๑๒ มี.ค. ๒๕๔๕
แบบคลื่นเรียงแนวนอน	parade pattern	๑๒ มี.ค. ๒๕๔๕
แบบคลื่นเรียงซ้อนทับ	superimposed pattern	๑๒ มี.ค. ๒๕๔๕
ใบปัดน้ำฝน	wiper blade	๑๒ มี.ค. ๒๕๔๕
ใบพัด	impeller	๑๒ มี.ค. ๒๕๔๕
แปรงถ่าน	carbon brush	๑๒ มี.ค. ๒๕๔๕
แป้นเกลียว, น็อต	nut	๑๒ มี.ค. ๒๕๔๕
แป้นเกลียวล็อก	lock nut; locknut	๑๒ มี.ค. ๒๕๔๕
แป้นเกลียวล็อกตัวเอง	self-locking nut	๑๒ มี.ค. ๒๕๔๕
แป้นเกลียวกันคลาย	prevailing-torque nut	๑๒ มี.ค. ๒๕๔๕
แป้นเกลียวปีก	wing nut	๑๒ มี.ค. ๒๕๔๕
เปลี่ยนเกียร์ลง	downshift	๑๒ มี.ค. ๒๕๔๕
เปลี่ยนเกียร์ขึ้น	upshift	๑๒ มี.ค. ๒๕๔๕
เปลือกรองลื่น	bearing shell	๑๒ มี.ค. ๒๕๔๕
แผ่นเบรก	brake pad; friction pad; pad	๑๒ มี.ค. ๒๕๔๕
แผ่นยืดกันฝุ่น	gaiter	๑๒ มี.ค. ๒๕๔๕
แผ่นรับกลอนประตูรถ	striker plate	๑๒ มี.ค. ๒๕๔๕
แผ่นสะท้อนแสง	reflector	๑๒ มี.ค. ๒๕๔๕
แผ่นหลังเบรก	brake back plate	๑๒ มี.ค. ๒๕๔๕
แผ่นจีม	shim	๑๒ มี.ค. ๒๕๔๕
แผ่นกั้นในแบตเตอรี่	battery separator; separator	๑๒ มี.ค. ๒๕๔๕
แผ่นกันเกิดฟอง	antifroth baffle	๑๒ มี.ค. ๒๕๔๕
แผ่นกดคลัตช์	clutch pressure plate; pressure plate	๑๒ มี.ค. ๒๕๔๕
แผ่นคลัตช์	clutch disc; clutch plate; driven disc; driven plate; friction disc; friction plate	๑๒ มี.ค. ๒๕๔๕
แผ่นธาตุ	plate	๑๒ มี.ค. ๒๕๔๕
แผ่นประกอบผ้าคลัตช์	clutch driven plate	๑๒ มี.ค. ๒๕๔๕
แผ่นปะทะ	baffle; baffle plate	๑๒ มี.ค. ๒๕๔๕
แผ่นป้องลม	shroud	๑๒ มี.ค. ๒๕๔๕
แผงหน้ารถ	front panel	๑๒ มี.ค. ๒๕๔๕
แผงหน้าปัด	dashboard; instrument panel	๑๒ มี.ค. ๒๕๔๕
แผงหน้าปัด; ผนังห้องเครื่อง	dash	๑๒ มี.ค. ๒๕๔๕
แผงท้ายรถ	rear panel	๑๒ มี.ค. ๒๕๔๕
แผงฟิวส์	fuse block	๑๒ มี.ค. ๒๕๔๕
แผนภาพระบบไฟ	wiring diagram	๑๒ มี.ค. ๒๕๔๕
โพรนีเบรก	prony brake	๑๒ มี.ค. ๒๕๔๕
เพลา	axle	๑๒ มี.ค. ๒๕๔๕
เพลา	shaft	๑๒ มี.ค. ๒๕๔๕
เพลาเยื้องศูนย์กลาง	eccentric shaft	๑๒ มี.ค. ๒๕๔๕
เพลารับกำลังเข้า	input shaft	๑๒ มี.ค. ๒๕๔๕
เพลาแข็ง	solid axle	๑๒ มี.ค. ๒๕๔๕
เพลาเต้น	axle tramp	๑๒ มี.ค. ๒๕๔๕
เพลาเป็น	live axle	๑๒ มี.ค. ๒๕๔๕
เพลาเฟืองเล็ก	pinion shaft	๑๒ มี.ค. ๒๕๔๕
เพลาหน้า	front axle	๑๒ มี.ค. ๒๕๔๕
เพลาลอย	floating axle; full-floating axle; fully- floating axle	๑๒ มี.ค. ๒๕๔๕
เพลาลูกเบี้ยว	camshaft	๑๒ มี.ค. ๒๕๔๕
เพลากระเดื่องกดลิ้น	rocker shaft	๑๒ มี.ค. ๒๕๔๕
เพลากลาง	propeller shaft	๑๒ มี.ค. ๒๕๔๕
เพลานำ	pilot shaft	๑๒ มี.ค. ๒๕๔๕
เพลาข้าง	half axle; half shaft	๑๒ มี.ค. ๒๕๔๕
เพลาขับ	drive shaft	๑๒ มี.ค. ๒๕๔๕
เพลาขับแบบปีก	swing axle	๑๒ มี.ค. ๒๕๔๕
เพลาขับจานจ่าย	distributor drive shaft	๑๒ มี.ค. ๒๕๔๕
เพลาคาน	beam axle; rigid axle	๑๒ มี.ค. ๒๕๔๕
เพลาคลัตช์	clutch shaft; first-motion shaft	๑๒ มี.ค. ๒๕๔๕
เพลาท้าย	rear axle	๑๒ มี.ค. ๒๕๔๕
เพลาท้ายทดรอบสองระดับ	double reduction axle	๑๒ มี.ค. ๒๕๔๕
เพลาท้ายทดความเร็วสองระดับ	two-speed rear axle	๑๒ มี.ค. ๒๕๔๕
เพลาทดรอบแบบสองตอน	dual reduction axle	๑๒ มี.ค. ๒๕๔๕
แพนอากาศ	aerofoil; airfoil	๑๒ มี.ค. ๒๕๔๕
เฟืองเสี้ยว	sector	๑๒ มี.ค. ๒๕๔๕
เฟืองเหลื่อมความเร็วแบบจำกัดการลื่น	limited-slip differential; nonslip differential	๑๒ มี.ค. ๒๕๔๕
เฟืองเหลื่อมความเร็วทดสองระดับ	double-reduction differential	๑๒ มี.ค. ๒๕๔๕
เฟืองเล็ก	pinion; pinion gear	๑๒ มี.ค. ๒๕๔๕
เฟืองเล็กขบแบบคงตัว	constant-mesh pinion	๑๒ มี.ค. ๒๕๔๕
เฟืองเลื่อน	sliding gear	๑๒ มี.ค. ๒๕๔๕
เฟืองโซ่	sprocket	๑๒ มี.ค. ๒๕๔๕
เฟืองแพลเนต	planet gear; planet pinion	๑๒ มี.ค. ๒๕๔๕
เฟืองเพลาลูกเบี้ยว	timing gear	๑๒ มี.ค. ๒๕๔๕
เฟืองเพลาข้อเหวี่ยง	crankshaft gear	๑๒ มี.ค. ๒๕๔๕
เฟืองเพลาคลัตช์	clutch gear	๑๒ มี.ค. ๒๕๔๕
เฟืองวงแหวน; เฟืองบายศรี; เฟืองสตาร์ต	ring gear	๑๒ มี.ค. ๒๕๔๕
เฟืองวงแหวนล้อตุนกำลัง	flywheel ring gear	๑๒ มี.ค. ๒๕๔๕
เฟืองสะพาน	rack and pinion gear	๑๒ มี.ค. ๒๕๔๕
เฟืองส่งผ่าน	idle-gear; idler gear	๑๒ มี.ค. ๒๕๔๕
เฟืองส่งผ่านเกียร์ถอยหลัง	reverse idler gear	๑๒ มี.ค. ๒๕๔๕
เฟืองสไปเดอร์	spider gear	๑๒ มี.ค. ๒๕๔๕
เฟืองสตาร์ต; เฟืองบายศรี; เฟืองวงแหวน	ring gear	๑๒ มี.ค. ๒๕๔๕
เฟืองฮีลิกซ์	helical gear	๑๒ มี.ค. ๒๕๔๕
เฟืองกลาง	sun gear	๑๒ มี.ค. ๒๕๔๕
เฟืองขับ	drive pinion; driving pinion	๑๒ มี.ค. ๒๕๔๕
เฟืองขับมอเตอร์ติดเครื่อง, เฟืองขับมอเตอร์สตาร์ต	starter pinion gear	๑๒ มี.ค. ๒๕๔๕
เฟืองขบแบบคงตัว	constant-mesh gears	๑๒ มี.ค. ๒๕๔๕
เฟืองขบกัน	meshing gears	๑๒ มี.ค. ๒๕๔๕
เฟืองดอกจอก	bevel gear	๑๒ มี.ค. ๒๕๔๕
เฟืองดอกจอกไฮพอยด์, เฟืองไฮพอยด์	hypoid bevel gear; hypoid gear	๑๒ มี.ค. ๒๕๔๕
เฟืองดอกจอกฟันโค้ง	spiralbevel gear	๑๒ มี.ค. ๒๕๔๕
เฟืองบังคับเลี้ยว; เฟืองพวงมาลัย	steering gear	๑๒ มี.ค. ๒๕๔๕
เฟืองบังคับเลี้ยวแบบแท่งปิด	torsion bar steering gear	๑๒ มี.ค. ๒๕๔๕
เฟืองบังคับเลี้ยวแบบเฟืองสะพาน	rack-and-pinion steering gear	๑๒ มี.ค. ๒๕๔๕
เฟืองบายศรี	crown wheel	๑๒ มี.ค. ๒๕๔๕
เฟืองบายศรี, เฟืองวงแหวน; เฟืองสตาร์ต	ring gear	๑๒ มี.ค. ๒๕๔๕
เฟืองพวงมาลัย; เฟืองบังคับเลี้ยว	steering gear	๑๒ มี.ค. ๒๕๔๕
เฟืองฟันตรง	spur gear; straight-cut gear	๑๒ มี.ค. ๒๕๔๕
มุมรวม	included angle	๑๒ มี.ค. ๒๕๔๕
มุมเอียงสลักล้อ	king pin angle	๑๒ มี.ค. ๒๕๔๕
มุมแคมเบอร์	camber angle	๑๒ มี.ค. ๒๕๔๕
มุมเบนออก	attitude angle	๑๒ มี.ค. ๒๕๔๕
มุมหน้าทองขาวปิด	cam angle	๑๒ มี.ค. ๒๕๔๕
มุมลูกหมาก	ball-joint angle	๑๒ มี.ค. ๒๕๔๕
มุมลื่นไถล	slip angle	๑๒ มี.ค. ๒๕๔๕
มุมดเวลล์	dwell; dwell angle; dwell period	๑๒ มี.ค. ๒๕๔๕
มุมคาสเตอร์	caster angle; castor angle	๑๒ มี.ค. ๒๕๔๕
รุ่นปี	model year	๑๒ มี.ค. ๒๕๔๕
back pressure	ความดันต้านกลับ	๑๒ มี.ค. ๒๕๔๕
backfire	การจุดระเบิดย้อนกลับ	๑๒ มี.ค. ๒๕๔๕
backfire-suppressor valve; antibackfire valve; gulp valve	ลิ้นกันการจุดระเบิดย้อนกลับ	๑๒ มี.ค. ๒๕๔๕
backlash	ระยะคลอน	๑๒ มี.ค. ๒๕๔๕
backup light; reversing light	ไฟถอยหลัง	๑๒ มี.ค. ๒๕๔๕
baffle; baffle plate	แผ่นปะทะ	๑๒ มี.ค. ๒๕๔๕
bais-balted tyre; belted-bias tire; belted-bias tyre; bias-belted tire; bias-belted tyre	ยางเสริมเข็มขัดรัด	๑๒ มี.ค. ๒๕๔๕
balanced carburetor	คาร์บูเรเตอร์ได้ดุล	๑๒ มี.ค. ๒๕๔๕
balanced valve	ลิ้นได้ดุล	๑๒ มี.ค. ๒๕๔๕
balanced weight assortment	ชุดวัสดุถ่วงล้อ	๑๒ มี.ค. ๒๕๔๕
balancing-coil gauge	เกจขดลวดดุล	๑๒ มี.ค. ๒๕๔๕
balk ring; baulk ring	แหวนช่วยการเข้าเกียร์	๑๒ มี.ค. ๒๕๔๕
ball	๑. ลูกปืน๒. เม็ดกลม	๑๒ มี.ค. ๒๕๔๕
ball bearing	ตลับลูกปืนเม็ดกลม	๑๒ มี.ค. ๒๕๔๕
ball check valve	ลิ้นกันกลับเม็ดกลม	๑๒ มี.ค. ๒๕๔๕
ball joint	(ข้อต่อ)ลูกหมาก	๑๒ มี.ค. ๒๕๔๕
ball seat	บ่าลิ้นเม็ดกลม	๑๒ มี.ค. ๒๕๔๕
ball stud	๑. สลักเกลียวสองปลายหัวมน๒. ลูกหมาก	๑๒ มี.ค. ๒๕๔๕
ball valve	ลิ้นเม็ดกลม	๑๒ มี.ค. ๒๕๔๕
ball-joint angle	มุมลูกหมาก	๑๒ มี.ค. ๒๕๔๕
ball-joint suspension	ระบบรองรับแบบลูกหมาก	๑๒ มี.ค. ๒๕๔๕
banking	การเอียงตัว	๑๒ มี.ค. ๒๕๔๕
barrel	๑. กระบอกสูบ๒. ท่อ	๑๒ มี.ค. ๒๕๔๕
base circle	วงกลมฐาน	๑๒ มี.ค. ๒๕๔๕
battery element; element	ชุดแผ่นธาตุ	๑๒ มี.ค. ๒๕๔๕
battery separator; separator	แผ่นกั้นในแบตเตอรี่	๑๒ มี.ค. ๒๕๔๕
battery	แบตเตอรี่	๑๒ มี.ค. ๒๕๔๕
battery charger	เครื่องประจุแบตเตอรี่	๑๒ มี.ค. ๒๕๔๕
battery charging	การประจุแบตเตอรี่, การอัดแบตเตอรี่	๑๒ มี.ค. ๒๕๔๕
baulk ring; balk ring	แหวนช่วยการเข้าเกียร์	๑๒ มี.ค. ๒๕๔๕
BDC (bottom dead center)	บีดีซี (ศูนย์ตายล่าง)	๑๒ มี.ค. ๒๕๔๕
bead	ขอบในยางนอก	๑๒ มี.ค. ๒๕๔๕
beam axle; rigid axle	เพลาคาน	๑๒ มี.ค. ๒๕๔๕
bearing	๑. ตลับลูกปืน๒. รองลื่น	๑๒ มี.ค. ๒๕๔๕
bearing cap	ฝารองลื่น	๑๒ มี.ค. ๒๕๔๕
bearing clearance	ระยะห่างรองลื่น	๑๒ มี.ค. ๒๕๔๕
bearing crush	ระยะอัดรองลื่น	๑๒ มี.ค. ๒๕๔๕
bearing groove	ร่องรองลื่น	๑๒ มี.ค. ๒๕๔๕
bearing shell	เปลือกรองลื่น	๑๒ มี.ค. ๒๕๔๕
bearing spin	รองลื่นสปิน	๑๒ มี.ค. ๒๕๔๕
bearing spread	ระยะถ่างรองลื่น	๑๒ มี.ค. ๒๕๔๕
bedding-in	การขัดแต่งเข้าที่	๑๒ มี.ค. ๒๕๔๕
before top dead center (BTDC)	ก่อนศูนย์ตายบน (บีทีดีซี)	๑๒ มี.ค. ๒๕๔๕
bellows	ส่วนพับยืด	๑๒ มี.ค. ๒๕๔๕
belted-bias tire; bais-balted tyre; belted-bias tyre; bias-belted tire; bias-belted tyre	ยางเสริมเข็มขัดรัด	๑๒ มี.ค. ๒๕๔๕
belt	๑. สายพาน๒. เข็มขัดรัดหน้ายาง	๑๒ มี.ค. ๒๕๔๕
bevel gear	เฟืองดอกจอก	๑๒ มี.ค. ๒๕๔๕
bhp (brake horsepower)	บีเอชพี (แรงม้าเพลา)	๑๒ มี.ค. ๒๕๔๕
bias-belted tire; bais-balted tyre; belted-bias tire; belted-bias tyre; bias-belted tyre	ยางเสริมเข็มขัดรัด	๑๒ มี.ค. ๒๕๔๕
bias-ply tire; bias-ply tyre; cross-ply tire; cross-ply tyre	ยางธรรมดา	๑๒ มี.ค. ๒๕๔๕
big-end; rod big end	ปลายใหญ่ก้านสูบ	๑๒ มี.ค. ๒๕๔๕
biomass fuel	เชื้อเพลิงมวลชีวภาพ	๑๒ มี.ค. ๒๕๔๕
bleed	ไล่ลม	๑๒ มี.ค. ๒๕๔๕
bleeder valve	ลิ้นไล่ลม	๑๒ มี.ค. ๒๕๔๕
blow-back; pop-back; popping back; spit-back	การเผาไหม้ย้อนกลับ	๑๒ มี.ค. ๒๕๔๕
blow-by	แก๊สรั่ว	๑๒ มี.ค. ๒๕๔๕
bmep (brake mean effective pressure)	บีเอ็มอีพี (ความดันประสิทธิผลเฉลี่ยสำหรับแรงม้าเพลา)	๑๒ มี.ค. ๒๕๔๕
bolt	สลักเกลียว	๑๒ มี.ค. ๒๕๔๕
bonnet; hood	ฝากระโปรงห้องเครื่อง	๑๒ มี.ค. ๒๕๔๕
boost pressure; manifold pressure	ความดันเสริมในท่อร่วมไอดี	๑๒ มี.ค. ๒๕๔๕
boot; trunk	ห้องเก็บของ	๑๒ มี.ค. ๒๕๔๕
bore; cylinder bore	ขนาดกระบอกสูบ	๑๒ มี.ค. ๒๕๔๕
bore out	คว้านกระบอกสูบ	๑๒ มี.ค. ๒๕๔๕
boring; rebore; reboring	การคว้านกระบอกสูบ	๑๒ มี.ค. ๒๕๔๕
bottom dead center (BDC)	ศูนย์ตายล่าง (บีดีซี)	๑๒ มี.ค. ๒๕๔๕
bounce; flutter	เต้น	๑๒ มี.ค. ๒๕๔๕
box wrench; ring spanner	ประแจแหวน	๑๒ มี.ค. ๒๕๔๕
boxer engine; flat engine; horizontally opposed engine; pancake engine	เครื่องยนต์สูบนอนยันกัน	๑๒ มี.ค. ๒๕๔๕
bp (brake power)	บีพี (กำลังเพลา)	๑๒ มี.ค. ๒๕๔๕
brake	เบรก, ห้ามล้อ	๑๒ มี.ค. ๒๕๔๕
brake anchor; anchor pin	สลักเบรก	๑๒ มี.ค. ๒๕๔๕
brake back plate	แผ่นหลังเบรก	๑๒ มี.ค. ๒๕๔๕
brake band	แถบเบรก	๑๒ มี.ค. ๒๕๔๕
brake bleeding	การไล่ลมเบรก	๑๒ มี.ค. ๒๕๔๕
brake cam	ลูกเบี้ยวเบรก	๑๒ มี.ค. ๒๕๔๕
brake cylinder; brake wheel cylinder; slave cylinder; wheel cylinder	ชุดกระบอกเบรก	๑๒ มี.ค. ๒๕๔๕
brake disc	จานเบรก	๑๒ มี.ค. ๒๕๔๕
brake dive	หน้ารถทิ่ม	๑๒ มี.ค. ๒๕๔๕
brake drag	เบรกเสียดสี	๑๒ มี.ค. ๒๕๔๕
brake drum	ดุมเบรก	๑๒ มี.ค. ๒๕๔๕
brake fade	เบรกลื่น	๑๒ มี.ค. ๒๕๔๕
brake fluid	น้ำมันเบรก	๑๒ มี.ค. ๒๕๔๕
brake flushing	การล้างระบบน้ำมันเบรก	๑๒ มี.ค. ๒๕๔๕
brake horsepower (bhp)	แรงม้าเพลา (บีเอชพี)	๑๒ มี.ค. ๒๕๔๕
brake light; stop light	ไฟเบรก	๑๒ มี.ค. ๒๕๔๕
brake lining; lining	ผ้าเบรก	๑๒ มี.ค. ๒๕๔๕
brake mean effective pressure (bmep)	ความดันประสิทธิผลเฉลี่ยสำหรับแรงม้าเพลา (บีเอ็มอีพี)	๑๒ มี.ค. ๒๕๔๕
brake pad; friction pad; pad	แผ่นเบรก	๑๒ มี.ค. ๒๕๔๕
brake power (bp)	กำลังเพลา (บีพี)	๑๒ มี.ค. ๒๕๔๕
brake shoe; shoe	เกือกเบรก, ฝักเบรก	๑๒ มี.ค. ๒๕๔๕
brake system	ระบบเบรก	๑๒ มี.ค. ๒๕๔๕
brake wheel cylinder; brake cylinder; slave cylinder; wheel cylinder	ชุดกระบอกเบรก	๑๒ มี.ค. ๒๕๔๕
brake-drum glaze	ผิวดุมเบรกเรียบลื่น	๑๒ มี.ค. ๒๕๔๕
braking distance	ระยะเบรก	๑๒ มี.ค. ๒๕๔๕
braking force	แรงเบรก	๑๒ มี.ค. ๒๕๔๕
breather	ช่องหายใจ, ช่องระบาย	๑๒ มี.ค. ๒๕๔๕
break-in	การทำให้สึกเข้าที่	๑๒ มี.ค. ๒๕๔๕
breaker arm	ก้านทองขาว	๑๒ มี.ค. ๒๕๔๕
breaker cam; distributor cam	ลูกเบี้ยวจานจ่าย	๑๒ มี.ค. ๒๕๔๕
breaker point ignition system; contact-point ignition system	ระบบจุดระเบิดแบบทองขาว	๑๒ มี.ค. ๒๕๔๕
breaker points; contact points; points	หน้าทองขาว	๑๒ มี.ค. ๒๕๔๕
breakerless ignition	การจุดระเบิดแบบไร้ทองขาว	๑๒ มี.ค. ๒๕๔๕
BTDC (before top dead center)	บีทีดีซี (ก่อนศูนย์ตายบน)	๑๒ มี.ค. ๒๕๔๕
bucket seat	เบาะนั่งกระชับ	๑๒ มี.ค. ๒๕๔๕
bump stop	ตัวกันกระแทก	๑๒ มี.ค. ๒๕๔๕
bump-steer	ท้ายรถปัดส่าย	๑๒ มี.ค. ๒๕๔๕
bumper	กันชน	๑๒ มี.ค. ๒๕๔๕
bush	ปลอก, บุช	๑๒ มี.ค. ๒๕๔๕
butterfly valve; throttle; throttle plate; throttle valve	ลิ้นปีกผีเสื้อ	๑๒ มี.ค. ๒๕๔๕
bypass valve	ลิ้นเบี่ยง	๑๒ มี.ค. ๒๕๔๕
bypass filter	หม้อกรองเบี่ยงบางส่วน	๑๒ มี.ค. ๒๕๔๕
cable	สายเคเบิล	๑๒ มี.ค. ๒๕๔๕
cable brake	เบรกสาย	๑๒ มี.ค. ๒๕๔๕
cadence braking; pump-braking	การย้ำเบรกกันปัด	๑๒ มี.ค. ๒๕๔๕
calorific value	ค่าความร้อน	๑๒ มี.ค. ๒๕๔๕
cam	ลูกเบี้ยว	๑๒ มี.ค. ๒๕๔๕
cam -ground piston	ลูกสูบวงรี	๑๒ มี.ค. ๒๕๔๕
cam angle	มุมหน้าทองขาวปิด	๑๒ มี.ค. ๒๕๔๕
cam follower	ตัวตามลูกเบี้ยว	๑๒ มี.ค. ๒๕๔๕
cam lobe	แง่ลูกเบี้ยว	๑๒ มี.ค. ๒๕๔๕
camshaft	เพลาลูกเบี้ยว	๑๒ มี.ค. ๒๕๔๕
camber angle	มุมแคมเบอร์	๑๒ มี.ค. ๒๕๔๕
canister	กล่องดักไอน้ำมัน	๑๒ มี.ค. ๒๕๔๕
capacitor	ตัวเก็บประจุ	๑๒ มี.ค. ๒๕๔๕
capacitor-discharge ignition (CDI)	การจุดระเบิดด้วยตัวเก็บประจุ (ซีดีไอ)	๑๒ มี.ค. ๒๕๔๕
car stand; jack stand; safety stand	ขาตั้งรับรถ	๑๒ มี.ค. ๒๕๔๕
carbon brush	แปรงถ่าน	๑๒ มี.ค. ๒๕๔๕
carbon canister; charcoal canister	กล่องดักไอน้ำมันแบบใช้ถ่าน	๑๒ มี.ค. ๒๕๔๕
carbon monoxide	คาร์บอนมอนอกไซด์	๑๒ มี.ค. ๒๕๔๕
carbonize	การเกิดคาร์บอน	๑๒ มี.ค. ๒๕๔๕
carburetion	การผสมน้ำมันกับอากาศ	๑๒ มี.ค. ๒๕๔๕
carburetor; carburettor	คาร์บูเรเตอร์	๑๒ มี.ค. ๒๕๔๕
carburettor; carburetor	คาร์บูเรเตอร์	๑๒ มี.ค. ๒๕๔๕
carcass; tire carcass; tire casing; tyre carcass; tyre casing	โครงยาง	๑๒ มี.ค. ๒๕๔๕
caster angle; castor angle	คาสเตอร์	๑๒ มี.ค. ๒๕๔๕
catalytic converter	เครื่องฟอกไอเสียเชิงเร่งปฏิกิริยา, แคทาลิติกคอนเวอร์เตอร์	๑๒ มี.ค. ๒๕๔๕
CDI (capacitor-discharge ignition)	ซีดีไอ (การจุดระเบิดด้วยตัวเก็บประจุ)	๑๒ มี.ค. ๒๕๔๕
center electrode	แกนหัวเทียน	๑๒ มี.ค. ๒๕๔๕
centrifugal advance	เร่งไฟหนีศูนย์กลาง	๑๒ มี.ค. ๒๕๔๕
ว่าง	neutral	๑๒ มี.ค. ๒๕๔๕
ceramic	เซรามิก	๑๒ มี.ค. ๒๕๔๕
ceramic filter	ตัวกรองแบบเซรามิก	๑๒ มี.ค. ๒๕๔๕
cetane number	เลขซีเทน	๑๒ มี.ค. ๒๕๔๕
chain tensioner	ตัวปรับความตึงโซ่	๑๒ มี.ค. ๒๕๔๕
chamfer	การลบมุม	๑๒ มี.ค. ๒๕๔๕
charcoal canister; carbon canister	กล่องดักไอน้ำมันแบบใช้ถ่าน	๑๒ มี.ค. ๒๕๔๕
charge	ประจุ	๑๒ มี.ค. ๒๕๔๕
charging rate	อัตราการประจุ	๑๒ มี.ค. ๒๕๔๕
chassis dynamometer	แชสซีไดนาโมมิเตอร์	๑๒ มี.ค. ๒๕๔๕
chassis	แชสซี	๑๒ มี.ค. ๒๕๔๕
check valve; non-return valve	ลิ้นกันกลับ	๑๒ มี.ค. ๒๕๔๕
childproof lock	ล็อกกันเด็ก	๑๒ มี.ค. ๒๕๔๕
choke; strangler	โช้ก	๑๒ มี.ค. ๒๕๔๕
choke flap; strangler flap	ลิ้นโช้ก	๑๒ มี.ค. ๒๕๔๕
choke tube	ท่อโช้ก	๑๒ มี.ค. ๒๕๔๕
chrome-plated ring	แหวนชุบโครเมียม	๑๒ มี.ค. ๒๕๔๕
CI engine; compression-ignition engine	เครื่องยนต์ซีไอ, เครื่องยนต์จุดระเบิดด้วยการอัด	๑๒ มี.ค. ๒๕๔๕
circlip	แหวนล็อกสลัก	๑๒ มี.ค. ๒๕๔๕
clearance	ระยะห่าง	๑๒ มี.ค. ๒๕๔๕
closed circuit	วงจรปิด	๑๒ มี.ค. ๒๕๔๕
closed crankcase ventilation system	ระบบระบายอากาศห้องข้อเหวี่ยงแบบปิด	๑๒ มี.ค. ๒๕๔๕
clutch	คลัตช์	๑๒ มี.ค. ๒๕๔๕
clutch safety switch	สวิตช์นิรภัยของคลัตช์	๑๒ มี.ค. ๒๕๔๕
clutch shaft; first-motion shaft	เพลาคลัตช์	๑๒ มี.ค. ๒๕๔๕
clutch slave cylinder	ชุดกระบอกคลัตช์	๑๒ มี.ค. ๒๕๔๕
clutch slip	คลัตช์ลื่น	๑๒ มี.ค. ๒๕๔๕
clutch solenoid	โซเลนอยด์คลัตช์	๑๒ มี.ค. ๒๕๔๕
clutch spring; release spring	สปริงคลัตช์	๑๒ มี.ค. ๒๕๔๕
clutch thrust bearing; release bearing; throwout bearing; withdrawal bearing	ตลับลูกปืนคลัตช์	๑๒ มี.ค. ๒๕๔๕
clylinder compression tester; compression tester; cylinder compression tester	เครื่องทดสอบการอัดในกระบอกสูบ	๑๒ มี.ค. ๒๕๔๕
clutch disc; clutch plate; driven disc; driven plate; friction disc; friction plate	แผ่นคลัตช์	๑๒ มี.ค. ๒๕๔๕
clutch drag	คลัตช์เสียดสี	๑๒ มี.ค. ๒๕๔๕
clutch driven plate	แผ่นประกอบผ้าคลัตช์	๑๒ มี.ค. ๒๕๔๕
clutch fork	ก้ามปูคลัตช์	๑๒ มี.ค. ๒๕๔๕
clutch gear	เฟืองเพลาคลัตช์	๑๒ มี.ค. ๒๕๔๕
clutch housing	เสื้อคลัตช์, เรือนคลัตช์	๑๒ มี.ค. ๒๕๔๕
clutch lining	ผ้าคลัตช์	๑๒ มี.ค. ๒๕๔๕
clutch pedal	คันเหยียบคลัตช์	๑๒ มี.ค. ๒๕๔๕
clutch plate; clutch disc; driven disc; driven plate; friction disc; friction plate	แผ่นคลัตช์	๑๒ มี.ค. ๒๕๔๕
clutch pressure plate; pressure plate	แผ่นกดคลัตช์	๑๒ มี.ค. ๒๕๔๕
วัสดุบุหลังคา	headlining; roof lining	๑๒ มี.ค. ๒๕๔๕
วัสดุปะเก็นแอโรบิก	aerobic gasket material; room-temperature- vulcanising sealant; RTV sealant	๑๒ มี.ค. ๒๕๔๕
วัฏจักร	cycle	๑๒ มี.ค. ๒๕๔๕
วัฏจักรสามแบบวิธี	three-mode cycle	๑๒ มี.ค. ๒๕๔๕
วัฏจักรดีเซล	diesel cycle	๑๒ มี.ค. ๒๕๔๕
วัฏจักรสี่จังหวะ	four-cycle; four-stroke; four-stroke cycle	๑๒ มี.ค. ๒๕๔๕
วัฏจักรขับทดสอบ	driving cycle	๑๒ มี.ค. ๒๕๔๕
วีเอสเอส (ตัวรับรู้อัตราเร็วพาหนะ)	VSS (vehicle speed sensor)	๑๒ มี.ค. ๒๕๔๕
coated ring	แหวนเคลือบ	๑๒ มี.ค. ๒๕๔๕
coast	วิ่งด้วยแรงเฉื่อย	๑๒ มี.ค. ๒๕๔๕
coefficient of air drag; drag coefficient	สัมประสิทธิ์แรงต้านลม	๑๒ มี.ค. ๒๕๔๕
วิ่งด้วยแรงเฉื่อย	coast	๑๒ มี.ค. ๒๕๔๕
cog belt; toothed belt	สายพานร่องฟัน	๑๒ มี.ค. ๒๕๔๕
coil ignition	การจุดระเบิดด้วยคอยล์	๑๒ มี.ค. ๒๕๔๕
coil spring; helical spring	สปริงขด	๑๒ มี.ค. ๒๕๔๕
coil-spring clutch	คลัตช์สปริงขด	๑๒ มี.ค. ๒๕๔๕
cold hard start	เครื่องยนต์ติดยากขณะเย็น	๑๒ มี.ค. ๒๕๔๕
cold patching	การปะยางแบบเย็น	๑๒ มี.ค. ๒๕๔๕
cold plug	หัวเทียนเย็น	๑๒ มี.ค. ๒๕๔๕
collapsible steering column	แกนพวงมาลัยยุบตัวได้	๑๒ มี.ค. ๒๕๔๕
collet; split cone	ประกับล็อก	๑๒ มี.ค. ๒๕๔๕
compression gauge	เกจวัดการอัด	๑๒ มี.ค. ๒๕๔๕
compression pressure	ความดันอัด	๑๒ มี.ค. ๒๕๔๕
compression ratio	อัตราส่วนการอัด	๑๒ มี.ค. ๒๕๔๕
compression ring	แหวนอัด	๑๒ มี.ค. ๒๕๔๕
compression stroke	จังหวะอัด	๑๒ มี.ค. ๒๕๔๕
compression tester; clylinder compression tester; cylinder compression tester	เครื่องทดสอบการอัดในกระบอกสูบ	๑๒ มี.ค. ๒๕๔๕
compression-ignition engine; CI engine	เครื่องยนต์ซีไอ, เครื่องยนต์จุดระเบิดด้วยการอัด	๑๒ มี.ค. ๒๕๔๕
con-rod; connecting rod	ก้านสูบ	๑๒ มี.ค. ๒๕๔๕
connecting rod; con-rod	ก้านสูบ	๑๒ มี.ค. ๒๕๔๕
connecting-rod bearing; rod bearing	รองลื่นก้านสูบ	๑๒ มี.ค. ๒๕๔๕
connecting-rod journal; crankpin	สลักข้อเหวี่ยง	๑๒ มี.ค. ๒๕๔๕
constant-current charging	การประจุแบบกระแสคงตัว, การอัดไฟแบบกระแสคงตัว	๑๒ มี.ค. ๒๕๔๕
constant-mesh gears	เฟืองขบแบบคงตัว	๑๒ มี.ค. ๒๕๔๕
constant-mesh pinion	เฟืองเล็กขบแบบคงตัว	๑๒ มี.ค. ๒๕๔๕
constant mesh transmission	การส่งกำลังแบบเฟืองขบคงตัว	๑๒ มี.ค. ๒๕๔๕
constant vacuum carburetor	คาร์บูเรเตอร์แบบสุญญากาศคงตัว	๑๒ มี.ค. ๒๕๔๕
contact points; breaker points; points	หน้าทองขาว	๑๒ มี.ค. ๒๕๔๕
contact-point ignition system; breaker point igenition system	ระบบจุดระเบิดแบบทองขาว	๑๒ มี.ค. ๒๕๔๕
control arm; suspension arm; wishbone; wishbone arm	ปีกนก	๑๒ มี.ค. ๒๕๔๕
control box	กล่องควบคุม	๑๒ มี.ค. ๒๕๔๕
control system	ระบบควบคุม	๑๒ มี.ค. ๒๕๔๕
convertible	รถเปิดประทุน	๑๒ มี.ค. ๒๕๔๕
coolant	ตัวทำให้เย็น	๑๒ มี.ค. ๒๕๔๕
coolant-override valve; vacuum-control valve	ลิ้นช่องสุญญากาศ	๑๒ มี.ค. ๒๕๔๕
cooling system	ระบบทำให้เย็น	๑๒ มี.ค. ๒๕๔๕
core	ไส้หม้อน้ำ	๑๒ มี.ค. ๒๕๔๕
cord	เส้นตีเกลียวเสริมยาง	๑๒ มี.ค. ๒๕๔๕
core hole plug; core plug; expansion plug; freeze plug; welch plug	ปลั๊กตาน้ำ	๑๒ มี.ค. ๒๕๔๕
cornering force	แรงเลี้ยวรถ	๑๒ มี.ค. ๒๕๔๕
cornering wear	การสึกจากการเลี้ยวรถ	๑๒ มี.ค. ๒๕๔๕
cotter pin; split pin	สลักปลายแยก	๑๒ มี.ค. ๒๕๔๕
counterbored ring	แหวนอัดปาดขอบใน	๑๒ มี.ค. ๒๕๔๕
counterweight	น้ำหนักถ่วง	๑๒ มี.ค. ๒๕๔๕
coupé	รถคูเป	๑๒ มี.ค. ๒๕๔๕
coupling	๑. คู่ต่อประกบ, ชุดต่อประกบ๒. การต่อประกบ	๑๒ มี.ค. ๒๕๔๕
courtesy light	ไฟเก๋ง	๑๒ มี.ค. ๒๕๔๕
cowl	โครงกระจังหน้ารถ	๑๒ มี.ค. ๒๕๔๕
วาล์ว, ลิ้น	valve	๑๒ มี.ค. ๒๕๔๕
วาล์วหล่อเย็นด้วยโซเดียม	sodium-cooled valve; sodium-filled valve	๑๒ มี.ค. ๒๕๔๕
วาล์วควบคุมสุญญากาศด้วยอุณหภูมิ	vacuum-control temperature-sensing valve	๑๒ มี.ค. ๒๕๔๕
วีไอ (ดรรชนีความหนืด)	VI (viscosity index)	๑๒ มี.ค. ๒๕๔๕
วีไอเอ็น (เลขตัวถัง)	VIN (vehicle identification number)	๑๒ มี.ค. ๒๕๔๕
วิชายานยนต์	automotive mechanics	๑๒ มี.ค. ๒๕๔๕
crankcase	ห้องข้อเหวี่ยง	๑๒ มี.ค. ๒๕๔๕
crankcase breather	ช่องหายใจห้องข้อเหวี่ยง	๑๒ มี.ค. ๒๕๔๕
crankcase dilution	การเจือจางน้ำมันห้องข้อเหวี่ยง	๑๒ มี.ค. ๒๕๔๕
crankcase emissions	สารมลพิษจากห้องข้อเหวี่ยง	๑๒ มี.ค. ๒๕๔๕
crankcase ventilation	การระบายไอห้องข้อเหวี่ยง	๑๒ มี.ค. ๒๕๔๕
cranking motor; starter; starter motor; starting motor	มอเตอร์ติดเครื่อง, มอเตอร์สตาร์ต	๑๒ มี.ค. ๒๕๔๕
crankpin; connecting-rod journal	สลักข้อเหวี่ยง	๑๒ มี.ค. ๒๕๔๕
crank	ข้อเหวี่ยง	๑๒ มี.ค. ๒๕๔๕
crank throw	๑. สลักข้อเหวี่ยงพร้อมแขน๒. ระยะเหวี่ยง	๑๒ มี.ค. ๒๕๔๕
crank web	แขนข้อเหวี่ยง	๑๒ มี.ค. ๒๕๔๕
crankpin ridging	การสึกเป็นร่องของสลักข้อเหวี่ยง	๑๒ มี.ค. ๒๕๔๕
crankshaft gear	เฟืองเพลาข้อเหวี่ยง	๑๒ มี.ค. ๒๕๔๕
cross-fire injection	การฉีดน้ำมันไขว้	๑๒ มี.ค. ๒๕๔๕
cross-ply tire; bias-ply tire; bias-ply tyre; cross-ply tyre	ยางธรรมดา	๑๒ มี.ค. ๒๕๔๕
cross-ply tyre; bias-ply tire; bias-ply tyre; cross-ply tire	ยางธรรมดา	๑๒ มี.ค. ๒๕๔๕
crossflow radiator	หม้อน้ำไหลแนวนอน	๑๒ มี.ค. ๒๕๔๕
crown wheel	เฟืองบายศรี	๑๒ มี.ค. ๒๕๔๕
cruise control	อุปกรณ์คงความเร็วรถ	๑๒ มี.ค. ๒๕๔๕
curb idle	เดินเบาขณะเครื่องร้อน	๑๒ มี.ค. ๒๕๔๕
curb weight	น้ำหนักรถเปล่า	๑๒ มี.ค. ๒๕๔๕
current regulator	ตัวคุมค่ากระแส	๑๒ มี.ค. ๒๕๔๕
cut-out	๑. สะพานไฟ๒. เครื่องยนต์หมดกำลัง๓. ลิ้นเบี่ยงไอเสีย	๑๒ มี.ค. ๒๕๔๕
cutout relay	รีเลย์สะพานไฟ	๑๒ มี.ค. ๒๕๔๕
cutting compound; rubbing compound	ยาขัดสี	๑๒ มี.ค. ๒๕๔๕
cycle	วัฏจักร	๑๒ มี.ค. ๒๕๔๕
cycling-clutch system	ระบบปรับอากาศใช้คลัตช์	๑๒ มี.ค. ๒๕๔๕
cylinder bore gauge	เกจขนาดกระบอกสูบ	๑๒ มี.ค. ๒๕๔๕
cylinder boring machine	เครื่องคว้านกระบอกสูบ	๑๒ มี.ค. ๒๕๔๕
cylinder compression tester; clylinder compression tester; compression tester	เครื่องทดสอบการอัดในกระบอกสูบ	๑๒ มี.ค. ๒๕๔๕
cylinder head; head	ฝาสูบ	๑๒ มี.ค. ๒๕๔๕
cylinder hone	เครื่องขัดกระบอก	๑๒ มี.ค. ๒๕๔๕
cylinder jacket; water jacket	ช่องน้ำเสื้อสูบ	๑๒ มี.ค. ๒๕๔๕
cylinder leakage tester	เครื่องทดสอบการรั่วของกระบอกสูบ	๑๒ มี.ค. ๒๕๔๕
cylinder liner; cylinder sleeve	ปลอกสูบ	๑๒ มี.ค. ๒๕๔๕
cylinder ridge reamer; ridge reamer; ring-ridge remover	เครื่องปาดขอบในของกระบอกสูบ	๑๒ มี.ค. ๒๕๔๕
cylinder sleeve; cylinder liner	ปลอกสูบ	๑๒ มี.ค. ๒๕๔๕
cylinder-head gasket	ปะเก็นฝาสูบ	๑๒ มี.ค. ๒๕๔๕
cylinder	๑. กระบอกสูบ๒. กระบอก	๑๒ มี.ค. ๒๕๔๕
cylinder block; engine block	เสื้อสูบ	๑๒ มี.ค. ๒๕๔๕
cylinder bore; bore	ขนาดกระบอกสูบ	๑๒ มี.ค. ๒๕๔๕
วงแหวนเฟืองใน	annulus	๑๒ มี.ค. ๒๕๔๕
วงแหวนจุดหมุน	fulcrum ring	๑๒ มี.ค. ๒๕๔๕
วงกลมฐาน	base circle	๑๒ มี.ค. ๒๕๔๕
วงจรเปิด	open circuit	๑๒ มี.ค. ๒๕๔๕
วงจรขนาน	parallel circuit	๑๒ มี.ค. ๒๕๔๕
วงจรทุติยภูมิ	secondary circuit	๑๒ มี.ค. ๒๕๔๕
วงจรปิด	closed circuit	๑๒ มี.ค. ๒๕๔๕
วงจรปฐมภูมิ	primary circuit	๑๒ มี.ค. ๒๕๔๕
วงจรพิมพ์	printed circuit	๑๒ มี.ค. ๒๕๔๕
damper	๑. ตัวหน่วง ๒. ตัวหน่วงการสั่นสะเทือน	๑๒ มี.ค. ๒๕๔๕
dash	๑. ผนังห้องเครื่อง ๒. แผงหน้าปัด [มีความหมายเหมือนกับ dashboard; instrument panel]	๑๒ มี.ค. ๒๕๔๕
dashboard; instrument panel	แผงหน้าปัด	๑๒ มี.ค. ๒๕๔๕
dashpot	แดชพอต [มีความหมายเหมือนกับ throttle-return check]	๑๒ มี.ค. ๒๕๔๕
detergent	สารชะล้าง	๑๒ มี.ค. ๒๕๔๕
detonation	การระเบิดรุนแรง	๑๒ มี.ค. ๒๕๔๕
Deutsche Industrie Norm (DIN)	สำนักงานมาตรฐานอุตสาหกรรมของสหพันธ์สาธารณรัฐเยอรมนี (ดีน)	๑๒ มี.ค. ๒๕๔๕
diagnosis	การวินิจฉัย	๑๒ มี.ค. ๒๕๔๕
diagonally split braking system	ระบบเบรกวงจรไขว้	๑๒ มี.ค. ๒๕๔๕
diaphragm	ไดอะแฟรม	๑๒ มี.ค. ๒๕๔๕
diaphragm pump	เครื่องสูบไดอะแฟรม, ปั๊มไดอะแฟรม	๑๒ มี.ค. ๒๕๔๕
diaphragm spring	สปริงไดอะแฟรม	๑๒ มี.ค. ๒๕๔๕
diaphragm-spring clutch	คลัตช์แบบสปริงไดอะแฟรม	๑๒ มี.ค. ๒๕๔๕
die out	เครื่องดับ	๑๒ มี.ค. ๒๕๔๕
diesel cycle	วัฏจักรดีเซล	๑๒ มี.ค. ๒๕๔๕
diesel engine	เครื่องยนต์ดีเซล	๑๒ มี.ค. ๒๕๔๕
diesel oil	น้ำมันดีเซล	๑๒ มี.ค. ๒๕๔๕
dieseling; afterrunning; running-on; run-on	เครื่องเดินค้าง	๑๒ มี.ค. ๒๕๔๕
DIN (Deutsche Industrie Norm)	ดีน (สำนักงานมาตรฐานอุตสาหกรรมของสหพันธ์สาธารณรัฐเยอรมนี)	๑๒ มี.ค. ๒๕๔๕
DIN brake horsepower (DIN bhp)	แรงม้าเพลาดีน (บีเอชพีดีน)	๑๒ มี.ค. ๒๕๔๕
dipped headlight; low beam; lower beam	ไฟต่ำ	๑๒ มี.ค. ๒๕๔๕
dipstick; oil-level indicator	ก้านวัดน้ำมันเครื่อง	๑๒ มี.ค. ๒๕๔๕
directional signal; turn signal	สัญญาณไฟเลี้ยว	๑๒ มี.ค. ๒๕๔๕
dispersant	ตัวกระจาย	๑๒ มี.ค. ๒๕๔๕
displacement; engine displacement	ความจุเครื่องยนต์	๑๒ มี.ค. ๒๕๔๕
distributor; ignition distributor; timer	จานจ่าย	๑๒ มี.ค. ๒๕๔๕
distributor cam; breaker cam	ลูกเบี้ยวจานจ่าย	๑๒ มี.ค. ๒๕๔๕
distributor cap	ฝาครอบจานจ่าย	๑๒ มี.ค. ๒๕๔๕
distributor drive shaft	เพลาขับจานจ่าย	๑๒ มี.ค. ๒๕๔๕
distributor plate	จานทองขาว	๑๒ มี.ค. ๒๕๔๕
distributor rotor; distributor rotor arm; rotor arm	หัวนกกระจอก	๑๒ มี.ค. ๒๕๔๕
distributor rotor arm; distributor rotor; rotor arm	หัวนกกระจอก	๑๒ มี.ค. ๒๕๔๕
distributor weights	ลูกตุ้มในจานจ่าย	๑๒ มี.ค. ๒๕๔๕
distributorless ignition	การจุดระเบิดแบบไร้จานจ่าย	๑๒ มี.ค. ๒๕๔๕
diverter valve	ลิ้นเปลี่ยนทางอากาศ	๑๒ มี.ค. ๒๕๔๕
dog clutch	คลัตช์ฟัน	๑๒ มี.ค. ๒๕๔๕
DOHC engine; double-overhead-camshaft engine	เครื่องยนต์ดีโอเอชซี, เครื่องยนต์แบบเพลาลูกเบี้ยวคู่เหนือสูบ	๑๒ มี.ค. ๒๕๔๕
dolly	ที่รองค้อนเคาะ	๑๒ มี.ค. ๒๕๔๕
double reduction axle	เพลาท้ายทดรอบสองระดับ	๑๒ มี.ค. ๒๕๔๕
double-overhead camshaft engine; DOHC engine	เครื่องยนต์แบบเพลาลูกเบี้ยวคู่เหนือสูบ, เครื่องยนต์ดีโอเอชซี	๑๒ มี.ค. ๒๕๔๕
downflow radiator	หม้อน้ำไหลลง	๑๒ มี.ค. ๒๕๔๕
downshift	เปลี่ยนเกียร์ลง	๑๒ มี.ค. ๒๕๔๕
doughnut coupling	คู่ต่อประกบวงแหวน, ชุดต่อประกบวงแหวน	๑๒ มี.ค. ๒๕๔๕
dowel; dowel pin	สลักนำ	๑๒ มี.ค. ๒๕๔๕
dowel pin; dowel	สลักนำ	๑๒ มี.ค. ๒๕๔๕
downdraft carburetor; downdraught carburettor	คาร์บูเรเตอร์แบบดูดลง	๑๒ มี.ค. ๒๕๔๕
double-reduction differential	เฟืองเหลื่อมความเร็วทดสองระดับ [มีความหมายเหมือนกับ two-speed rear axle]	๑๒ มี.ค. ๒๕๔๕
drag coefficient; coefficient of air drag	สัมประสิทธิ์แรงต้านลม	๑๒ มี.ค. ๒๕๔๕
drain-plug	จุกเกลียวถ่าย	๑๒ มี.ค. ๒๕๔๕
drifting	การบังคับเลี้ยวไถล	๑๒ มี.ค. ๒๕๔๕
drag link	คันดึง	๑๒ มี.ค. ๒๕๔๕
drive line	ชุดเพลาขับ	๑๒ มี.ค. ๒๕๔๕
drive pinion; driving pinion	เฟืองขับ	๑๒ มี.ค. ๒๕๔๕
drive shaft	เพลาขับ	๑๒ มี.ค. ๒๕๔๕
drive train; power train	ขบวนส่งกำลัง	๑๒ มี.ค. ๒๕๔๕
drive-fit; press-fit	การสวมอัด	๑๒ มี.ค. ๒๕๔๕
driveability	การเอื้อต่อการขับขี่	๑๒ มี.ค. ๒๕๔๕
driven disc; clutch disc; clutch plate; driven plate; friction disc, friction plate	แผ่นคลัตช์	๑๒ มี.ค. ๒๕๔๕
driving cycle	วัฏจักรขับทดสอบ	๑๒ มี.ค. ๒๕๔๕
driving pinion; drive pinion	เฟืองขับ	๑๒ มี.ค. ๒๕๔๕
drop-center wheel	กระทะล้อร่องกลาง	๑๒ มี.ค. ๒๕๔๕
drop arm	ขาไก่	๑๒ มี.ค. ๒๕๔๕
drum brake	เบรกดุม	๑๒ มี.ค. ๒๕๔๕
drum lathe	เครื่องกลึงเบรก	๑๒ มี.ค. ๒๕๔๕
dry liner	ปลอกสูบแบบแห้ง	๑๒ มี.ค. ๒๕๔๕
dry sump; dry sump lubrication	การหล่อลื่นแบบอ่างแห้ง	๑๒ มี.ค. ๒๕๔๕
dry sump lubrication; dry sump	การหล่อลื่นแบบอ่างแห้ง	๑๒ มี.ค. ๒๕๔๕
dry-charged battery	แบตเตอรี่ประจุแห้ง	๑๒ มี.ค. ๒๕๔๕
dry-disc clutch	คลัตช์แบบแผ่นแห้ง	๑๒ มี.ค. ๒๕๔๕
dual control car	รถชุดควบคุมคู่	๑๒ มี.ค. ๒๕๔๕
dual diaphragm vacuum advance	กลไกเร่งไฟสุญญากาศไดอะแฟรมคู่	๑๒ มี.ค. ๒๕๔๕
dual fuel engine	เครื่องยนต์ใช้เชื้อเพลิงสองชนิด	๑๒ มี.ค. ๒๕๔๕
dual braking system; dual-brake system	ระบบเบรกสองวงจร	๑๒ มี.ค. ๒๕๔๕
dual carbutetors	คาร์บูเรเตอร์คู่	๑๒ มี.ค. ๒๕๔๕
dual ignition system	ระบบจุดระเบิดคู่	๑๒ มี.ค. ๒๕๔๕
dual master cylinder	แม่ปั๊มเบรกคู่	๑๒ มี.ค. ๒๕๔๕
dual reduction axle	เพลาทดรอบแบบสองตอน	๑๒ มี.ค. ๒๕๔๕
dual-bed catalytic converter	เครื่องฟอกไอเสียเชิงเร่งปฏิกิริยาสองส่วน, แคทาลิติกคอนเวอร์เตอร์สองส่วน	๑๒ มี.ค. ๒๕๔๕
dual-brake system; dual braking system	ระบบเบรกสองวงจร	๑๒ มี.ค. ๒๕๔๕
dust cap	ฝากันฝุ่น	๑๒ มี.ค. ๒๕๔๕
dust excluder	ปลอกกันฝุ่น	๑๒ มี.ค. ๒๕๔๕
dwell; dwell angle; dwell period	มุมดเวลล์	๑๒ มี.ค. ๒๕๔๕
dwell angle; dwell; dwell period	มุมดเวลล์	๑๒ มี.ค. ๒๕๔๕
dwell meter	มาตรมุมดเวลล์	๑๒ มี.ค. ๒๕๔๕
dwell period; dwell; dwell angle	มุมดเวลล์	๑๒ มี.ค. ๒๕๔๕
Dyer drive	ชุดขับแบบดายเออร์	๑๒ มี.ค. ๒๕๔๕
dynamic balance	ดุลพลวัต	๑๒ มี.ค. ๒๕๔๕
dynamo	ไดนาโม	๑๒ มี.ค. ๒๕๔๕
dynamometer	ไดนาโมมิเตอร์	๑๒ มี.ค. ๒๕๔๕
หม้อเสริมกำลัง	power booster	๑๒ มี.ค. ๒๕๔๕
หม้อสะสมไฟฟ้า; ถังสะสม	accumulator	๑๒ มี.ค. ๒๕๔๕
หม้อลดเสียง	silencer	๑๒ มี.ค. ๒๕๔๕
หม้อกรอง, ตัวกรอง; ไส้กรอง	filter	๑๒ มี.ค. ๒๕๔๕
หม้อกรองเชื้อเพลิง, ตัวกรองเชื้อเพลิง	fuel filter	๑๒ มี.ค. ๒๕๔๕
หม้อกรองเบี่ยงบางส่วน	bypass filter	๑๒ มี.ค. ๒๕๔๕
หม้อกรองอาการแบบอัดเข้า	ram-air cleaner	๑๒ มี.ค. ๒๕๔๕
หม้อกรองอากาศ	air cleaner; air filter	๑๒ มี.ค. ๒๕๔๕
หม้อน้ำแบบท่อครีบ	tube-and fin radiator	๑๒ มี.ค. ๒๕๔๕
หม้อน้ำล้น	overflow tank	๑๒ มี.ค. ๒๕๔๕
หม้อน้ำล้น; หม้อกันล้น	expansion tank; recovery tank	๑๒ มี.ค. ๒๕๔๕
หม้อน้ำไหลแนวนอน	crossflow radiator	๑๒ มี.ค. ๒๕๔๕
หม้อน้ำไหลงลง	downflow radiator	๑๒ มี.ค. ๒๕๔๕
หม้อน้ำท่อนบน	header tank	๑๒ มี.ค. ๒๕๔๕
หม้อพัก	muffler	๑๒ มี.ค. ๒๕๔๕
หม้อกรองอากาศแบบอ่างน้ำมันเครื่อง	oil-bath cleaner; oil-bath filter	๑๒ มี.ค. ๒๕๔๕
หม้อกรองอากาศควบคุมด้วยเทอร์มอสแตต	thermostatic air cleaner; thermostatically controlled air cleaner	๑๒ มี.ค. ๒๕๔๕
หม้อกรองน้ำมันเครื่อง	oil filter	๑๒ มี.ค. ๒๕๔๕
หม้อกันล้น; หม้อน้ำล้น	expansion tank; recovery tank	๑๒ มี.ค. ๒๕๔๕
หม้อน้ำ	radiator	๑๒ มี.ค. ๒๕๔๕
หม้อน้ำแบบรังผึ้ง	ribbon-cellular radiator	๑๒ มี.ค. ๒๕๔๕
หมอกควันแบบโฟโตเคมี	photochemical smog	๑๒ มี.ค. ๒๕๔๕
สมาคมวิศวกรยานยนต์ (เอสเออี)	Society of Automotive Engineers (SAE)	๑๒ มี.ค. ๒๕๔๕
สภาพพร้อมวิ่ง	roadworthiness	๑๒ มี.ค. ๒๕๔๕
earth; ground; ground wire	สายดิน	๑๒ มี.ค. ๒๕๔๕
earth electrode	ขั้วดิน, เขี้ยวหัวเทียน	๑๒ มี.ค. ๒๕๔๕
early fuel evaporation system; EFE system	ระบบทำให้เชื้อเพลิงระเหยก่อน, ระบบอีเอฟอี	๑๒ มี.ค. ๒๕๔๕
earthing strip	สายดินแบบถัก	๑๒ มี.ค. ๒๕๔๕
east-west mounting	การวางขวาง	๑๒ มี.ค. ๒๕๔๕
สเตเตอร์	stator	๑๒ มี.ค. ๒๕๔๕
eccentric	ลูกเบี้ยวจาน	๑๒ มี.ค. ๒๕๔๕
eccentric shaft	เพลาเยื้องศูนย์กลาง	๑๒ มี.ค. ๒๕๔๕
ECM (electronic control module)	อีซีเอ็ม (มอดูลควบคุมแบบอิเล็กทรอนิกส์)	๑๒ มี.ค. ๒๕๔๕
สวิตช์สุญญากาศ	vacuum switch	๑๒ มี.ค. ๒๕๔๕
สวิตช์ช่องสุญญากาศ (พีวีเอส)	ported-vacuum switch (PVS)	๑๒ มี.ค. ๒๕๔๕
สวิตช์ติดเครื่อง	ignition switch	๑๒ มี.ค. ๒๕๔๕
สวิตช์นิรภัยเกียร์ว่าง	neutral safety switch; neutral-start switch	๑๒ มี.ค. ๒๕๔๕
สวิตช์นิรภัยของคลัตช์	clutch safety switch	๑๒ มี.ค. ๒๕๔๕
economizer	ตัวประหยัดน้ำมัน	๑๒ มี.ค. ๒๕๔๕
economy jet	นมหนูประหยัดน้ำมัน	๑๒ มี.ค. ๒๕๔๕
ECU (electronic control unit)	อีซียู (ชุดควบคุมแบบอิเล็กทรอนิกส์)	๑๒ มี.ค. ๒๕๔๕
สะพานไฟ; เครื่องยนต์หมดกำลัง; ลิ้นเบี่ยงไอเสีย	cut-out	๑๒ มี.ค. ๒๕๔๕
สะพานไฟอัตโนมัติ	automatic cut-out	๑๒ มี.ค. ๒๕๔๕
ห่วงยึดแหนบ, โตงเตง	shackle; spring shackle	๑๒ มี.ค. ๒๕๔๕
ส่วนคอด	neck	๑๒ มี.ค. ๒๕๔๕
ส่วนพับยืด	bellows	๑๒ มี.ค. ๒๕๔๕
ห้องเก็บของ	boot; trunk	๑๒ มี.ค. ๒๕๔๕
ห้องเผาไม้ครึ่งทรงกลม	hemispherical combustion chamber	๑๒ มี.ค. ๒๕๔๕
ห้องเผาไหม้สี่ลิ้น	four-valve combustion chamber	๑๒ มี.ค. ๒๕๔๕
ห้องเผาไหม้ก่อน	prechamber; precombustion chamber	๑๒ มี.ค. ๒๕๔๕
ห้องเผาไหม้ทรงลิ่ม	wedge combustion chamber	๑๒ มี.ค. ๒๕๔๕
ห้องลูกลอย	float bowl; float chamber	๑๒ มี.ค. ๒๕๔๕
ห้องข้อเหวี่ยง	crankcase	๑๒ มี.ค. ๒๕๔๕
ห้ามล้อ, เบรก	brake	๑๒ มี.ค. ๒๕๔๕
EFE system; early fuel evaporation system	ระบบทำให้เชื้อเพลิงระเหยก่อน, ระบบอีเอฟอี	๑๒ มี.ค. ๒๕๔๕
efficiency	ประสิทธิภาพ	๑๒ มี.ค. ๒๕๔๕
EFI system; electronic fuel-injection system	ระบบอีเอฟไอ, ระบบฉีดเชื้อเพลิงแบบอิเล็กทรอนิกส์	๑๒ มี.ค. ๒๕๔๕
ELB system; electronic lean-burn system	ระบบอีแอลบี, ระบบเผาไหม้ไอดีบางโดยอิเล็กทรอนิกส์	๑๒ มี.ค. ๒๕๔๕
electric fuel pump	เครื่องสูบเชื้อเพลิงไฟฟ้า, ปั๊มเชื้อเพลิงไฟฟ้า	๑๒ มี.ค. ๒๕๔๕
electric-assist choke	โช้กไฟฟ้า	๑๒ มี.ค. ๒๕๔๕
electrical system; electric system	ระบบไฟฟ้า	๑๒ มี.ค. ๒๕๔๕
electrode	ขั้วไฟฟ้า	๑๒ มี.ค. ๒๕๔๕
electrolyte	อิเล็กโทรไลต์	๑๒ มี.ค. ๒๕๔๕
electrolyte-level indicator	ตัวชี้บอกระดับอิเล็กโทรไลต์	๑๒ มี.ค. ๒๕๔๕
electronic fuel-injection system; EFI system	ระบบฉีดเชื้อเพลิงแบบอิเล็กทรอนิกส์, ระบบอีเอฟไอ	๑๒ มี.ค. ๒๕๔๕
electronic ignition system	ระบบจุดระเบิดแบบอิเล็กทรอนิกส์	๑๒ มี.ค. ๒๕๔๕
electronic lean-burn system; ELB system	ระบบเผาไหม้ไอดีบางโดยอิเล็กทรอนิกส์, ระบบอีแอลบี	๑๒ มี.ค. ๒๕๔๕
electronic control module (ECM)	มอดูลควบคุมแบบอิเล็กทรอนิกส์ (อีซีเอ็ม)	๑๒ มี.ค. ๒๕๔๕
electronic control unit (ECU)	ชุดควบคุมแบบอิเล็กทรอนิกส์ (อีซียู) [มีความหมายเหมือนกับ electronic control module (ECM)]	๑๒ มี.ค. ๒๕๔๕
electronic spark control (ESC)	การควบคุมการจุดระเบิดแบบอิเล็กทรอนิกส์ (อีเอสซี)	๑๒ มี.ค. ๒๕๔๕
element; battery element	ชุดแผ่นธาตุ	๑๒ มี.ค. ๒๕๔๕
Elliott steering knuckle	หัวต่อแกนล้อแบบเอลเลียต	๑๒ มี.ค. ๒๕๔๕
emergency signal system; hazard system	ระบบไฟกะพริบฉุกเฉิน	๑๒ มี.ค. ๒๕๔๕
emergency brake	เบรกฉุกเฉิน	๑๒ มี.ค. ๒๕๔๕
emission control	การควบคุมไอเสีย	๑๒ มี.ค. ๒๕๔๕
emission standard	มาตรฐานไอเสีย	๑๒ มี.ค. ๒๕๔๕
emulsion tube	ท่อผสม	๑๒ มี.ค. ๒๕๔๕
en-bloc; in-block; monobloc; mono-block	เสื้อสูบแบบหล่อชิ้นเดียว	๑๒ มี.ค. ๒๕๔๕
สัมประสิทธิ์แรงต้านอากาศพลศาสตร์	aerodynamic drag coefficient	๑๒ มี.ค. ๒๕๔๕
สัมประสิทธิ์แรงต้านลม	coefficient of air drag; drag coefficeint	๑๒ มี.ค. ๒๕๔๕
สัมผัสโคน	heel contact; short heel contact	๑๒ มี.ค. ๒๕๔๕
สัมผัสปลาย	short toe contact; toe contact	๑๒ มี.ค. ๒๕๔๕
หัวเทียน	sparking plug; spark plug	๑๒ มี.ค. ๒๕๔๕
หัวเทียนเย็น	cold plug	๑๒ มี.ค. ๒๕๔๕
หัวเทียนร้อน	hot plug	๑๒ มี.ค. ๒๕๔๕
หัวเทียนมีตัวต้านทาน	resistor spark plug	๑๒ มี.ค. ๒๕๔๕
หัวเผา	glow plug	๑๒ มี.ค. ๒๕๔๕
หัวอัดแบบเซิร์ก	zerk fitting	๑๒ มี.ค. ๒๕๔๕
หัวอัดจาระบี	grease nipple; nipple	๑๒ มี.ค. ๒๕๔๕
หัวลิ้น	valve head	๑๒ มี.ค. ๒๕๔๕
หัวลาก	truck tractor	๑๒ มี.ค. ๒๕๔๕
หัวลาก; รถแทรกเตอร์	tractor	๑๒ มี.ค. ๒๕๔๕
หัวลูกสูบ	piston crown; piston head	๑๒ มี.ค. ๒๕๔๕
หัวฉีด	injector nozzle	๑๒ มี.ค. ๒๕๔๕
หัวฉีด; ปากท่อ	nozzle	๑๒ มี.ค. ๒๕๔๕
หัวฉีดแบบเดือย	pintle nozzle	๑๒ มี.ค. ๒๕๔๕
หัวฉีดลม	air nozzle	๑๒ มี.ค. ๒๕๔๕
หัวต่อแกนล้อ	knuckle; steering knuckle	๑๒ มี.ค. ๒๕๔๕
หัวต่อแกนล้อแบบเอลเลียต	Elliott steering knuckle	๑๒ มี.ค. ๒๕๔๕
หัวต่อแกนล้อแบบเอลเลียตผันกลับ	reverse Elliott steering knuckle	๑๒ มี.ค. ๒๕๔๕
หัวนกกระจอก	distributor rotor; distributor rotor arm; rotor arm	๑๒ มี.ค. ๒๕๔๕
end play; end-float	ระยะรุน	๑๒ มี.ค. ๒๕๔๕
end-float; end play	ระยะรุน	๑๒ มี.ค. ๒๕๔๕
end-gas	ไอดีริมห้องเผาไหม้	๑๒ มี.ค. ๒๕๔๕
energy	พลังงาน	๑๒ มี.ค. ๒๕๔๕
engine	เครื่องยนต์	๑๒ มี.ค. ๒๕๔๕
engine block; cylinder block	เสื้อสูบ	๑๒ มี.ค. ๒๕๔๕
engine braking	การเบรกด้วยเครื่องยนต์	๑๒ มี.ค. ๒๕๔๕
engine displacement; displacement	ความจุเครื่องยนต์	๑๒ มี.ค. ๒๕๔๕
engine fan	พัดลมเครื่องยนต์	๑๒ มี.ค. ๒๕๔๕
engine mounts	ตัวรองแท่นเครื่อง	๑๒ มี.ค. ๒๕๔๕
engine power	กำลังเครื่องยนต์	๑๒ มี.ค. ๒๕๔๕
สัญญาณไฟเลี้ยว	directional signal; turn signal	๑๒ มี.ค. ๒๕๔๕
สีเมแทลลิกส์, สีเกล็ดโลหะ	metallics	๑๒ มี.ค. ๒๕๔๕
สารมลพิษจากห้องข้อเหวี่ยง	crankcase emissions	๑๒ มี.ค. ๒๕๔๕
สายเคเบิล	cable	๑๒ มี.ค. ๒๕๔๕
สารเติมแต่ง	additive	๑๒ มี.ค. ๒๕๔๕
สายหัวเทียน	plut lead	๑๒ มี.ค. ๒๕๔๕
สารหล่อลื่น	lube; lubricant	๑๒ มี.ค. ๒๕๔๕
สีรองหน้า	undercoat	๑๒ มี.ค. ๒๕๔๕
สำรองการจุดระเบิด	ignition reserve	๑๒ มี.ค. ๒๕๔๕
สีรองพื้น	prime coat	๑๒ มี.ค. ๒๕๔๕
สายไฟแรงสูง	high-tension cable; high-tension lead; high- voltage cable	๑๒ มี.ค. ๒๕๔๕
สายไฟพ่วง	jumper cable; jump lead	๑๒ มี.ค. ๒๕๔๕
สารกันเยือกแข็ง	antifreeze	๑๒ มี.ค. ๒๕๔๕
สารกันรั่ว	sealant; sealer; sealing compound	๑๒ มี.ค. ๒๕๔๕
สารกันรั่วไม่ใช้อากาศ	anaerobic sealant	๑๒ มี.ค. ๒๕๔๕
สารกันการยึดติด	antiseize compoud	๑๒ มี.ค. ๒๕๔๕
สารกันน็อก	antiknock compound	๑๒ มี.ค. ๒๕๔๕
สีเกล็ดโลหะ, สีเมแทลลิกส์	metallics	๑๒ มี.ค. ๒๕๔๕
สารขัดถู	abrasive	๑๒ มี.ค. ๒๕๔๕
สายคันเร่ง	accelerator cable	๑๒ มี.ค. ๒๕๔๕
สารชะล้าง	detergent	๑๒ มี.ค. ๒๕๔๕
สายดิน	earth; ground; ground wire	๑๒ มี.ค. ๒๕๔๕
สายดินแบบถัก	earthing strip	๑๒ มี.ค. ๒๕๔๕
สีโป๊	putty	๑๒ มี.ค. ๒๕๔๕
สีโป๊พลาสติก	plastic filler	๑๒ มี.ค. ๒๕๔๕
สารผสมอากาศกับเชื้อเพลิง, ไอดี	air-fuel mixture; fuel mixture; mixture	๑๒ มี.ค. ๒๕๔๕
สารผสมอากาศกับเชื้อเพลิง	air-fuel mixture; fuel mixture; mixture	๑๒ มี.ค. ๒๕๔๕
สายพาน; เข็มขัดรัดหน้ายาง	belt	๑๒ มี.ค. ๒๕๔๕
สายพานร่องฟัน	cog belt; toothed belt	๑๒ มี.ค. ๒๕๔๕
สายพานเพลาลูกเบี้ยว	timing belt	๑๒ มี.ค. ๒๕๔๕
สายฟิวส์	fusible link	๑๒ มี.ค. ๒๕๔๕
สีชั้นสุดท้าย	finish coat	๑๒ มี.ค. ๒๕๔๕
สำนักงานมาตรฐานอุตสาหกรรมของสหพันธ์สาธารณรัฐเยอรมนี (ดีน)	Deutsche Industrie Norm (DIN)	๑๒ มี.ค. ๒๕๔๕
ESC (electronic spark control)	อีเอสซี (การควบคุมการจุดระเบิดแบบอิเล็กทรอนิกส์)	๑๒ มี.ค. ๒๕๔๕
estate car; station wagon	รถตรวจการ	๑๒ มี.ค. ๒๕๔๕
หูแหนบ	spring eye	๑๒ มี.ค. ๒๕๔๕
ศูนย์สัมบูรณ์	absolute zero	๑๒ มี.ค. ๒๕๔๕
ศูนย์ตายล่าง (บีดีซี)	bottom dead center (BDC)	๑๒ มี.ค. ๒๕๔๕
ศูนย์ตายบน (ทีดีซี)	top dead center (TDC)	๑๒ มี.ค. ๒๕๔๕
evaporative control system; fuel-vapour recovery system; vapour-recovery system; vapour-saver system; vehicle vapour recovery	ระบบควบคุมการระเหย	๑๒ มี.ค. ๒๕๔๕
exhaust-gas analyser	เครื่องวิเคราะห์ไอเสีย	๑๒ มี.ค. ๒๕๔๕
exhaust gases	ไอเสีย	๑๒ มี.ค. ๒๕๔๕
exhaust manifold	ท่อร่วมไอเสีย	๑๒ มี.ค. ๒๕๔๕
expansion plug; core hole plug; core plug; freeze plug; welch plug	ปลั๊กตาน้ำ	๑๒ มี.ค. ๒๕๔๕
expansion tank; recovery tank	๑. หม้อน้ำล้น๒. หม้อกันล้น	๑๒ มี.ค. ๒๕๔๕
หลอดไฟควอตซ์-แฮโลเจน	quartz-halogen bulb	๑๒ มี.ค. ๒๕๔๕
สลักเกลียว	bolt	๑๒ มี.ค. ๒๕๔๕
สลักเกลียวรูปตัวยู	U-bolt	๑๒ มี.ค. ๒๕๔๕
สลักเกลียวสองปลาย	stud; stud bolt	๑๒ มี.ค. ๒๕๔๕
สลักเกลียวสองปลายหัวมน; ลูกหมาก	ball stud	๑๒ มี.ค. ๒๕๔๕
สลักเกลียวก้านสูบ	rod bolt	๑๒ มี.ค. ๒๕๔๕
สลักล้อ	king pin; knuckle pin; swivel pin	๑๒ มี.ค. ๒๕๔๕
สลักลูกสูบ	gudgeon pin; piston pin; wrist pin	๑๒ มี.ค. ๒๕๔๕
สลักลูกสูบลอย	floating piston pin; full-floating piston pin	๑๒ มี.ค. ๒๕๔๕
สลัก	pintle	๑๒ มี.ค. ๒๕๔๕
สลักเบรก	anchor pin; brake anchor	๑๒ มี.ค. ๒๕๔๕
สลักตะขอต่อพ่วง	pintle hook	๑๒ มี.ค. ๒๕๔๕
สลักข้อเหวี่ยง	connection-rod journal; crankpin	๑๒ มี.ค. ๒๕๔๕
สลักข้อเหวี่ยงแยกส่วนก้านสูบ	splayed crankpins	๑๒ มี.ค. ๒๕๔๕
สลักข้อเหวี่ยงพร้อมแขน; ระยะเหวี่ยง	crank throw	๑๒ มี.ค. ๒๕๔๕
สลักนำ	dowel; dowel pin	๑๒ มี.ค. ๒๕๔๕
สลักปลายแยก	cotter pin; split pin	๑๒ มี.ค. ๒๕๔๕
หลังศูนย์ตายล่าง (เอบีดีซี)	after bottom dead center (ABDC)	๑๒ มี.ค. ๒๕๔๕
หลังศูนย์ตายบน (เอทีดีซี)	after top dead center (ATDC)	๑๒ มี.ค. ๒๕๔๕
หลังคารับแดด	sunroof	๑๒ มี.ค. ๒๕๔๕
หลังคาแข็ง	hard top	๑๒ มี.ค. ๒๕๔๕
สกรูไล่อากาศ	air-bleed nipple; air-bleed screw	๑๒ มี.ค. ๒๕๔๕
สกรูตัดเกลียวเอง	self-tapping screw	๑๒ มี.ค. ๒๕๔๕
สกรูปรับเดินเบา	slow-running screw; throttle-stop screw	๑๒ มี.ค. ๒๕๔๕
สกรูปรับไอดีเดินเบา	idle-mixture screw; idling-mixture screw; volume-control screw	๑๒ มี.ค. ๒๕๔๕
สกรูปรับไฟหน้า	aiming screw	๑๒ มี.ค. ๒๕๔๕
สตรอโบสโคป	stroboscope	๑๒ มี.ค. ๒๕๔๕
หน้ารถทิ่ม	brake dive	๑๒ มี.ค. ๒๕๔๕
หน้าลิ้น	valve face	๑๒ มี.ค. ๒๕๔๕
หน้าทองขาว	breaker points; contact points; points	๑๒ มี.ค. ๒๕๔๕
สปริง	spring	๑๒ มี.ค. ๒๕๔๕
สปริงเกือกเบรก	pull-off spring	๑๒ มี.ค. ๒๕๔๕
สปริงแบบมาร์เชล	Marcel spring	๑๒ มี.ค. ๒๕๔๕
สปริงลม	air spring	๑๒ มี.ค. ๒๕๔๕
สปริงลดการสั่น	antirattle spring	๑๒ มี.ค. ๒๕๔๕
สปริงไดอะแฟรม	diaphragm spring	๑๒ มี.ค. ๒๕๔๕
สปริงขด	coil spring; helical spring	๑๒ มี.ค. ๒๕๔๕
สปริงคลัตช์	clutch spring; release spring	๑๒ มี.ค. ๒๕๔๕
สปอยเลอร์	spoiler	๑๒ มี.ค. ๒๕๔๕
สุญญากาศเวนจูริ	venturi vacuum	๑๒ มี.ค. ๒๕๔๕
สุญญากาศในท่อร่วมไอดี	manifold vacuum	๑๒ มี.ค. ๒๕๔๕
F-head engine	เครื่องยนต์แบบหัวรูปตัวเอฟ	๑๒ มี.ค. ๒๕๔๕
fade-out	เครื่องดับเพราะเย็น	๑๒ มี.ค. ๒๕๔๕
fast flushing	การล้างอย่างเร็ว	๑๒ มี.ค. ๒๕๔๕
fast idle	เดินเบารอบสูง	๑๒ มี.ค. ๒๕๔๕
fast-idle cam	ลูกเบี้ยวเดินเบารอบสูง	๑๒ มี.ค. ๒๕๔๕
fastback	รถเก๋งท้ายลาด	๑๒ มี.ค. ๒๕๔๕
feedback carburetor	คาร์บูเรเตอร์แบบป้อนกลับ	๑๒ มี.ค. ๒๕๔๕
feeler gauge	เกจแผ่นสอด	๑๒ มี.ค. ๒๕๔๕
felt element	ไส้กรองชนิดสักหลาด	๑๒ มี.ค. ๒๕๔๕
fiberglass	ไฟเบอร์กลาสส์	๑๒ มี.ค. ๒๕๔๕
field coil; field winding	ขดลวดสนามแม่เหล็ก	๑๒ มี.ค. ๒๕๔๕
field relay	รีเลย์ขดลวดสนามแม่เหล็ก	๑๒ มี.ค. ๒๕๔๕
field terminal	ขั้วต่อขดลวดสนามแม่เหล็ก	๑๒ มี.ค. ๒๕๔๕
field winding; field coil	ขดลวดสนามแม่เหล็ก	๑๒ มี.ค. ๒๕๔๕
field-frame assembly	โครงขดลวดสนามแม่เหล็ก	๑๒ มี.ค. ๒๕๔๕
fifth wheel	จานที่ห้า	๑๒ มี.ค. ๒๕๔๕
filler cap	ฝาช่องเติม	๑๒ มี.ค. ๒๕๔๕
fin	ครีบ	๑๒ มี.ค. ๒๕๔๕
filter	๑. ตัวกรอง, หม้อกรอง๒. ไส้กรอง	๑๒ มี.ค. ๒๕๔๕
filter element	ไส้กรอง [มีความหมายเหมือนกับ filter๒]	๑๒ มี.ค. ๒๕๔๕
filter separator	เครื่องกรองและแยก	๑๒ มี.ค. ๒๕๔๕
final drive	ชุดเฟืองท้าย	๑๒ มี.ค. ๒๕๔๕
finger; rocker; rocker arm	กระเดื่องกดลิ้น	๑๒ มี.ค. ๒๕๔๕
finish coat	สีชั้นสุดท้าย	๑๒ มี.ค. ๒๕๔๕
fire point	จุดติดไฟ	๑๒ มี.ค. ๒๕๔๕
firewall	ผนังห้องเครื่อง	๑๒ มี.ค. ๒๕๔๕
firing order	ลำดับการจุดระเบิด	๑๒ มี.ค. ๒๕๔๕
first-motion shaft; clutch shaft	เพลาคลัตช์	๑๒ มี.ค. ๒๕๔๕
fixed-caliper disc brake	เบรกจานชนิดก้ามปูคงที่	๑๒ มี.ค. ๒๕๔๕
fixed-jet carburetor	คาร์บูเรเตอร์แบบนมหนูคงที่	๑๒ มี.ค. ๒๕๔๕
flash point	จุดวาบไฟ	๑๒ มี.ค. ๒๕๔๕
flasher	ตัวทำไฟกะพริบ	๑๒ มี.ค. ๒๕๔๕
flat spot	๑. การเสียรูปของโครงยาง๒. จุดเครื่องยนต์เฉื่อย	๑๒ มี.ค. ๒๕๔๕
flat-head engine	เครื่องยนต์แบบหัวแบน	๑๒ มี.ค. ๒๕๔๕
flat engine; boxer engine; horizontally opposed engine; pancake engine	เครื่องยนต์สูบนอนยันกัน	๑๒ มี.ค. ๒๕๔๕
float	ลูกลอย	๑๒ มี.ค. ๒๕๔๕
float bowl; float chamber	ห้องลูกลอย	๑๒ มี.ค. ๒๕๔๕
float level	ระดับลูกลอย	๑๒ มี.ค. ๒๕๔๕
float needle; needle valve	เข็มลูกลอย	๑๒ มี.ค. ๒๕๔๕
float system	ระบบลูกลอย	๑๒ มี.ค. ๒๕๔๕
floating axle; full-floating axle; fully-floating axle	เพลาลอย	๑๒ มี.ค. ๒๕๔๕
floating caliper	ก้ามปูลอย	๑๒ มี.ค. ๒๕๔๕
floating link	ก้านต่อลอย	๑๒ มี.ค. ๒๕๔๕
floating piston pin; full-floating piston pin	สลักลูกสูบลอย	๑๒ มี.ค. ๒๕๔๕
floating-caliper disc brake	เบรกจานชนิดก้ามปูลอย	๑๒ มี.ค. ๒๕๔๕
fluid coupling	ชุดต่อประกอบแบบของไหล	๑๒ มี.ค. ๒๕๔๕
fluid drive	ชุดขับด้วยของไหล	๑๒ มี.ค. ๒๕๔๕
fluid flywheel	ล้อตุนกำลังแบบของไหล	๑๒ มี.ค. ๒๕๔๕
fluid reservoir	กระปุกน้ำมันไฮดรอลิก	๑๒ มี.ค. ๒๕๔๕
flushing oil	น้ำมันล้างภายในเครื่อง	๑๒ มี.ค. ๒๕๔๕
flutter; bounce	เต้น	๑๒ มี.ค. ๒๕๔๕
flywheel	ล้อตุนกำลัง	๑๒ มี.ค. ๒๕๔๕
flywheel markings	เครื่องหมายที่ล้อตุนกำลัง	๑๒ มี.ค. ๒๕๔๕
flywheel ring gear	เฟืองวงแหวนล้อตุนกำลัง	๑๒ มี.ค. ๒๕๔๕
fog lamp	ไฟตัดหมอก	๑๒ มี.ค. ๒๕๔๕
foot brake	เบรกเท้า	๑๒ มี.ค. ๒๕๔๕
formed-in place gaskes; plastic gasket compound	ปะเก็นเหลว	๑๒ มี.ค. ๒๕๔๕
fossil fuel	เชื้อเพลิงฟอสซิล	๑๒ มี.ค. ๒๕๔๕
four-barrel carburetor	คาร์บูเรเตอร์แบบสี่ท่อ	๑๒ มี.ค. ๒๕๔๕
four-cycle; four-stroke; four-stroke cycle	วัฏจักรสี่จังหวะ	๑๒ มี.ค. ๒๕๔๕
four-cycle; four-stroke; four-stroke cycle	วัฏจักรสี่จังหวะ	๑๒ มี.ค. ๒๕๔๕
four-cycle engine; four-stroke cycle engine; four-stroke engine	เครื่องยนต์สี่จังหวะ	๑๒ มี.ค. ๒๕๔๕
four-cycle engine; four-stroke engine; four-stroke cycle engine	เครื่องยนต์สี่จังหวะ	๑๒ มี.ค. ๒๕๔๕
four-speed gearbox	กระปุกเกียร์สี่ความเร็ว [มีความหมายเหมือนกับ four-speed transmission]	๑๒ มี.ค. ๒๕๔๕
four-speed transmission	ชุดส่งกำลังสี่ความเร็ว	๑๒ มี.ค. ๒๕๔๕
four-valve combustion chamber	ห้องเผาไหม้สี่ลิ้น	๑๒ มี.ค. ๒๕๔๕
four-way wheel nut wrench	ประแจล้อแบบกากบาท	๑๒ มี.ค. ๒๕๔๕
four-wheel drive	การขับสี่ล้อ	๑๒ มี.ค. ๒๕๔๕
four-wheel steering	ระบบบังคับเลี้ยวสี่ล้อ	๑๒ มี.ค. ๒๕๔๕
frame straightener	ชุดดัดโครงรถ	๑๒ มี.ค. ๒๕๔๕
frame	โครงรถ	๑๒ มี.ค. ๒๕๔๕
frame guage	เกจโครงรถ	๑๒ มี.ค. ๒๕๔๕
free pedal; free travel	ระยะว่างคันเหยียบ	๑๒ มี.ค. ๒๕๔๕
free play; lash; play	ระยะว่าง	๑๒ มี.ค. ๒๕๔๕
free travel; free pedal	ระยะว่างคันเหยียบ	๑๒ มี.ค. ๒๕๔๕
free-wheel; one-way clutch; overrun clutch; overrunning clutch	คลัตช์ทางเดียว	๑๒ มี.ค. ๒๕๔๕
free-wheeling; overrunning coupling	การส่งกำลังทางเดียว	๑๒ มี.ค. ๒๕๔๕
freeze plug; core hole plug; core plug; expansion plug; welch plug	ปลั๊กตาน้ำ	๑๒ มี.ค. ๒๕๔๕
friction bearing	รองลื่นแบบเสียดทาน	๑๒ มี.ค. ๒๕๔๕
friction disc; clutch disc; clutch plate; driven disc; driven plate; friction plate	แผ่นคลัตช์	๑๒ มี.ค. ๒๕๔๕
friction horsepower (fhp)	แรงม้าเสียดทาน (เอฟเอชพี)	๑๒ มี.ค. ๒๕๔๕
friction pad; brake pad; pad	แผ่นเบรก	๑๒ มี.ค. ๒๕๔๕
friction plate; clutch disc; clutch plate; driven disc; driven plate; friction disc	แผ่นคลัตช์	๑๒ มี.ค. ๒๕๔๕
front -end geometry	เรขาคณิตล้อหน้า	๑๒ มี.ค. ๒๕๔๕
front axle	เพลาหน้า	๑๒ มี.ค. ๒๕๔๕
friction power	กำลังเสียดทาน	๑๒ มี.ค. ๒๕๔๕
front panel	แผงหน้ารถ	๑๒ มี.ค. ๒๕๔๕
front suspension	ระบบรองรับล้อหน้า	๑๒ มี.ค. ๒๕๔๕
front-end drive; front-wheel drive	ระบบขับเคลื่อนล้อหน้า	๑๒ มี.ค. ๒๕๔๕
front-wheel drive; front-end drive	ระบบขับเคลื่อนล้อหน้า	๑๒ มี.ค. ๒๕๔๕
fuel	เชื้อเพลิง	๑๒ มี.ค. ๒๕๔๕
fuel cell	เซลล์เชื้อเพลิง	๑๒ มี.ค. ๒๕๔๕
fuel nozzle	ปากท่อเชื้อเพลิง	๑๒ มี.ค. ๒๕๔๕
fuel oil	๑. น้ำมันเชื้อเพลิง๒. น้ำมันเตา	๑๒ มี.ค. ๒๕๔๕
fuel pump; fuel feed pump	เครื่องสูบป้อนเชื้อเพลิง, ปั๊มป้อนเชื้อเพลิง	๑๒ มี.ค. ๒๕๔๕
fuel starvation	การขาดเชื้อเพลิง	๑๒ มี.ค. ๒๕๔๕
fuel system	ระบบเชื้อเพลิง	๑๒ มี.ค. ๒๕๔๕
fuel tank	ถังเชื้อเพลิง	๑๒ มี.ค. ๒๕๔๕
fuel-induction system	ระบบจ่ายไอดี	๑๒ มี.ค. ๒๕๔๕
fuel feed pump; fuel pump	เครื่องสูบป้อนเชื้อเพลิง, ปั๊มป้อนเชื้อเพลิง	๑๒ มี.ค. ๒๕๔๕
fuel filter	ตัวกรองเชื้อเพลิง, หม้อกรองเชื้อเพลิง	๑๒ มี.ค. ๒๕๔๕
fuel gauge	เกจเชื้อเพลิง	๑๒ มี.ค. ๒๕๔๕
fuel injector	ตัวฉีดเชื้อเพลิง	๑๒ มี.ค. ๒๕๔๕
fuel knock	น็อกจากเชื้อเพลิง	๑๒ มี.ค. ๒๕๔๕
fuel line	ท่อส่งเชื้อเพลิง	๑๒ มี.ค. ๒๕๔๕
fuel mixture; air-fuel mixture; mixture	ไอดี, สารผสมอากาศกับเชื้อเพลิง	๑๒ มี.ค. ๒๕๔๕
fuel-injection system	ระบบฉีดเชื้อเพลิง	๑๒ มี.ค. ๒๕๔๕
fuel-vapour recovery system; evaporative control system; vapour-recovery system; vapour-saver system; vehicle vapour recovery	ระบบควบคุมการระเหย	๑๒ มี.ค. ๒๕๔๕
fulcrum ring	วงแหวนจุดหมุน	๑๒ มี.ค. ๒๕๔๕
full coil suspension	ระบบรองรับแบบสปริงขด	๑๒ มี.ค. ๒๕๔๕
full lock	การทำวงเลี้ยวแคบสุด	๑๒ มี.ค. ๒๕๔๕
full throttle	ตำแหน่งเร่งเต็มที่	๑๒ มี.ค. ๒๕๔๕
full-floating axle; floating axle; fully-floating axle	เพลาลอย	๑๒ มี.ค. ๒๕๔๕
full-floating piston pin; floating piston pin	สลักลูกสูบลอย	๑๒ มี.ค. ๒๕๔๕
fully-floating axle; floating axle; full-floating axle	เพลาลอย	๑๒ มี.ค. ๒๕๔๕
fuse	ฟิวส์	๑๒ มี.ค. ๒๕๔๕
fuse block	แผงฟิวส์	๑๒ มี.ค. ๒๕๔๕
fuse box	กล่องฟิวส์	๑๒ มี.ค. ๒๕๔๕
fusible link	สายฟิวส์	๑๒ มี.ค. ๒๕๔๕
gage; gauge	เกจ	๑๒ มี.ค. ๒๕๔๕
gaiter	แผ่นยืดกันฝุ่น	๑๒ มี.ค. ๒๕๔๕
gallery	ช่องทางน้ำมันหล่อลื่น	๑๒ มี.ค. ๒๕๔๕
gap	ช่องว่าง	๑๒ มี.ค. ๒๕๔๕
gas engine	เครื่องยนต์แก๊ส	๑๒ มี.ค. ๒๕๔๕
gas turbine engine	เครื่องยนต์กังหันแก๊ส	๑๒ มี.ค. ๒๕๔๕
gasolene engine	เครื่องยนต์แกโซลีน	๑๒ มี.ค. ๒๕๔๕
gasoline; gasolene	แกโซลีน	๑๒ มี.ค. ๒๕๔๕
gassing	การเกิดแก๊ส	๑๒ มี.ค. ๒๕๔๕
gasahol	แกซาฮอล [มีความหมายเหมือนกับ gasohol]	๑๒ มี.ค. ๒๕๔๕
gasket	ปะเก็น	๑๒ มี.ค. ๒๕๔๕
gasket cement; gasket liquid sealer	น้ำยาทาปะเก็น	๑๒ มี.ค. ๒๕๔๕
gasket liquid sealer; gasket cement	น้ำยาทาปะเก็น	๑๒ มี.ค. ๒๕๔๕
gasohol	แกโซฮอล	๑๒ มี.ค. ๒๕๔๕
gasolene; gasoline	แกโซลีน	๑๒ มี.ค. ๒๕๔๕
gauge; gage	เกจ	๑๒ มี.ค. ๒๕๔๕
gauge pressure	ความดันเกจ	๑๒ มี.ค. ๒๕๔๕
gear train	ขบวนเฟือง	๑๒ มี.ค. ๒๕๔๕
gear-type pump; gear pump	เครื่องสูบเฟือง, ปั๊มเฟือง	๑๒ มี.ค. ๒๕๔๕
gearbox	กระปุกเกียร์ [มีความหมายเหมือนกับ transmission ๒]	๑๒ มี.ค. ๒๕๔๕
geared speed	ความเร็วรถทางทฤษฎี	๑๒ มี.ค. ๒๕๔๕
gearshift	ชุดคันเกียร์	๑๒ มี.ค. ๒๕๔๕
GCW (gross combination weight)	จีซีดับเบิลยู (น้ำหนักรวมรวบยอด)	๑๒ มี.ค. ๒๕๔๕
gear	เกียร์, เฟือง	๑๒ มี.ค. ๒๕๔๕
gear lever	คันเกียร์	๑๒ มี.ค. ๒๕๔๕
gear lubricant	น้ำมันเกียร์	๑๒ มี.ค. ๒๕๔๕
gear pump; gear-type pump	เครื่องสูบเฟือง, ปั๊มเฟือง	๑๒ มี.ค. ๒๕๔๕
gear ratio	อัตราทดเกียร์, อัตราทดเฟือง	๑๒ มี.ค. ๒๕๔๕
generator	เครื่องกำเนิดไฟฟ้า	๑๒ มี.ค. ๒๕๔๕
glad hand	ข้อต่อลมเบรก	๑๒ มี.ค. ๒๕๔๕
glaze	ผิวมันลื่น	๑๒ มี.ค. ๒๕๔๕
glaze breaker	เครื่องขจัดผิวมันลื่น	๑๒ มี.ค. ๒๕๔๕
glove compartment	ช่องเก็บของ	๑๒ มี.ค. ๒๕๔๕
glow plug	หัวเผา	๑๒ มี.ค. ๒๕๔๕
gradeability	ความสามารถไต่ความชันได้	๑๒ มี.ค. ๒๕๔๕
Gran Turismo (GT); Grand Touring	รถเก๋งหรูสมรรถนะสูง (จีที)	๑๒ มี.ค. ๒๕๔๕
Grand Touring; Gran Turismo (GT)	รถเก๋งหรูสมรรถนะสูง (จีที)	๑๒ มี.ค. ๒๕๔๕
graphite grease	จาระบีแกรไฟต์	๑๒ มี.ค. ๒๕๔๕
grease	จาระบี	๑๒ มี.ค. ๒๕๔๕
grease gun	ปืนอัดจาระบี	๑๒ มี.ค. ๒๕๔๕
grease nipple	หัวอัดจาระบี	๑๒ มี.ค. ๒๕๔๕
grommet		๑๒ มี.ค. ๒๕๔๕
gross combination weight (GCW)	น้ำหนักรวมรวบยอด (จีซีดับเบิลยู)	๑๒ มี.ค. ๒๕๔๕
gross power	กำลังรวบยอด	๑๒ มี.ค. ๒๕๔๕
gross torque	ทอร์กรวบยอด	๑๒ มี.ค. ๒๕๔๕
gross vehicle weight (GVW)	น้ำหนักยานยนต์รวบยอด (จีวีดับเบิลยู)	๑๒ มี.ค. ๒๕๔๕
ground; ground wire	สายดิน	๑๒ มี.ค. ๒๕๔๕
ground wire; ground	สายดิน	๑๒ มี.ค. ๒๕๔๕
GT (Grand Touring; Gran Turismo)	จีที (รถเก๋งหรูสมรรถนะสูง)	๑๒ มี.ค. ๒๕๔๕
gudgeon pin	สลักลูกสูบ	๑๒ มี.ค. ๒๕๔๕
gulp valve	ลิ้นกันการจุดระเบิดย้อนกลับ	๑๒ มี.ค. ๒๕๔๕
gum	ขี้น้ำมัน, ยางน้ำมัน	๑๒ มี.ค. ๒๕๔๕
GVW (gross vehicle weight)	จีวีดับเบิลยู (น้ำหนักยานยนต์รวบยอด)	๑๒ มี.ค. ๒๕๔๕
half axle; half shaft	เพลาข้าง	๑๒ มี.ค. ๒๕๔๕
half shaft; half axle	เพลาข้าง	๑๒ มี.ค. ๒๕๔๕
half-liners	กาบรองลื่นผ่าครึ่ง	๑๒ มี.ค. ๒๕๔๕
halogen headlamp; halogen headlight	ไฟหน้าแฮโลเจน	๑๒ มี.ค. ๒๕๔๕
hand jack	แม่แรงประจำรถ	๑๒ มี.ค. ๒๕๔๕
handbrake	เบรกมือ	๑๒ มี.ค. ๒๕๔๕
handling	เสถียรภาพการบังคับรถ	๑๒ มี.ค. ๒๕๔๕
hanger bracket; spring hanger	แท่นยึดหูแหนบ	๑๒ มี.ค. ๒๕๔๕
hard pedal	เบรกหนัก	๑๒ มี.ค. ๒๕๔๕
hard top	หลังคาแข็ง	๑๒ มี.ค. ๒๕๔๕
harmonic balancer; harmonic damper	ชุดลดแรงสั่นข้อเหวี่ยง	๑๒ มี.ค. ๒๕๔๕
harmonic damper; harmonic balancer	ชุดลดแรงสั่นข้อเหวี่ยง	๑๒ มี.ค. ๒๕๔๕
hatchback	รถเก๋งมีประตูท้าย	๑๒ มี.ค. ๒๕๔๕
hazard system; emergency signal system	ระบบไฟกะพริบฉุกเฉิน	๑๒ มี.ค. ๒๕๔๕
head; cylinder head	ฝาสูบ	๑๒ มี.ค. ๒๕๔๕
head-land ring	แหวนอัด	๑๒ มี.ค. ๒๕๔๕
head distortion	ฝาสูบโก่ง	๑๒ มี.ค. ๒๕๔๕
header	เฮดเดอร์	๑๒ มี.ค. ๒๕๔๕
header tank	หม้อน้ำท่อนบน	๑๒ มี.ค. ๒๕๔๕
headlamp; headlight	ไฟหน้า	๑๒ มี.ค. ๒๕๔๕
headlight; headlamp	ไฟหน้า	๑๒ มี.ค. ๒๕๔๕
headlining; roof lining	วัสดุบุหลังคา	๑๒ มี.ค. ๒๕๔๕
heat control valve; manifold heat control valve	ลิ้นอุ่นไอดี	๑๒ มี.ค. ๒๕๔๕
heat dam	ร่องกันความร้อน	๑๒ มี.ค. ๒๕๔๕
heat range; spark plug heat range	ช่วงความร้อนหัวเทียน	๑๒ มี.ค. ๒๕๔๕
heat riser	ช่องอุ่นไอดี	๑๒ มี.ค. ๒๕๔๕
HEI (high-energy ignition system)	เอชอีไอ (ระบบจุดระเบิดพลังงานสูง)	๑๒ มี.ค. ๒๕๔๕
heel	โคน	๑๒ มี.ค. ๒๕๔๕
heel contact; short heel contact	สัมผัสโคน	๑๒ มี.ค. ๒๕๔๕
helical gear	เฟืองฮีลิกซ์	๑๒ มี.ค. ๒๕๔๕
helical spring; coil spring	สปริงขด	๑๒ มี.ค. ๒๕๔๕
hemispherical combustion chamber	ห้องเผาไหม้ครึ่งทรงกลม	๑๒ มี.ค. ๒๕๔๕
high beam; main beam; upper beam	ไฟสูง	๑๒ มี.ค. ๒๕๔๕
high compression	การอัดสูง	๑๒ มี.ค. ๒๕๔๕
high-discharge test	การทดสอบโดยจ่ายไฟกระแสสูง	๑๒ มี.ค. ๒๕๔๕
high-energy ignition system (HEI)	ระบบจุดระเบิดพลังงานสูง (เอชอีไอ)	๑๒ มี.ค. ๒๕๔๕
high-speed system	ระบบอัตราเร็วสูง	๑๒ มี.ค. ๒๕๔๕
high-tension cable; high-tension lead; high-voltage cable	สายไฟแรงสูง	๑๒ มี.ค. ๒๕๔๕
high-tension current	กระแสไฟฟ้าแรงสูง	๑๒ มี.ค. ๒๕๔๕
high-tension lead; high-tension cable; high-voltage cable	สายไฟแรงสูง	๑๒ มี.ค. ๒๕๔๕
high-tension pick-up	ถ่านจานจ่าย	๑๒ มี.ค. ๒๕๔๕
high-voltage cable; high-tension cable; high-tension lead	สายไฟแรงสูง	๑๒ มี.ค. ๒๕๔๕
hood; bonnet	ฝากระโปรงห้องเครื่อง	๑๒ มี.ค. ๒๕๔๕
Hooke joint	ข้อต่อฮุก	๑๒ มี.ค. ๒๕๔๕
horn	แตร	๑๒ มี.ค. ๒๕๔๕
horsepower (hp)	แรงม้า (เอชพี)	๑๒ มี.ค. ๒๕๔๕
horizontally oppesed engine; boxer engine; flat engine; pancake engine	เครื่องยนต์สูบนอนยันกัน	๑๒ มี.ค. ๒๕๔๕
hot hard start	เครื่องยนต์ติดยากขณะร้อน	๑๒ มี.ค. ๒๕๔๕
hot patching	การปะยางแบบร้อน	๑๒ มี.ค. ๒๕๔๕
hot plug	หัวเทียนร้อน	๑๒ มี.ค. ๒๕๔๕
hot soak	ฮอตโซ้ก	๑๒ มี.ค. ๒๕๔๕
hot spot	จุดร้อน	๑๒ มี.ค. ๒๕๔๕
hot-idle compensator	ลิ้นเพิ่มอากาศ	๑๒ มี.ค. ๒๕๔๕
Hotchkiss drive	ระบบส่งแรงขับแบบฮอตช์คิสส์	๑๒ มี.ค. ๒๕๔๕
housing	ตัวเรือน, ตัวเสื้อ	๑๒ มี.ค. ๒๕๔๕
hp (horsepower)	เอชพี (แรงม้า)	๑๒ มี.ค. ๒๕๔๕
hub	ดุมล้อ	๑๒ มี.ค. ๒๕๔๕
hub bearing	ตลับลูกปืนดุมล้อ	๑๒ มี.ค. ๒๕๔๕
hub cover	ฝาดุมล้อ	๑๒ มี.ค. ๒๕๔๕
hunting	เครื่องยนต์เดินผิดปรกติ	๑๒ มี.ค. ๒๕๔๕
hydraulic brake system	ระบบเบรกไฮดรอลิก	๑๒ มี.ค. ๒๕๔๕
hydraulic clutch	คลัตช์ไฮดรอลิก	๑๒ มี.ค. ๒๕๔๕
hydraulic coupling	ชุดต่อประกอบไฮดรอลิก	๑๒ มี.ค. ๒๕๔๕
hydraulic damper	ตัวหน่วยไฮดรอลิก	๑๒ มี.ค. ๒๕๔๕
hydraulic fluid	น้ำมันไฮดรอลิก	๑๒ มี.ค. ๒๕๔๕
hydraulic lifter; hydraulic valve lifter	ลูกกระทุ้งลิ้นไฮดรอลิก	๑๒ มี.ค. ๒๕๔๕
hydraulic press	แท่นอัดไฮดรอลิก	๑๒ มี.ค. ๒๕๔๕
hydraulic shift valve	ลิ้นเปลี่ยนเกียร์ไฮดรอกลิก	๑๒ มี.ค. ๒๕๔๕
hydraulic valve	ลิ้นไฮดรอลิก	๑๒ มี.ค. ๒๕๔๕
hydraulic valve lifter; hydraulic lifter	ลูกกระทุ้งลิ้นไฮดรอลิก	๑๒ มี.ค. ๒๕๔๕
hydro-mechanical brake	เบรกกลไฮโดร	๑๒ มี.ค. ๒๕๔๕
hydrocarbon engine	เครื่องยนต์ไฮโดรคาร์บอน	๑๒ มี.ค. ๒๕๔๕
hydrocarbon reactivity	ความไวปฏิกิริยาไฮโดรคาร์บอน	๑๒ มี.ค. ๒๕๔๕
hydrolastic suspension	ระบบรองรับไฮโดรลาสติก	๑๒ มี.ค. ๒๕๔๕
hypoid bevel gear; hypoid gear	เฟืองดอกจอกไฮพอยด์, เฟืองไฮพอยด์	๑๒ มี.ค. ๒๕๔๕
I-head engine	เครื่องยนต์แบบหัวรูปตัวไอ [มีความหมายเหมือนกับ overhead-valve engine; OHV engine และ valve-in-head engine]	๑๒ มี.ค. ๒๕๔๕
IC engine; internal combustion engine	เครื่องยนต์ไอซี, เครื่องยนต์เผาไหม้ภายใน	๑๒ มี.ค. ๒๕๔๕
idle limiter	ตัวกำจัดเดินเบา	๑๒ มี.ค. ๒๕๔๕
idle limiter cap	ฝาตัวจำกัดเดินเบา	๑๒ มี.ค. ๒๕๔๕
idle mixture	ไอดีเดินเบา	๑๒ มี.ค. ๒๕๔๕
idle port	ช่องน้ำมันเดินเบา	๑๒ มี.ค. ๒๕๔๕
idle speed	อัตราเร็วเดินเบา	๑๒ มี.ค. ๒๕๔๕
idle system	ระบบเดินเบา	๑๒ มี.ค. ๒๕๔๕
idle vent	ช่องอากาศเดินเบา	๑๒ มี.ค. ๒๕๔๕
idle; idling; tick-over	เดินเบา	๑๒ มี.ค. ๒๕๔๕
idle jet; pilot jet; slow-running jet	นมหนูเดินเบา	๑๒ มี.ค. ๒๕๔๕
idle-gear; idler gear	เฟืองส่งผ่าน	๑๒ มี.ค. ๒๕๔๕
idle-mixture screw; idling-mixture screw; volume-control screw	สกรูปรับไอดีเดินเบา	๑๒ มี.ค. ๒๕๔๕
idler arm	แขนไอเดลอร์	๑๒ มี.ค. ๒๕๔๕
idler gear; idle-gear	เฟืองส่งผ่าน	๑๒ มี.ค. ๒๕๔๕
idling; idle; tick-over	เดินเบา	๑๒ มี.ค. ๒๕๔๕
idling-mixture screw; idle-mixture screw; volume-control screw	สกรูปรับไอดีเดินเบา	๑๒ มี.ค. ๒๕๔๕
อ่างน้ำมันเครื่อง	oil pan; pan; sump	๑๒ มี.ค. ๒๕๔๕
IFS (independent front suspension)	ไอเอฟเอส (ระบบรองรับล้อหน้าแบบอิสระ)	๑๒ มี.ค. ๒๕๔๕
ignition	๑. การจุดระเบิด๒. การติดไป, การจุดไฟ	๑๒ มี.ค. ๒๕๔๕
ignition advance; spark advance	การเร่งไฟ	๑๒ มี.ค. ๒๕๔๕
ignition advance mechanism; advance mechanism; spark advance mechanism	กลไกเร่งไฟ	๑๒ มี.ค. ๒๕๔๕
ignition coil	คอยล์จุดระเบิด	๑๒ มี.ค. ๒๕๔๕
ignition distributor; distributor; timer	จานจ่าย	๑๒ มี.ค. ๒๕๔๕
ignition lag	ช่วงล่าช้าก่อนการเผาไหม้	๑๒ มี.ค. ๒๕๔๕
ignition module	มอดูลจุดระเบิด	๑๒ มี.ค. ๒๕๔๕
ignition reserve	สำรองการจุดระเบิด	๑๒ มี.ค. ๒๕๔๕
ignition resistor	ตัวต้านทานการจุดระเบิด	๑๒ มี.ค. ๒๕๔๕
ignition retard	การตั้งไฟอ่อน, การปรับไฟอ่อน	๑๒ มี.ค. ๒๕๔๕
ignition switch	สวิตช์ติดเครื่อง	๑๒ มี.ค. ๒๕๔๕
ignition system	ระบบจุดระเบิด	๑๒ มี.ค. ๒๕๔๕
ignition timing	การตั้งไฟจุดระเบิด	๑๒ มี.ค. ๒๕๔๕
ignition vacuum pipe	ท่อสุญญากาศปรับการจุดระเบิด	๑๒ มี.ค. ๒๕๔๕
ignition warning light	ไฟเตือนการจุดระเบิด	๑๒ มี.ค. ๒๕๔๕
ihp (indicated horsepower)	ไอเอชพี (แรงม้าบ่งชี้)	๑๒ มี.ค. ๒๕๔๕
ออกเทนที่ต้องการ	octane requirement	๑๒ มี.ค. ๒๕๔๕
ฮอตโซ้ก	hot soak	๑๒ มี.ค. ๒๕๔๕
impeller	ใบพัด	๑๒ มี.ค. ๒๕๔๕
in-block; en-bloc; monobloc; mono-block	เสื้อสูบแบบหล่อชิ้นเดียว	๑๒ มี.ค. ๒๕๔๕
in-line engine	เครื่องยนต์สูบเรียง	๑๒ มี.ค. ๒๕๔๕
included angle	มุมรวม	๑๒ มี.ค. ๒๕๔๕
independent front suspension (IFS)	ระบบรองรับล้อหน้าแบบอิสระ (ไอเอฟเอส)	๑๒ มี.ค. ๒๕๔๕
independent rear suspension (IRS)	ระบบรองรับล้อหลังแบบอิสระ (ไออาร์เอส)	๑๒ มี.ค. ๒๕๔๕
independent suspension	ระบบรองรับแบบอิสระ	๑๒ มี.ค. ๒๕๔๕
indicated horsepower (ihp)	แรงม้าบ่งชี้ (ไอเอชพี)	๑๒ มี.ค. ๒๕๔๕
indicated power (ip)	กำลังบ่งชี้ (ไอพี)	๑๒ มี.ค. ๒๕๔๕
indicator light	ไฟชี้บอก	๑๒ มี.ค. ๒๕๔๕
induction	๑. จังหวะดูด๒. การเหนี่ยวนำ	๑๒ มี.ค. ๒๕๔๕
induction coil	ขดลวดเหนี่ยวนำ	๑๒ มี.ค. ๒๕๔๕
induction manifold; inlet manifold; intake manifold	ท่อร่วมไอดี	๑๒ มี.ค. ๒๕๔๕
inductive ignition system	ระบบจุดระเบิดแบบเหนี่ยวนำ	๑๒ มี.ค. ๒๕๔๕
injector	ตัวฉีด	๑๒ มี.ค. ๒๕๔๕
injector nozzle	หัวฉีด	๑๒ มี.ค. ๒๕๔๕
inlet manifold; induction manifold; intake manifold	ท่อร่วมไอดี	๑๒ มี.ค. ๒๕๔๕
inlet over exhaust	เครื่องยนต์ลิ้นไอดีเหนือลิ้นไอเสีย	๑๒ มี.ค. ๒๕๔๕
inlet stroke; intake stroke; suction stroke	จังหวะดูด	๑๒ มี.ค. ๒๕๔๕
inlet valve; intake valve	ลิ้นไอดี	๑๒ มี.ค. ๒๕๔๕
inner tube; tire tube tyre tube	ยางใน	๑๒ มี.ค. ๒๕๔๕
input shaft	เพลารับกำลังเข้า	๑๒ มี.ค. ๒๕๔๕
instrument panel; dashboard	แผงหน้าปัด	๑๒ มี.ค. ๒๕๔๕
insulated-return system; two-wire system	ระบบไฟสองสาย	๑๒ มี.ค. ๒๕๔๕
intake manifold; induction manifold; inlet manifold	ท่อร่วมไอดี	๑๒ มี.ค. ๒๕๔๕
intake stroke; inlet stroke; suction stroke	จังหวะดูด	๑๒ มี.ค. ๒๕๔๕
intake valve; inlet valve	ลิ้นไอดี	๑๒ มี.ค. ๒๕๔๕
integral construction; monocoque; unitary construction; unitized body; unitized construction	ตัวถังแบบไร้โครง	๑๒ มี.ค. ๒๕๔๕
interaxle differential	ชุดเฟืองระหว่างเพลาขับ	๑๒ มี.ค. ๒๕๔๕
internal combustion engine; IC engine	เครื่องยนต์ไอซี, เครื่องยนต์เผาไหม้ภายใน	๑๒ มี.ค. ๒๕๔๕
internal combustion engine; IC engine	เครื่องยนต์เผาไหม้ภายในเครื่องยนต์ไอซี	๑๒ มี.ค. ๒๕๔๕
อัตราเร็วเดินเบา	idle speed	๑๒ มี.ค. ๒๕๔๕
อัตราส่วนเอ/เอฟ, อัตราส่วนอากาศต่อเชื้อเพลิง	air-fuel ratio; A/F ratio	๑๒ มี.ค. ๒๕๔๕
อัตราส่วนการอัด	compression ratio	๑๒ มี.ค. ๒๕๔๕
อัตราส่วนอากาศต่อเชื้อเพลิง, อัตราส่วนเอ/เอฟ	air-fuel ratio; A/F ratio	๑๒ มี.ค. ๒๕๔๕
อัตราส่วนลักษณะยาง	aspect ratio	๑๒ มี.ค. ๒๕๔๕
อัตราส่วนปริมาณสัมพันธ์	stoichiometric ratio	๑๒ มี.ค. ๒๕๔๕
อัตราการประจุ	charging rate	๑๒ มี.ค. ๒๕๔๕
อัตราทดเกียร์	gear ratio	๑๒ มี.ค. ๒๕๔๕
อัตราทดเกียร์, อัตราทดเฟือง	gear ratio	๑๒ มี.ค. ๒๕๔๕
อัตราทดเพลา	axle ratio	๑๒ มี.ค. ๒๕๔๕
อัตราทดเฟือง	gear ratio	๑๒ มี.ค. ๒๕๔๕
อัตราทดเฟือง, อัตราทดเกียร์	gear ratio	๑๒ มี.ค. ๒๕๔๕
อัตราทดพวงมาลัย	steering ratio	๑๒ มี.ค. ๒๕๔๕
อาร์โอเอ็น (เลขออกเทนวิจัย)	RON (research octane number)	๑๒ มี.ค. ๒๕๔๕
อาร์แอนด์อาร์ (ถอดประกอบ)	R and R (remove and reinstall)	๑๒ มี.ค. ๒๕๔๕
อาร์มาเจอร์	armuture	๑๒ มี.ค. ๒๕๔๕
อีเอสซี (การควบคุมการจุดระเบิดแบบอิเล็กทรอนิกส์)	ESC (electronic spark control)	๑๒ มี.ค. ๒๕๔๕
อิเล้กโทรไลต์	electrolyte	๑๒ มี.ค. ๒๕๔๕
อากาศอุด	air lock	๑๒ มี.ค. ๒๕๔๕
อากาศทุติยภูมิ	secondary air	๑๒ มี.ค. ๒๕๔๕
อากาศพลศาสตร์	aerodynamics	๑๒ มี.ค. ๒๕๔๕
อีซีเอ็ม (มอดูลควบคุมแบบอิเล็กทรอนิกส์)	ECM (electronic control module)	๑๒ มี.ค. ๒๕๔๕
อีซียู (ชุดควบคุมแบบอิเล็กทรอนิกส์)	ECU (electronic control unit)	๑๒ มี.ค. ๒๕๔๕
ip (indicated power)	ไอพี (กำลังบ่งชี้)	๑๒ มี.ค. ๒๕๔๕
IRS (independent rear suspension)	ไออาร์เอส (ระบบรองรับล้อหลังแบบอิสระ)	๑๒ มี.ค. ๒๕๔๕
องศาลิ้นซ้อนเหลื่อม	valve overlap	๑๒ มี.ค. ๒๕๔๕
อุปกรณ์แยกน้ำมันเครื่อง	oil seperator	๑๒ มี.ค. ๒๕๔๕
อุปกรณ์เผาไหม้เสริม	afterburner	๑๒ มี.ค. ๒๕๔๕
อุปกรณ์ลดหมอกควัน	antismog device	๑๒ มี.ค. ๒๕๔๕
อุปกรณ์คงความเร็วรถ	cruise control	๑๒ มี.ค. ๒๕๔๕
อุปกรณ์นำแนว	jig	๑๒ มี.ค. ๒๕๔๕
อุปกรณ์ปรับไฟหน้าอัตโนมัติ	autronic eye	๑๒ มี.ค. ๒๕๔๕
อุปกรณ์ทำให้น้ำมันเครื่องเย็น	oil cooler	๑๒ มี.ค. ๒๕๔๕
jack	แม่แรง	๑๒ มี.ค. ๒๕๔๕
jack stand; car stand; safety stand	ขาตั้งรับรถ	๑๒ มี.ค. ๒๕๔๕
jacking effect	ผลการยก	๑๒ มี.ค. ๒๕๔๕
jacking point	จุดขึ้นแม่แรง	๑๒ มี.ค. ๒๕๔๕
jet	นมหนู	๑๒ มี.ค. ๒๕๔๕
jig	อุปกรณ์นำแนว	๑๒ มี.ค. ๒๕๔๕
jockey wheel	ล้อปรับสายพาน	๑๒ มี.ค. ๒๕๔๕
journal	ข้อสัมผัส, เจอร์นัล	๑๒ มี.ค. ๒๕๔๕
jubilee clip	ตัวรัดจูบิลี	๑๒ มี.ค. ๒๕๔๕
judder	การสั่นกระตุก	๑๒ มี.ค. ๒๕๔๕
jump lead; jumper cable	สายไฟพ่วง	๑๒ มี.ค. ๒๕๔๕
jump spark; spark	ประกายไฟ	๑๒ มี.ค. ๒๕๔๕
jump-starting	ติดเครื่องด้วยการพ่นไฟ	๑๒ มี.ค. ๒๕๔๕
jumper cable; jump lead	สายไฟพ่วง	๑๒ มี.ค. ๒๕๔๕
Kamm back; Kamm tail	ท้ายรถแบบคัมม์	๑๒ มี.ค. ๒๕๔๕
Kettering ignition system	ระบบจุดระเบิดแบบเคตเทอริง	๑๒ มี.ค. ๒๕๔๕
key	ลิ่ม	๑๒ มี.ค. ๒๕๔๕
key bed; keyseat; keyway	ร่องลิ่ม	๑๒ มี.ค. ๒๕๔๕
kick-down	คิกดาวน์	๑๒ มี.ค. ๒๕๔๕
king pin; knuckle pin; swivel pin	สลักล้อ	๑๒ มี.ค. ๒๕๔๕
king pin angle	มุมเอียงสลักล้อ	๑๒ มี.ค. ๒๕๔๕
king pin inclination	ความเอียงสลักล้อ	๑๒ มี.ค. ๒๕๔๕
knife cuts; sipes	ร่องดอกละเอียด	๑๒ มี.ค. ๒๕๔๕
knock	น็อก	๑๒ มี.ค. ๒๕๔๕
knock-on wheel	ล้อน็อตเดียว	๑๒ มี.ค. ๒๕๔๕
knuckle; steering knuckle	หัวต่อแกนล้อ	๑๒ มี.ค. ๒๕๔๕
knuckle pin; king pin; swivel pin	สลักล้อ	๑๒ มี.ค. ๒๕๔๕
knurl	๑. พิมพ์ลาย๒. ลายพิมพ์	๑๒ มี.ค. ๒๕๔๕
L-head engine	เครื่องยนต์แบบหัวรูปตัวแอล [มีความหมายเหมือนกับ flat-head engine และ side-valve engine]	๑๒ มี.ค. ๒๕๔๕
Lambda sensor	ตัวรับรู้แลมบ์ดา	๑๒ มี.ค. ๒๕๔๕
laminated glass; laminated safety glass	กระจก(นิรภัย)แบบอัดซ้อน	๑๒ มี.ค. ๒๕๔๕
laminated spring	แหนบอัดซ้อน	๑๒ มี.ค. ๒๕๔๕
landing gear; landing leg	เท้าคำยัน	๑๒ มี.ค. ๒๕๔๕
lap belt; lap strap	เข็มขัดนิรภัยรัดหน้าตัก	๑๒ มี.ค. ๒๕๔๕
lap strap; lap belt	เข็มขัดนิรภัยรัดหน้าตัก	๑๒ มี.ค. ๒๕๔๕
lapping	การบดผิว, การบดวาล์ว	๑๒ มี.ค. ๒๕๔๕
lash; free play; play	ระยะว่าง	๑๒ มี.ค. ๒๕๔๕
lateral runout	ระยะส่าย	๑๒ มี.ค. ๒๕๔๕
leaded gasolene	แกโซลีนมีสารตะกั่ว	๑๒ มี.ค. ๒๕๔๕
leading shoe	เกือกเบรกนำ, ฝักเบรกนำ	๑๒ มี.ค. ๒๕๔๕
leads	ชุดสายไฟแรงสูง	๑๒ มี.ค. ๒๕๔๕
leaf spring	แหนบแผ่น	๑๒ มี.ค. ๒๕๔๕
lean mixture	ไอดีบาง	๑๒ มี.ค. ๒๕๔๕
lean-burn engine; lean-burning engine	เครื่องยนต์แบบเผาไหม้ไอดีบาง	๑๒ มี.ค. ๒๕๔๕
level plug	ปลั๊กตรวจระดับน้ำมันเกียร์	๑๒ มี.ค. ๒๕๔๕
liftback	รถเก๋งท้ายยก	๑๒ มี.ค. ๒๕๔๕
lifter; tappet; valve lifter; valve tappet	ลูกกระทุ้งลิ้น	๑๒ มี.ค. ๒๕๔๕
limited-slip differential; nonslip differential	เฟืองเหลื่อมความเร็วแบบจำกัดการลื่น	๑๒ มี.ค. ๒๕๔๕
limiting valve; pressure-limiting valve	ลิ้นจำกัดความดัน	๑๒ มี.ค. ๒๕๔๕
limousine	รถลีมูซีน	๑๒ มี.ค. ๒๕๔๕
liner	๑. ปลอกสูบ ๒. กาบรองลื่น	๑๒ มี.ค. ๒๕๔๕
lining; brake lining	ผ้าเบรก	๑๒ มี.ค. ๒๕๔๕
linkage power steering	ระบบพวงมาลัยเสริมกำลังแบบก้านต่อ	๑๒ มี.ค. ๒๕๔๕
liquefied petroleum gas (LPG; LP-GAS)	แก๊สปิโตรเลียมเหลว (แอลพีจี, แอลพีแก๊ส)	๑๒ มี.ค. ๒๕๔๕
liquid-cooled engine	เครื่องยนต์ระบายความร้อนด้วยของเหลว	๑๒ มี.ค. ๒๕๔๕
little-end; rod small end; small-end	ปลายเล็กก้านสูบ	๑๒ มี.ค. ๒๕๔๕
live axle	เพลาเป็น	๑๒ มี.ค. ๒๕๔๕
loading; rich running	ไอดีหนาเกิน	๑๒ มี.ค. ๒๕๔๕
lobe	ลอน	๑๒ มี.ค. ๒๕๔๕
locknut; lock nut	แป้นเกลียวล็อก	๑๒ มี.ค. ๒๕๔๕
lockup torque converter	ทอร์กคอนเวอร์เตอร์แบบล็อกได้	๑๒ มี.ค. ๒๕๔๕
lockwasher; locking washer	แหวนล็อก	๑๒ มี.ค. ๒๕๔๕
lock	ล็อก	๑๒ มี.ค. ๒๕๔๕
lock nut; locknut	แป้นเกลียวล็อก	๑๒ มี.ค. ๒๕๔๕
locking; locking of wheels	ล้อตาย	๑๒ มี.ค. ๒๕๔๕
locking washer; lockwasher	แหวนล็อก	๑๒ มี.ค. ๒๕๔๕
loping idle; rolling idle	เดินเบาไม่สม่ำเสมอ	๑๒ มี.ค. ๒๕๔๕
low beam; dipped headlight; lower beam	ไฟต่ำ	๑๒ มี.ค. ๒๕๔๕
low profile tire; low profile tyre	ยางหน้ากว้าง	๑๒ มี.ค. ๒๕๔๕
low-lead fuel	น้ำมันเชื้อเพลิงตะกั่วต่ำ	๑๒ มี.ค. ๒๕๔๕
low-tension current	กระแสไฟฟ้าแรงต่ำ	๑๒ มี.ค. ๒๕๔๕
LPG; LP-GAS (liquefied petroleum gas)	แอลพีจี, แอลพีแก๊ส (แก๊สปิโตรเลียมเหลว)	๑๒ มี.ค. ๒๕๔๕
lube; lubricant	สารหล่อลื่น	๑๒ มี.ค. ๒๕๔๕
lube oil; lubricating oil	น้ำมันหล่อลื่น, น้ำมันเครื่อง	๑๒ มี.ค. ๒๕๔๕
lubricant; lube	สารหล่อลื่น	๑๒ มี.ค. ๒๕๔๕
lubricating oil; lube oil	น้ำมันหล่อลื่น, น้ำมันเครื่อง	๑๒ มี.ค. ๒๕๔๕
lubrication	การหล่อลื่น	๑๒ มี.ค. ๒๕๔๕
lubrication system	ระบบหล่อลื่น	๑๒ มี.ค. ๒๕๔๕
LP-GAS (liquefied petroleum gas); LPG	แอลพีจี, แอลพีแก๊ส (แก๊สปิโตรเลียมเหลว)	๑๒ มี.ค. ๒๕๔๕
lugging	การสะท้านของเครื่อง	๑๒ มี.ค. ๒๕๔๕
MacPherson strut; MacPherson suspension	ระบบรองรับแบบแม็กเฟอร์สัน	๑๒ มี.ค. ๒๕๔๕
mag wheel	ล้อแม็ก	๑๒ มี.ค. ๒๕๔๕
magnetic clutch	คลัตช์แม่เหล็ก	๑๒ มี.ค. ๒๕๔๕
main beam; high beam; upper beam	ไฟสูง	๑๒ มี.ค. ๒๕๔๕
main bearing	รองลื่นหลัก	๑๒ มี.ค. ๒๕๔๕
main jet	นมหนูหลัก	๑๒ มี.ค. ๒๕๔๕
main journal	ข้อสัมผัสหลัก, เจอร์นัลหลัก	๑๒ มี.ค. ๒๕๔๕
main-metering system	ระบบหลักควบคุมน้ำมัน	๑๒ มี.ค. ๒๕๔๕
mainfold	ท่อร่วม	๑๒ มี.ค. ๒๕๔๕
maintenance-free battery	แบตเตอรี่ปลอดการบำรุงรักษา	๑๒ มี.ค. ๒๕๔๕
manifold heat control valve; heat control valve	ลิ้นอุ่นไอดี	๑๒ มี.ค. ๒๕๔๕
manifold pressure; boost pressure	ความดันเสริมในท่อร่วมไอดี	๑๒ มี.ค. ๒๕๔๕
manifold vacuum	สุญญากาศในท่อร่วมไอดี	๑๒ มี.ค. ๒๕๔๕
Marcel spring	สปริงแบบมาร์เชล	๑๒ มี.ค. ๒๕๔๕
manual gearbox	กระปุกเกียร์ธรรมดา	๑๒ มี.ค. ๒๕๔๕
manual low	ตำแหน่งเลือกเกียร์ต่ำ	๑๒ มี.ค. ๒๕๔๕
masking paper	กระดาษปิดกันสี	๑๒ มี.ค. ๒๕๔๕
masking tape	แถบกาวปิดกันสี	๑๒ มี.ค. ๒๕๔๕
master cylinder	แม่ปั๊ม	๑๒ มี.ค. ๒๕๔๕
mechanical efficiency	ประสิทธิภาพเชิงกล	๑๒ มี.ค. ๒๕๔๕
member	ชิ้นส่วนหลัก	๑๒ มี.ค. ๒๕๔๕
meshing	การขบของฟันเฟือง	๑๒ มี.ค. ๒๕๔๕
meshing gears	เฟืองขบกัน	๑๒ มี.ค. ๒๕๔๕
metallics	สีเมแทลลิกส์, สีเกล็ดโลหะ	๑๒ มี.ค. ๒๕๔๕
metering	การปรับให้เหมาะ, การควบคุมให้เหมาะ	๑๒ มี.ค. ๒๕๔๕
metering rod	ก้านควบคุมปริมาณเชื้อเพลิง	๑๒ มี.ค. ๒๕๔๕
metering unit	ชุดควบคุมปริมาณเชื้อเพลิง	๑๒ มี.ค. ๒๕๔๕
metering valve	ลิ้นควบคุม	๑๒ มี.ค. ๒๕๔๕
mileometer- odometer	มาตรระยะทาง	๑๒ มี.ค. ๒๕๔๕
misfire	การจุดระเบิดไม่ครบสูบ	๑๒ มี.ค. ๒๕๔๕
mixture; air-fuel mixture; fuel mixture	ไอดี, สารผสมอากาศกับเชื้อเพลิง	๑๒ มี.ค. ๒๕๔๕
model year	รุ่นปี	๑๒ มี.ค. ๒๕๔๕
modified engine	เครื่องยนต์แต่ง	๑๒ มี.ค. ๒๕๔๕
modulator	ตัวคุม	๑๒ มี.ค. ๒๕๔๕
molybdenum disulphide	(สารหล่อลื่น)โมลิบดีนัมไดซัลไฟด์	๑๒ มี.ค. ๒๕๔๕
monobloc; en-bloc; in-block; mono-block	เสื้อสูบแบบหล่อชิ้นเดียว	๑๒ มี.ค. ๒๕๔๕
MON (motor octane number)	เอ็มโอเอ็น (เลขออกเทนเครื่องยนต์)	๑๒ มี.ค. ๒๕๔๕
monocoque; integral construction; unitary construction; unitized body; unitized construction	ตัวถังแบบไร้โครง	๑๒ มี.ค. ๒๕๔๕
motor	มอเตอร์, -ยนต์	๑๒ มี.ค. ๒๕๔๕
motor octane number (MON)	เลขออกเทนเครื่องยนต์ (เอ็มโอเอ็น)	๑๒ มี.ค. ๒๕๔๕
motor vehicle	ยานยนต์	๑๒ มี.ค. ๒๕๔๕
mud flap	ยางกันโคลน	๑๒ มี.ค. ๒๕๔๕
muffler	หม้อพัก	๑๒ มี.ค. ๒๕๔๕
multigrade oil; multiple-viscosity oil	น้ำมันเครื่องเกรดรวม	๑๒ มี.ค. ๒๕๔๕
multiple-disc clutch; multiple-plate clutch	คลัตช์แบบหลายแผ่น	๑๒ มี.ค. ๒๕๔๕
multiple-point injection; port injection	การฉีดแยกช่องไอดี	๑๒ มี.ค. ๒๕๔๕
multiple-viscosity oil; multigrade oil	น้ำมันเครื่องเกรดรวม	๑๒ มี.ค. ๒๕๔๕
mushroomed valve stem	ก้านลิ้นเยิน	๑๒ มี.ค. ๒๕๔๕
nave plate	ฝาครอบดุมล้อ	๑๒ มี.ค. ๒๕๔๕
needle bearing	ตลับลูกปืนเข็ม	๑๒ มี.ค. ๒๕๔๕
needle valve; float needle	เข็มลูกลอย	๑๒ มี.ค. ๒๕๔๕
neck	ส่วนคอด	๑๒ มี.ค. ๒๕๔๕
negative earth; negative ground	ขั้วลบลงดิน	๑๒ มี.ค. ๒๕๔๕
negative pole; negative terminal	ขั้วลบ	๑๒ มี.ค. ๒๕๔๕
neoprene	นีโอพรีน	๑๒ มี.ค. ๒๕๔๕
net horsepower	แรงม้าสุทธิ	๑๒ มี.ค. ๒๕๔๕
net torque	ทอร์กสุทธิ	๑๒ มี.ค. ๒๕๔๕
net power	กำลังสุทธิ	๑๒ มี.ค. ๒๕๔๕
neutral	ว่าง	๑๒ มี.ค. ๒๕๔๕
neutral safety switch; neutral-start switch	สวิตช์นิรภัยเกียร์ว่าง[มีความหมายเหมือนกับ clutch safety switch]	๑๒ มี.ค. ๒๕๔๕
nipple; grease nipple	หัวอัดจารบี	๑๒ มี.ค. ๒๕๔๕
no-load test	การทดสอบโดยไม่มีภาระ	๑๒ มี.ค. ๒๕๔๕
Nox control system	ระบบควบคุมไนโตรเจนออกไซด์	๑๒ มี.ค. ๒๕๔๕
non-return valve; check valve	ลิ้นกันกลับ	๑๒ มี.ค. ๒๕๔๕
nonslip differential; limited-slip differential	เฟืองเหลื่อมความเร็วแบบจำกัดการลื่น	๑๒ มี.ค. ๒๕๔๕
nonleaded gasolene	แกโซลีนไร้สารตะกั่ว	๑๒ มี.ค. ๒๕๔๕
normally aspirated engine	เครื่องยนต์ธรรมดา	๑๒ มี.ค. ๒๕๔๕
notchback	รถเก๋งท้ายหยัก	๑๒ มี.ค. ๒๕๔๕
nozzle	๑. ปากท่อ๒. หัวฉีด	๑๒ มี.ค. ๒๕๔๕
number plate	ป้ายทะเบียนรถ	๑๒ มี.ค. ๒๕๔๕
number-plate light	ไฟส่องป้าย	๑๒ มี.ค. ๒๕๔๕
nut	แป้นเกลียว, น็อต	๑๒ มี.ค. ๒๕๔๕
octane number (ON)	เลขออกเทน (โอเอ็น)	๑๒ มี.ค. ๒๕๔๕
octane rating	ค่าประเมินออกเทน	๑๒ มี.ค. ๒๕๔๕
octane requirement	ออกเทนที่ต้องการ	๑๒ มี.ค. ๒๕๔๕
odometer; mileometer	มาตรระยะทาง	๑๒ มี.ค. ๒๕๔๕
OHC engine; overhead-camshaft engine	เครื่องยนต์โอเอชวี, เครื่องยนต์แบบเพลาลูกเบี้ยวเหนือสูบ	๑๒ มี.ค. ๒๕๔๕
OHV engine; overhead-valve engine	เครื่องยนต์โอเอชวี, เครื่องยนต์แบบลิ้นเหนือสูบ	๑๒ มี.ค. ๒๕๔๕
oil	น้ำมัน	๑๒ มี.ค. ๒๕๔๕
oil clearance	ระยะห่างน้ำมันหล่อลื่น	๑๒ มี.ค. ๒๕๔๕
oil cooler	อุปกรณ์ทำให้น้ำมันเครื่องเย็น	๑๒ มี.ค. ๒๕๔๕
oil dilution	การเจือจางน้ำมันเครื่อง	๑๒ มี.ค. ๒๕๔๕
oil filler cap	ฝาช่องเติมน้ำมันเครื่อง	๑๒ มี.ค. ๒๕๔๕
oil filter	หม้อกรองน้ำมันเครื่อง	๑๒ มี.ค. ๒๕๔๕
oil gallery; gallery	ช่องทางน้ำมันหล่อลื่น	๑๒ มี.ค. ๒๕๔๕
oil pan; pan; sump	อ่างน้ำมันเครื่อง	๑๒ มี.ค. ๒๕๔๕
oil pump	เครื่องสูบน้ำมันเครื่อง, ปั๊มน้ำมันเครื่อง	๑๒ มี.ค. ๒๕๔๕
oil pumping	น้ำมันเครื่องรั่วผ่านแหวน	๑๒ มี.ค. ๒๕๔๕
oil ring; oil-control ring; oil scraper ring; scraper ring 	แหวนกวาดน้ำมันเครื่อง	๑๒ มี.ค. ๒๕๔๕
oil seal	กันรั่วน้ำมันหล่อลื่น	๑๒ มี.ค. ๒๕๔๕
oil seperator	อุปกรณ์แยกน้ำมันเครื่อง	๑๒ มี.ค. ๒๕๔๕
oil strainer	ตะแกรงกรองน้ำมันเครื่อง	๑๒ มี.ค. ๒๕๔๕
oil-bath cleaner; oil-bath filter	หม้อกรองอากาศแบบอ่างน้ำมันเครื่อง	๑๒ มี.ค. ๒๕๔๕
oil-control ring; oil ring; oil scraper ring; scraper ring	แหวนกวาดน้ำมันเครื่อง	๑๒ มี.ค. ๒๕๔๕
oil-filter wrench	ประแจตัวกรองน้ำมันเครื่อง	๑๒ มี.ค. ๒๕๔๕
oil-level indicator; dipstick	ก้านวัดน้ำมันเครื่อง	๑๒ มี.ค. ๒๕๔๕
oil-pressure gauge	เกจความดันน้ำมันเครื่อง	๑๒ มี.ค. ๒๕๔๕
oil-pressure indicator	เครื่องชี้บอกความดันน้ำมันเครื่อง	๑๒ มี.ค. ๒๕๔๕
oil-pressure warning light	ไฟเตือนความดันน้ำมันเครื่อง	๑๒ มี.ค. ๒๕๔๕
oil-seal-and-shield	ชุดกันรั่วน้ำมันหล่อลื่น	๑๒ มี.ค. ๒๕๔๕
one-way clutch; free-wheel; free-wheel one-way clutch; overrun clutch; overrunning clutch	คลัตช์ทางเดียว	๑๒ มี.ค. ๒๕๔๕
one-wire system	ระบบไฟสายเดี่ยว	๑๒ มี.ค. ๒๕๔๕
open circuit	วงจรเปิด	๑๒ มี.ค. ๒๕๔๕
orange peel	ลักษณะผิวส้ม	๑๒ มี.ค. ๒๕๔๕
orifice	รูเล็ก	๑๒ มี.ค. ๒๕๔๕
overflow tank	หม้อน้ำล้น	๑๒ มี.ค. ๒๕๔๕
overhead-camshaft engine; OHC engine	เครื่องยนต์แบบเพลาลูกเบี้ยวเหนือสูบ, เครื่องยนต์โอเอชซี	๑๒ มี.ค. ๒๕๔๕
overhead-valve engine; OHV engine	เครื่องยนต์แบบลิ้นเหนือสูบ, เครื่องยนต์โอเอชวี	๑๒ มี.ค. ๒๕๔๕
overrun clutch; free-wheel; one-way clutch; 	คลัตช์ทางเดียว	๑๒ มี.ค. ๒๕๔๕
overrunning coupling; free-wheeling	การส่งกำลังทางเดียว	๑๒ มี.ค. ๒๕๔๕
oversquare engine	เครื่องยนต์ช่วงชักสั้น	๑๒ มี.ค. ๒๕๔๕
oversteer	ไวโค้ง	๑๒ มี.ค. ๒๕๔๕
oxidation catalytic converter	เครื่องฟอกไอเสียเชิงเร่งปฏิกิริยาออกซิเดชัน, แคทาลิติกคอนเวอร์เตอร์แบบออกซิเดชัน	๑๒ มี.ค. ๒๕๔๕
pad; brake pad; friction pad	แผ่นเบรก	๑๒ มี.ค. ๒๕๔๕
paint film	ความหนาของสี	๑๒ มี.ค. ๒๕๔๕
paint remover	น้ำยาลอกสี	๑๒ มี.ค. ๒๕๔๕
pan; oil pan; sump	อ่างน้ำมันเครื่อง	๑๒ มี.ค. ๒๕๔๕
pancake engine; boxer engine; flat engine; horizontally opposed engine	เครื่องยนต์สูบนอนยันกัน	๑๒ มี.ค. ๒๕๔๕
paper element	ไส้กรองชนิดกระดาษ	๑๒ มี.ค. ๒๕๔๕
parade pattern	แบบคลื่นเรียงแนวนอน	๑๒ มี.ค. ๒๕๔๕
parallel circuit	วงจรขนาน	๑๒ มี.ค. ๒๕๔๕
parallelogram linkage	กลไกก้านต่อแบบขนาน	๑๒ มี.ค. ๒๕๔๕
parking brake	เบรกจอด	๑๒ มี.ค. ๒๕๔๕
parking light; side-light	ไฟจอด	๑๒ มี.ค. ๒๕๔๕
passenger car	รถยนต์นั่ง	๑๒ มี.ค. ๒๕๔๕
passive safety	ความปลอดภัยด้วยตัวเอง, ความปลอดภัย แบบกสานติ์	๑๒ มี.ค. ๒๕๔๕
pay load	น้ำหนักบรรทุก	๑๒ มี.ค. ๒๕๔๕
PCV (positive crankcase ventilation)	พีซีวี (การระบายไอห้องข้อเหวี่ยงแบบปิด)	๑๒ มี.ค. ๒๕๔๕
PCV valve	ลิ้นพีซีวี	๑๒ มี.ค. ๒๕๔๕
pedal bleeding	การไล่ลมเบรกด้วยคันเหยียบ	๑๒ มี.ค. ๒๕๔๕
pedal reserve	ระยะสำรองคันเหยียบ	๑๒ มี.ค. ๒๕๔๕
percent of grade	ร้อยละความชัน	๑๒ มี.ค. ๒๕๔๕
percolation	การไหลซึม	๑๒ มี.ค. ๒๕๔๕
petrol	เบนซิน	๑๒ มี.ค. ๒๕๔๕
petrol engine	เครื่องยนต์เบนซิน	๑๒ มี.ค. ๒๕๔๕
petrol injection	การฉีดเบนซิน	๑๒ มี.ค. ๒๕๔๕
petrol pump	เครื่องสูบเบนซิน, ปั๊มเบนซิน	๑๒ มี.ค. ๒๕๔๕
petroleum	ปิโตรเลียม	๑๒ มี.ค. ๒๕๔๕
photochemical smog	หมอกควันแบบโฟโตเคมี	๑๒ มี.ค. ๒๕๔๕
pickup coil	ขดลวดจ่ายศักย์เหนี่ยวนำ	๑๒ มี.ค. ๒๕๔๕
pickup truck	รถพิกอัป	๑๒ มี.ค. ๒๕๔๕
pilot valve	ลิ้นนำ	๑๒ มี.ค. ๒๕๔๕
pilot bearing	ตลับลูกปืนหัวเพลาคลัตช์	๑๒ มี.ค. ๒๕๔๕
pilot jet; idle jet; slow-running jet	นมหนูเดินเบา	๑๒ มี.ค. ๒๕๔๕
pilot light	ไฟนำ	๑๒ มี.ค. ๒๕๔๕
pilot shaft	เพลานำ	๑๒ มี.ค. ๒๕๔๕
pinion; pinion gear	เฟืองเล็ก	๑๒ มี.ค. ๒๕๔๕
pinion shaft	เพลาเฟืองเล็ก	๑๒ มี.ค. ๒๕๔๕
pintle	สลัก	๑๒ มี.ค. ๒๕๔๕
pintle hook	สลักตะขอต่อพ่วง	๑๒ มี.ค. ๒๕๔๕
pintle nozzle	หัวฉีดแบบเดือย	๑๒ มี.ค. ๒๕๔๕
piston	ลูกสูบ	๑๒ มี.ค. ๒๕๔๕
piston clearance	ระยะห่างลูกสูบ	๑๒ มี.ค. ๒๕๔๕
piston collapse	การยุบของกระโปรงลูกสูบ	๑๒ มี.ค. ๒๕๔๕
piston compression height	ระยะสลักถึงหัวลูกสูบ	๑๒ มี.ค. ๒๕๔๕
piston crown; piston head	หัวลูกสูบ	๑๒ มี.ค. ๒๕๔๕
piston displacement	ความจุกระบอกสูบ	๑๒ มี.ค. ๒๕๔๕
piston engine reciprocating engine	เครื่องยนต์ลูกสูบ	๑๒ มี.ค. ๒๕๔๕
piston head; piston crown	หัวลูกสูบ	๑๒ มี.ค. ๒๕๔๕
piston land	ผิวลูกสูบระหว่างแหวน	๑๒ มี.ค. ๒๕๔๕
piston pin; gudgeon pin; wrist pin	สลักลูกสูบ	๑๒ มี.ค. ๒๕๔๕
piston ring	แหวนลูกสูบ	๑๒ มี.ค. ๒๕๔๕
piston ring gap; ring gap	ระยะปากแหวน	๑๒ มี.ค. ๒๕๔๕
piston ring groove; ring groove	ร่องแหวนลูกสูบ	๑๒ มี.ค. ๒๕๔๕
piston skirt	กระโปรงลูกสูบ	๑๒ มี.ค. ๒๕๔๕
pitman arm	แขนพิตแมน	๑๒ มี.ค. ๒๕๔๕
piston slap	เสียงลูกสูบตบข้าง	๑๒ มี.ค. ๒๕๔๕
pitching	การปักแล้วเงย	๑๒ มี.ค. ๒๕๔๕
plain bearing	รองลื่น	๑๒ มี.ค. ๒๕๔๕
planet carrier	ชิ้นรองรับชุดเฟืองแพลเนต	๑๒ มี.ค. ๒๕๔๕
planet gear; planet pinion	เฟืองแพลเนต	๑๒ มี.ค. ๒๕๔๕
planet pinion; planet gear	เฟืองแพลเนต	๑๒ มี.ค. ๒๕๔๕
planetary gear train	ขบวนเฟืองแพลเนต	๑๒ มี.ค. ๒๕๔๕
plastic filler	สีโป๊พลาสติก	๑๒ มี.ค. ๒๕๔๕
plastic gasket compound; formed-in-place gasket	ปะเก็นเหลว	๑๒ มี.ค. ๒๕๔๕
Plastigage	พลาสทิเกจ	๑๒ มี.ค. ๒๕๔๕
plate	แผ่นธาตุ	๑๒ มี.ค. ๒๕๔๕
play; free play; lash	ระยะว่าง	๑๒ มี.ค. ๒๕๔๕
plug gap; spark gap	ช่องว่างเขี้ยวหัวเทียน	๑๒ มี.ค. ๒๕๔๕
plug lead	สายหัวเทียน	๑๒ มี.ค. ๒๕๔๕
plunger	พลันเจอร์	๑๒ มี.ค. ๒๕๔๕
ply	ชั้นโครงสร้างยางรถ	๑๒ มี.ค. ๒๕๔๕
ply rating (PR)	ค่าประเมินความแข็งแรงชั้นโครงสร้างยางรถ (พีอาร์)	๑๒ มี.ค. ๒๕๔๕
pneumatic suspension	ระบบรองรับแบบใช้ลม	๑๒ มี.ค. ๒๕๔๕
pneumatic tire; pneumatic tyre	ยางสูบลม	๑๒ มี.ค. ๒๕๔๕
pocketing	บ่าลิ้นจม	๑๒ มี.ค. ๒๕๔๕
points; breaker points; contact points	หน้าทองขาว	๑๒ มี.ค. ๒๕๔๕
pole trailer	รถกึ่งพ่วงปรับความยาวได้	๑๒ มี.ค. ๒๕๔๕
pop-back; blow-back; popping back; spit back	การเผาไหม้ย้อนกลับ	๑๒ มี.ค. ๒๕๔๕
poppet valve	ลิ้นดอกเห็ด	๑๒ มี.ค. ๒๕๔๕
popping back; blow-back; pop-back; spit back	การเผาไหม้ย้อนกลับ	๑๒ มี.ค. ๒๕๔๕
port injection; multiple-point injection	การฉีดแยกช่องไอดี	๑๒ มี.ค. ๒๕๔๕
ported vacuum	ช่องสุญญากาศ	๑๒ มี.ค. ๒๕๔๕
ported-vacuum switch (PVS)	สวิตช์ช่องสุญญากาศ (พีวีเอส) [มีความหมายเหมือนกับ coolant-override valve; vacuum-control valve]	๑๒ มี.ค. ๒๕๔๕
porting	การปรับแต่งช่องไอดีไอเสีย	๑๒ มี.ค. ๒๕๔๕
positive pole; positive terminal	ขั้วบวก	๑๒ มี.ค. ๒๕๔๕
positive crankcase ventilation (PCV)	การระบายไอห้องข้อเหวี่ยงแบบปิด (พีซีวี)	๑๒ มี.ค. ๒๕๔๕
pour point	จุดเริ่มไหล	๑๒ มี.ค. ๒๕๔๕
power booster	หม้อเสริมกำลัง	๑๒ มี.ค. ๒๕๔๕
power brake	เบรกเสริมกำลัง	๑๒ มี.ค. ๒๕๔๕
power cylinder	กระบอกสูบเสริมกำลัง	๑๒ มี.ค. ๒๕๔๕
power steering	ระบบพวงมาลัยเสริมกำลัง	๑๒ มี.ค. ๒๕๔๕
power stroke	จังหวะกำลัง	๑๒ มี.ค. ๒๕๔๕
power train; drive train	ขบวนส่งกำลัง	๑๒ มี.ค. ๒๕๔๕
power hop	การกระชาก	๑๒ มี.ค. ๒๕๔๕
power piston	ลูกสูบเสริมกำลัง	๑๒ มี.ค. ๒๕๔๕
PR (ply rating)	พีอาร์ (ค่าประเมินความแข็งแรงชั้นโครงสร้างยางรถ)	๑๒ มี.ค. ๒๕๔๕
pre-ignition	การชิงจุดระเบิด	๑๒ มี.ค. ๒๕๔๕
prechamber; precombustion chamber	ห้องเผาไหม้ก่อน	๑๒ มี.ค. ๒๕๔๕
precision-insert bearing; slip-in-bearing	รองลื่นสำเร็จรูป	๑๒ มี.ค. ๒๕๔๕
precombustion chamber; prechamber	ห้องเผาไหม้ก่อน	๑๒ มี.ค. ๒๕๔๕
preloading	การให้ภาระก่อน	๑๒ มี.ค. ๒๕๔๕
press	แท่นอัด	๑๒ มี.ค. ๒๕๔๕
press-fit; drive-fit	การสวมอัด	๑๒ มี.ค. ๒๕๔๕
pressure bleeder	เครื่องอัดน้ำมันเบรก	๑๒ มี.ค. ๒๕๔๕
pressure cap; radiator pressure cap	ฝาหม้อน้ำความดัน [มีความหมายเหมือนกับ radiator cap]	๑๒ มี.ค. ๒๕๔๕
pressure plate; clutch pressure plate	แผ่นกดคลัตช์	๑๒ มี.ค. ๒๕๔๕
pressure regulator	ตัวคุมค่าความดัน	๑๒ มี.ค. ๒๕๔๕
pressure tester	เครื่องทดสอบความดัน	๑๒ มี.ค. ๒๕๔๕
pressure valve	ลิ้นความดัน	๑๒ มี.ค. ๒๕๔๕
pressure-differential valve	ลิ้นเตือนความดันตก	๑๒ มี.ค. ๒๕๔๕
pressure-feed oil system	ระบบหล่อลื่นแบบความดัน	๑๒ มี.ค. ๒๕๔๕
pressure-limiting valve; limiting valve	ลิ้นจำกัดความดัน	๑๒ มี.ค. ๒๕๔๕
pressure-relief valve; relief valve	ลิ้นระบายความดัน	๑๒ มี.ค. ๒๕๔๕
prevailing-torque fasteners	ตัวยึดกันคลาย	๑๒ มี.ค. ๒๕๔๕
prevailing-torque nut	แป้นเกลียวกันคลาย	๑๒ มี.ค. ๒๕๔๕
preventive maintenance	การบำรุงรักษาแบบป้องกัน	๑๒ มี.ค. ๒๕๔๕
primary circuit	วงจรปฐมภูมิ	๑๒ มี.ค. ๒๕๔๕
primary current	กระแสปฐมภูมิ	๑๒ มี.ค. ๒๕๔๕
prime coat	สีรองพื้น	๑๒ มี.ค. ๒๕๔๕
primary winding	ขดลวดปฐมภูมิ	๑๒ มี.ค. ๒๕๔๕
printed circuit	วงจรพิมพ์	๑๒ มี.ค. ๒๕๔๕
progressive linkage	กลไกก้านต่อก้าวหน้า	๑๒ มี.ค. ๒๕๔๕
prony brake	โพรนีเบรก	๑๒ มี.ค. ๒๕๔๕
propeller shaft	เพลากลาง	๑๒ มี.ค. ๒๕๔๕
proportioning valve	ลิ้นแบ่งความดัน	๑๒ มี.ค. ๒๕๔๕
pull	ปัด	๑๒ มี.ค. ๒๕๔๕
pull-off spring	สปริงเกือกเบรก	๑๒ มี.ค. ๒๕๔๕
pulley	รอก	๑๒ มี.ค. ๒๕๔๕
pump	เครื่องสูบ, ปั๊ม	๑๒ มี.ค. ๒๕๔๕
pump-braking; cadence braking	การย้ำเบรกกันปัด	๑๒ มี.ค. ๒๕๔๕
purge valve	ลิ้นรุทิ้ง	๑๒ มี.ค. ๒๕๔๕
push-rod	ก้านกระทุ้ง	๑๒ มี.ค. ๒๕๔๕
putty	สีโป๊	๑๒ มี.ค. ๒๕๔๕
PVS (ported-vacuum switch)	พีวีเอส (สวิตช์ช่องสุญญากาศ)	๑๒ มี.ค. ๒๕๔๕
quarter light	กระจกหูช้าง	๑๒ มี.ค. ๒๕๔๕
quartz-halogen bulb	หลอดไฟควอตซ์-แฮโลเจน	๑๒ มี.ค. ๒๕๔๕
quench area	บริเวณเย็น	๑๒ มี.ค. ๒๕๔๕
quick charger	เครื่องประจุแบตเตอรี่แบบเร็ว	๑๒ มี.ค. ๒๕๔๕
R and R (remove and reinstall)	อาร์แอนด์อาร์ (ถอดประกอบ)	๑๒ มี.ค. ๒๕๔๕
race	รางลูกปืน	๑๒ มี.ค. ๒๕๔๕
rack and pinion gear	เฟืองสะพาน	๑๒ มี.ค. ๒๕๔๕
rack-and-pinion steering gear	เฟืองบังคับเลี้ยวแบบเฟืองสะพาน	๑๒ มี.ค. ๒๕๔๕
radial runout	ความส่ายจากแนวรัศมี, ความเบี้ยวจากแนวรัศมี	๑๒ มี.ค. ๒๕๔๕
radial tire; radial tyre; radial-ply tire; radial-ply tyre	ยางเรเดียล	๑๒ มี.ค. ๒๕๔๕
radial-ply tire; radial tire; radial tyre; radial-ply tyre	ยางเรเดียล	๑๒ มี.ค. ๒๕๔๕
radiator	หม้อน้ำ	๑๒ มี.ค. ๒๕๔๕
radiator cap	ฝาหม้อน้ำ	๑๒ มี.ค. ๒๕๔๕
radiator hose	ท่ออ่อนหม้อน้ำ	๑๒ มี.ค. ๒๕๔๕
radiator pressure cap; pressure cap	ฝาหม้อน้ำความดัน	๑๒ มี.ค. ๒๕๔๕
radius arm; radius rod	แขนยึด	๑๒ มี.ค. ๒๕๔๕
radius ride	การปีนตามแนวรัศมี	๑๒ มี.ค. ๒๕๔๕
radius rod; radius arm	แขนยึด	๑๒ มี.ค. ๒๕๔๕
ram-air cleaner	หม้อกรองอากาศแบบอัดเข้า	๑๒ มี.ค. ๒๕๔๕
raster pattern; stacked pattern	แบบคลื่นเรียงแนวตั้ง	๑๒ มี.ค. ๒๕๔๕
reach	ความยาวเกลียวหัวเทียน	๑๒ มี.ค. ๒๕๔๕
rear axle	เพลาท้าย	๑๒ มี.ค. ๒๕๔๕
rear lamp; tail lamp	ไฟท้าย	๑๒ มี.ค. ๒๕๔๕
rear panel	แผงท้ายรถ	๑๒ มี.ค. ๒๕๔๕
rear suspension	ระบบรองรับล้อหลัง	๑๒ มี.ค. ๒๕๔๕
rear-end torque	ทอร์กบนเสื้อเพลาท้าย	๑๒ มี.ค. ๒๕๔๕
rear-wheel drive	ระบบขับเคลื่อนล้อหลัง	๑๒ มี.ค. ๒๕๔๕
rebore; boring; reboring	การคว้านกระบอกสูบ	๑๒ มี.ค. ๒๕๔๕
reboring; boring; rebore	การคว้านกระบอกสูบ	๑๒ มี.ค. ๒๕๔๕
rebound valve	ลิ้นบังคับการไหลกลับ	๑๒ มี.ค. ๒๕๔๕
recapped tire; retreaded tire	ยางหล่อดอก	๑๒ มี.ค. ๒๕๔๕
reciprocating engine; piston engine	เครื่องยนต์ลูกสูบ	๑๒ มี.ค. ๒๕๔๕
recovery tank; expansion tank	๑. หม้อน้ำล้น๒. หม้อกันล้น	๑๒ มี.ค. ๒๕๔๕
red line	เส้นแดง	๑๒ มี.ค. ๒๕๔๕
reed valve	ลิ้นแบบใบอ่อน	๑๒ มี.ค. ๒๕๔๕
reflector	แผ่นสะท้อนแสง	๑๒ มี.ค. ๒๕๔๕
regeneration system	ระบบอุ่นอากาศเข้า	๑๒ มี.ค. ๒๕๔๕
relay	รีเลย์	๑๒ มี.ค. ๒๕๔๕
release bearing; clutch thrust bearing; throwout bearing; withdrawal bearing	ตลับลูกปืนคลัตช์	๑๒ มี.ค. ๒๕๔๕
release fingers; release lever plate; release levers	นิ้วคลัตช์	๑๒ มี.ค. ๒๕๔๕
release spring; clutch spring	สปริงคลัตช์	๑๒ มี.ค. ๒๕๔๕
relief valve; pressure-relief valve	ลิ้นระบายความดัน	๑๒ มี.ค. ๒๕๔๕
reluctor	รีลักเตอร์	๑๒ มี.ค. ๒๕๔๕
remove and reinstall (R and R)	ถอดประกอบ (อาร์แอนด์อาร์)	๑๒ มี.ค. ๒๕๔๕
research octane number (RON)	เลขออกเทนวิจัย (อาร์โอเอ็น)	๑๒ มี.ค. ๒๕๔๕
reserve capacity	ความจุสำรอง	๑๒ มี.ค. ๒๕๔๕
resistor spark plug	หัวเทียนมีตัวต้านทาน	๑๒ มี.ค. ๒๕๔๕
resonator	ตัวลดเสียงไอเสีย	๑๒ มี.ค. ๒๕๔๕
retard; spark retard	ตั้งไฟอ่อน, ปรับไฟอ่อน	๑๒ มี.ค. ๒๕๔๕
retarded spark	ไฟอ่อน	๑๒ มี.ค. ๒๕๔๕
retainer lock; valve keeper; valve key; valve lock; valve-spring-retainer lock	ตัวประกบตีนลิ้น	๑๒ มี.ค. ๒๕๔๕
retreaded tire; recapped tire	ยางหล่อดอก	๑๒ มี.ค. ๒๕๔๕
reverse Elliott steering knuckle	หัวต่อแกนล้อแบบเอลเลียตผันกลับ	๑๒ มี.ค. ๒๕๔๕
reverse flushing	การล้างสวนทาง	๑๒ มี.ค. ๒๕๔๕
reverse idler gear	เฟืองส่งผ่านเกียร์ถอยหลัง	๑๒ มี.ค. ๒๕๔๕
reversing light; backup light	ไฟถอยหลัง	๑๒ มี.ค. ๒๕๔๕
ribbon-cellular radiator	หม้อน้ำแบบรังผึ้ง	๑๒ มี.ค. ๒๕๔๕
ribbon-cellular radiator core	ไส้หม้อน้ำแบบรังผึ้ง	๑๒ มี.ค. ๒๕๔๕
ridge reamer; cylinder ridge reamer; ring-ridge remover	เครื่องปาดขอบในของกระบอกสูบ	๑๒ มี.ค. ๒๕๔๕
riding the clutch	การเหยียบแช่คลัตช์	๑๒ มี.ค. ๒๕๔๕
rich mixture	ไอดีหนา	๑๒ มี.ค. ๒๕๔๕
rich running; loading	ไอดีหนาเกิน	๑๒ มี.ค. ๒๕๔๕
rigid axle; beam axle	เพลาคาน	๑๒ มี.ค. ๒๕๔๕
rim	ขอบล้อ	๑๒ มี.ค. ๒๕๔๕
ring gap; piston ring gap	ระยะปากแหวน	๑๒ มี.ค. ๒๕๔๕
ring gear	๑. เฟืองวงแหวน๒. เฟืองบายศรี๓. เฟืองสตาร์ต	๑๒ มี.ค. ๒๕๔๕
ring groove; piston ring groove	ร่องแหวนลูกสูบ	๑๒ มี.ค. ๒๕๔๕
ring ridge	ขอบในของกระบอกสูบ	๑๒ มี.ค. ๒๕๔๕
ring spanner; box wrench	ประแจแหวน	๑๒ มี.ค. ๒๕๔๕
ring-ridge remover; cylinder ridge reamer; ridge reamer	เครื่องปาดขอบในของกระบอกสูบ	๑๒ มี.ค. ๒๕๔๕
roadability	คุณภาพรถบนถนน	๑๒ มี.ค. ๒๕๔๕
roadworthiness	สภาพพร้อมวิ่ง	๑๒ มี.ค. ๒๕๔๕
road roar	เสียงยางบดถนน	๑๒ มี.ค. ๒๕๔๕
road-draft tube	ท่อระบายไอน้ำมันเครื่อง	๑๒ มี.ค. ๒๕๔๕
road-holding	การเกาะถนน	๑๒ มี.ค. ๒๕๔๕
rocker; finger; rocker arm	กระเดื่องกดลิ้น	๑๒ มี.ค. ๒๕๔๕
rocker arm; finger; rocker	กระเดื่องกดลิ้น	๑๒ มี.ค. ๒๕๔๕
rocker clearance; valve clearance; valve lash	ระยะตั้งลิ้น	๑๒ มี.ค. ๒๕๔๕
rocker cover	ฝาครอบลิ้น	๑๒ มี.ค. ๒๕๔๕
rocker shaft	เพลากระเดื่องกดลิ้น	๑๒ มี.ค. ๒๕๔๕
roll	การโคลง	๑๒ มี.ค. ๒๕๔๕
rod bearing; connecting-rod bearing	รองลื่นก้านสูบ	๑๒ มี.ค. ๒๕๔๕
rod big end; big-end	ปลายใหญ่ก้านสูบ	๑๒ มี.ค. ๒๕๔๕
rod bolt	สลักเกลียวก้านสูบ	๑๒ มี.ค. ๒๕๔๕
rod small end; little-end; small-end	ปลายเล็กก้านสูบ	๑๒ มี.ค. ๒๕๔๕
roll bar	โครงคุ้มกัน	๑๒ มี.ค. ๒๕๔๕
roll steer	การเอียงเลี้ยว	๑๒ มี.ค. ๒๕๔๕
roller bearing	ตลับลูกปืนเม็ดยาว	๑๒ มี.ค. ๒๕๔๕
roller tappet	ลูกกระทุ้งลิ้นแบบลูกกลิ้ง	๑๒ มี.ค. ๒๕๔๕
rolling idle; loping idle	เดินเบาไม่สม่ำเสมอ	๑๒ มี.ค. ๒๕๔๕
rolling radius	รัศมีการกลิ้ง	๑๒ มี.ค. ๒๕๔๕
rom-temperature-vulcanising sealant; aerobic gasket material; room-temperature-vulcanising sealant; RTV sealant	วัสดุปะเก็นแอโรบิก	๑๒ มี.ค. ๒๕๔๕
RON (research octane number)	อาร์โอเอ็น (เลขออกเทนวิจัย)	๑๒ มี.ค. ๒๕๔๕
roof lining; headlining	วัสดุบุหลังคา	๑๒ มี.ค. ๒๕๔๕
room-temperature-vulcanising sealant; aerobic gasket material; rom-temperature-vulcanising sealant; RTV sealant	วัสดุปะเก็นแอโรบิก	๑๒ มี.ค. ๒๕๔๕
rotary engine	เครื่องยนต์โรทารี	๑๒ มี.ค. ๒๕๔๕
rotary valve	ลิ้นหมุน	๑๒ มี.ค. ๒๕๔๕
rotor	ตัวหมุน	๑๒ มี.ค. ๒๕๔๕
rotor arm; distributor rotor; distributor rotor arm	หัวนกกระจอก	๑๒ มี.ค. ๒๕๔๕
rotor oil pump	เครื่องสูบน้ำมันเครื่องแบบตัวหมุน, ปั๊มน้ำมันเครื่องแบบตัวหมุน	๑๒ มี.ค. ๒๕๔๕
rough idle	เดินเบาไม่เรียบ	๑๒ มี.ค. ๒๕๔๕
RTV sealant; aerobic gasket material; rom-temperature-vulcanising sealant; room-temperature-vulcanising sealant	วัสดุปะเก็นแอโรบิก	๑๒ มี.ค. ๒๕๔๕
rubber solution	น้ำยาปะยางใน	๑๒ มี.ค. ๒๕๔๕
rubbing compound; cutting compound	ยาขัดสี	๑๒ มี.ค. ๒๕๔๕
run-in	รันอิน [มีความหมายเหมือนกับ break-in]	๑๒ มี.ค. ๒๕๔๕
run-on; afterrunning; dieseling; running-on	เครื่องเดินค้าง	๑๒ มี.ค. ๒๕๔๕
running-on; afterrunning; dieseling; run-on	เครื่องเดินค้าง	๑๒ มี.ค. ๒๕๔๕
runout; wobble	การส่าย	๑๒ มี.ค. ๒๕๔๕
SAE (Society of Automotive Engineers)	เอสเออี (สมาคมวิศวกรยานยนต์)	๑๒ มี.ค. ๒๕๔๕
SAE gross brake horsepower (SAE gross bhp)	แรงม้าเพลารวบยอดเอสเออี (บีเอชพีรวบยอดเอสเออี)	๑๒ มี.ค. ๒๕๔๕
SAE net brake horsepower (SAE net bhp)	แรงม้าเพลาสุทธิเอสเออี (บีเอชพีสุทธิเอสเออี)	๑๒ มี.ค. ๒๕๔๕
SAE oil grade	เกรดน้ำมันหล่อลื่นเอสเออี	๑๒ มี.ค. ๒๕๔๕
safety belt; seat belt	เข็มขัดนิรภัย	๑๒ มี.ค. ๒๕๔๕
safety glass	กระจกนิรภัย	๑๒ มี.ค. ๒๕๔๕
safety stand; car stand; jack stand	ขาตั้งรับรถ	๑๒ มี.ค. ๒๕๔๕
saloon; sedan	รถเก๋ง	๑๒ มี.ค. ๒๕๔๕
scavenging	การไล่ไอเสีย	๑๒ มี.ค. ๒๕๔๕
scored	มีรอยขูดขีด	๑๒ มี.ค. ๒๕๔๕
scraper	เหล็กขูด	๑๒ มี.ค. ๒๕๔๕
scraper ring; oil ring; oil scraper ring; oil-control ring	แหวนกวาดน้ำมันเครื่อง	๑๒ มี.ค. ๒๕๔๕
screw	สกรู	๑๒ มี.ค. ๒๕๔๕
screwdriver	ไขควง	๑๒ มี.ค. ๒๕๔๕
seal	กันรั่ว	๑๒ มี.ค. ๒๕๔๕
sealant; sealer; sealing compound	สารกันรั่ว	๑๒ มี.ค. ๒๕๔๕
sealed-beam headlight	ไฟหน้าผนึกสนิท	๑๒ มี.ค. ๒๕๔๕
sealer; sealant; sealing compound	สารกันรั่ว	๑๒ มี.ค. ๒๕๔๕
SDV (spark delay valve)	เอสดีวี (ลิ้นหน่วงการเกิดประกายไฟ)	๑๒ มี.ค. ๒๕๔๕
sealing washer	แหวนกันรั่ว	๑๒ มี.ค. ๒๕๔๕
seat belt; safety belt	เข็มขัดนิรภัย	๑๒ มี.ค. ๒๕๔๕
secondary circuit	วงจรทุติยภูมิ	๑๒ มี.ค. ๒๕๔๕
secondary air	อากาศทุติยภูมิ	๑๒ มี.ค. ๒๕๔๕
secondary available voltage	แรงเคลื่อนไฟฟ้าทุติยภูมิผลิตได้	๑๒ มี.ค. ๒๕๔๕
secondary venturi	คอคอดทุติยภูมิ	๑๒ มี.ค. ๒๕๔๕
section height	ความสูงภาคตัด	๑๒ มี.ค. ๒๕๔๕
section width	ความกว้างภาคตัด	๑๒ มี.ค. ๒๕๔๕
sedan; saloon	รถเก๋ง	๑๒ มี.ค. ๒๕๔๕
sector	เฟืองเสี้ยว	๑๒ มี.ค. ๒๕๔๕
selector fork	ก้ามปูเลือกเฟือง	๑๒ มี.ค. ๒๕๔๕
selector mechanism	กลไกเลือกเกียร์	๑๒ มี.ค. ๒๕๔๕
selector rod	ก้านเลือกเฟือง	๑๒ มี.ค. ๒๕๔๕
self-adjuster	ตัวปรับเอง	๑๒ มี.ค. ๒๕๔๕
self-aligning torque; aligning torque	ทอร์กคืนศูนย์	๑๒ มี.ค. ๒๕๔๕
self-diagnostic system	ระบบแสดงปัญหาขัดข้อง	๑๒ มี.ค. ๒๕๔๕
self-discharge	การปล่อยประจุเอง	๑๒ มี.ค. ๒๕๔๕
self-energization	การให้แรงเสริมตัวเอง	๑๒ มี.ค. ๒๕๔๕
self-induction	การเหนี่ยวนำตัวเอง	๑๒ มี.ค. ๒๕๔๕
self-locking nut	แป้นเกลียวล็อกตัวเอง	๑๒ มี.ค. ๒๕๔๕
self-servo effect	ผลการเสริมแรงตัวเอง	๑๒ มี.ค. ๒๕๔๕
self-tapping screw	สกรูตัดเกลียวเอง	๑๒ มี.ค. ๒๕๔๕
semi trailer	รถกึ่งพ่วง	๑๒ มี.ค. ๒๕๔๕
semi-conductor ignition system	ระบบจุดระเบิดแบบสารกึ่งตัวนำ	๑๒ มี.ค. ๒๕๔๕
semi-elliptic spring	แหนบกึ่งวงรี	๑๒ มี.ค. ๒๕๔๕
semi-trailing arm	แขนคล้อยหลัง	๑๒ มี.ค. ๒๕๔๕
sensor	ตัวรับรู้	๑๒ มี.ค. ๒๕๔๕
separator; batter separator	แผ่นกั้นในแบตเตอรี่	๑๒ มี.ค. ๒๕๔๕
servo	เซอร์โว	๑๒ มี.ค. ๒๕๔๕
servo system	ระบบเซอร์โว	๑๒ มี.ค. ๒๕๔๕
service rating	ค่าประเมินน้ำมันเครื่อง	๑๒ มี.ค. ๒๕๔๕
shackle; spring shackle	ห่วงยึดแหนบ, โตงเตง	๑๒ มี.ค. ๒๕๔๕
shaft	เพลา	๑๒ มี.ค. ๒๕๔๕
shell bearing	รองลื่นสองฝา	๑๒ มี.ค. ๒๕๔๕
shift lever; gear lever	คันเกียร์	๑๒ มี.ค. ๒๕๔๕
shift valve	ลิ้นเปลี่ยนเกียร์	๑๒ มี.ค. ๒๕๔๕
shim	แผ่นจีม	๑๒ มี.ค. ๒๕๔๕
shimmy	การสั่นแกว่ง	๑๒ มี.ค. ๒๕๔๕
shock absorber; suspension damper	ตัวหน่วงการสั่นสะเทือน	๑๒ มี.ค. ๒๕๔๕
shoe; brake shoe	เกือกเบรก, ฝักเบรก	๑๒ มี.ค. ๒๕๔๕
short block; short engine; short motor	เครื่องยนต์ส่วนหลัก	๑๒ มี.ค. ๒๕๔๕
short engine; short block; short motor	เครื่องยนต์ส่วนหลัก	๑๒ มี.ค. ๒๕๔๕
short heel contact; heel contact	สัมผัสโคน	๑๒ มี.ค. ๒๕๔๕
short motor; short block; short engine	เครื่องยนต์ส่วนหลัก	๑๒ มี.ค. ๒๕๔๕
short toe contact; toe contact	สัมผัสปลาย	๑๒ มี.ค. ๒๕๔๕
short-arm long-arm suspension	ระบบรองรับแบบปีกนกสั้น-ยาว	๑๒ มี.ค. ๒๕๔๕
shroud	แผ่นป้องลม	๑๒ มี.ค. ๒๕๔๕
shuttle valve	ลิ้นกระสวย	๑๒ มี.ค. ๒๕๔๕
SI engine; spark-ignition engine	เครื่องยนต์เอสไอ, เครื่องยนต์จุดระเบิดด้วยประกายไฟ	๑๒ มี.ค. ๒๕๔๕
Siamese ports	ช่องร่วมแฝด	๑๒ มี.ค. ๒๕๔๕
sidewall	แก้มยางรถ	๑๒ มี.ค. ๒๕๔๕
side-light; parking light	ไฟจอด	๑๒ มี.ค. ๒๕๔๕
side-valve engine	เครื่องยนต์แบบลิ้นข้าง	๑๒ มี.ค. ๒๕๔๕
silencer	หม้อลดเสียง	๑๒ มี.ค. ๒๕๔๕
silicone rubber	ยางซิลิโคน	๑๒ มี.ค. ๒๕๔๕
single-chamber capacity	ความจุห้องเดี่ยว	๑๒ มี.ค. ๒๕๔๕
single-piston caliper	ก้ามปูเบรกจานแบบสูบเดียว	๑๒ มี.ค. ๒๕๔๕
single-point injection	การฉีดจุดเดียว	๑๒ มี.ค. ๒๕๔๕
sipes; knife cuts	ร่องดอกละเอียด	๑๒ มี.ค. ๒๕๔๕
skid-control valve	ลิ้นควบคุมการไถล	๑๒ มี.ค. ๒๕๔๕
slave cylinder; brake cylinder; brake wheel cylinder; wheel cylinder	ชุดกระบอกเบรก	๑๒ มี.ค. ๒๕๔๕
slant engine	เครื่องยนต์กระบอกสูบเอียง	๑๒ มี.ค. ๒๕๔๕
sliding caliper	ก้ามปูเลื่อน	๑๒ มี.ค. ๒๕๔๕
sliding gear	เฟืองเลื่อน	๑๒ มี.ค. ๒๕๔๕
sliding joint; slip joint	ข้อต่อเลื่อน [มีความหมายเหมือนกับ spline joint]	๑๒ มี.ค. ๒๕๔๕
slip joint; sliding joint	ข้อต่อเลื่อน [มีความหมายเหมือนกับ spline joint]	๑๒ มี.ค. ๒๕๔๕
slip-in bearing; precision-insert bearing	รองลื่นสำเร็จรูป	๑๒ มี.ค. ๒๕๔๕
slip angle	มุมลื่นไถล	๑๒ มี.ค. ๒๕๔๕
slow-running	รอบเดินเบา	๑๒ มี.ค. ๒๕๔๕
slow-running jet; idle jet; pilot jet	นมหนูเดินเบา	๑๒ มี.ค. ๒๕๔๕
slow-running screw; throttle-stop screw	สกรูปรับเดินเบา	๑๒ มี.ค. ๒๕๔๕
sludge	โคลนน้ำมันเครื่อง	๑๒ มี.ค. ๒๕๔๕
snap ring	แหวนกันหลุด	๑๒ มี.ค. ๒๕๔๕
small-end; little-end; rod small end	ปลายเล็กก้านสูบ	๑๒ มี.ค. ๒๕๔๕
smoke in exhaust	ควันในไอเสีย	๑๒ มี.ค. ๒๕๔๕
Society of Automotive Engineers (SAE)	สมาคมวิศวกรยานยนต์ (เอสเออี)	๑๒ มี.ค. ๒๕๔๕
sodium-cooled valve; sodium-filled valve	วาล์วหล่อเย็นด้วยโซเดียม	๑๒ มี.ค. ๒๕๔๕
sodium-filled valve; sodium-cooled valve	วาล์วหล่อเย็นด้วยโซเดียม	๑๒ มี.ค. ๒๕๔๕
solenoid	โซเลนอยด์	๑๒ มี.ค. ๒๕๔๕
solid axle	เพลาแข็ง	๑๒ มี.ค. ๒๕๔๕
solid injection	การฉีดแบบลูกสูบอัด	๑๒ มี.ค. ๒๕๔๕
solid-state regulator	ตัวคุมค่าแบบโซลิดสเตต	๑๒ มี.ค. ๒๕๔๕
spark; jump spark	ประกายไฟ	๑๒ มี.ค. ๒๕๔๕
spark advance; ignition advance	การเร่งไฟ	๑๒ มี.ค. ๒๕๔๕
spark advance mechanism; advance mechanism; ignition advance mechanism	กลไกเร่งไฟ	๑๒ มี.ค. ๒๕๔๕
spark delay valve (SDV)	ลิ้นหน่วงการเกิดประกายไฟ (เอสดีวี)	๑๒ มี.ค. ๒๕๔๕
spark duration	ช่วงเกิดประกายไฟ	๑๒ มี.ค. ๒๕๔๕
spark gap; plug gap	ช่องว่างเขี้ยวหัวเทียน	๑๒ มี.ค. ๒๕๔๕
spark knock	น็อกจากประกายไฟ	๑๒ มี.ค. ๒๕๔๕
spark line	เส้นประกายไฟ	๑๒ มี.ค. ๒๕๔๕
spark plug; sparking plug	หัวเทียน	๑๒ มี.ค. ๒๕๔๕
spark plug gauge	เกจหัวเทียน	๑๒ มี.ค. ๒๕๔๕
spark plug heat range; heat range	ช่วงความร้อนหัวเทียน	๑๒ มี.ค. ๒๕๔๕
spark retard; retard	ตั้งไฟอ่อน, ปรับไฟอ่อน	๑๒ มี.ค. ๒๕๔๕
spark test	การทดสอบประกายไฟ	๑๒ มี.ค. ๒๕๔๕
spark-ignition engine; SI engine	เครื่องยนต์เอสไอ, เครื่องยนต์จุดระเบิดด้วยประกายไฟ	๑๒ มี.ค. ๒๕๔๕
sparking plug; spark plug	หัวเทียน	๑๒ มี.ค. ๒๕๔๕
speedometer	มาตรอัตราเร็ว	๑๒ มี.ค. ๒๕๔๕
spider	กากบาท	๑๒ มี.ค. ๒๕๔๕
spider gear	เฟืองสไปเดอร์	๑๒ มี.ค. ๒๕๔๕
spigot	เดือย	๑๒ มี.ค. ๒๕๔๕
spiral bevel gear	เฟืองดอกจอกฟันโค้ง	๑๒ มี.ค. ๒๕๔๕
spit-back; blow-back; pop-back; popping back	การเผาไหม้ย้อนกลับ	๑๒ มี.ค. ๒๕๔๕
splash lubrication	การหล่อลื่นแบบวิดสาด (น้ำมัน)	๑๒ มี.ค. ๒๕๔๕
splash-feed oil system	ระบบหล่อลื่นแบบวิดสาดน้ำมัน [มีความหมายเหมือนกับ splash lubrication]	๑๒ มี.ค. ๒๕๔๕
splayed crankpins	สลักข้อเหวี่ยงแยกส่วนก้านสูบ	๑๒ มี.ค. ๒๕๔๕
spline	ร่องฟัน	๑๒ มี.ค. ๒๕๔๕
spline joint	ข้อต่อร่องฟัน	๑๒ มี.ค. ๒๕๔๕
split brake system	ระบบเบรกแยกวงจร	๑๒ มี.ค. ๒๕๔๕
split cone; collet	ประกับล็อก	๑๒ มี.ค. ๒๕๔๕
split pin; cotter pin	สลักปลายแยก	๑๒ มี.ค. ๒๕๔๕
spoiler	สปอยเลอร์	๑๒ มี.ค. ๒๕๔๕
spool valve	ลิ้นหลอดด้าย	๑๒ มี.ค. ๒๕๔๕
spongy brake pedal; spongy pedal	คันเหยียบเบรกหยุ่นตัว	๑๒ มี.ค. ๒๕๔๕
spongy pedal; spongy brake pedal	คันเหยียบเบรกหยุ่นตัว	๑๒ มี.ค. ๒๕๔๕
sprag clutch	คลัตช์ทางเดียวแบบค้ำยัน	๑๒ มี.ค. ๒๕๔๕
spring	สปริง	๑๒ มี.ค. ๒๕๔๕
spring clip	ตัวรัดแหนบ	๑๒ มี.ค. ๒๕๔๕
spring eye	หูแหนบ	๑๒ มี.ค. ๒๕๔๕
spring hanger; hanger bracket	แท่นยึดหูแหนบ	๑๒ มี.ค. ๒๕๔๕
spring retainer; valve spring ratainer	ฐานสปริงลิ้น	๑๒ มี.ค. ๒๕๔๕
spring shackle; shackle	ห่วงยึดแหนบ, โตงเตง	๑๒ มี.ค. ๒๕๔๕
sprocket	เฟืองโซ่	๑๒ มี.ค. ๒๕๔๕
sprung weight	น้ำหนักบนสปริง	๑๒ มี.ค. ๒๕๔๕
spur gear; straight-cut gear	เฟืองฟันตรง	๑๒ มี.ค. ๒๕๔๕
spurt-hole	ช่องพ่นน้ำมัน	๑๒ มี.ค. ๒๕๔๕
squab	พนักพิง	๑๒ มี.ค. ๒๕๔๕
square engine	เครื่องยนต์ช่วงชักเท่า	๑๒ มี.ค. ๒๕๔๕
squish area	บริเวณพ่นไอดี	๑๒ มี.ค. ๒๕๔๕
stacked pattern; raster pattern	แบบคลื่นเรียงแนวตั้ง	๑๒ มี.ค. ๒๕๔๕
stabilizer; antiroll bar; stabilizer bar; sway bar	ท่อนกันโคลง	๑๒ มี.ค. ๒๕๔๕
stabilizer bar; antiroll bar; stabilizer; sway bar	ท่อนกันโคลง	๑๒ มี.ค. ๒๕๔๕
stall	เครื่องยนต์สะดุดดับ	๑๒ มี.ค. ๒๕๔๕
stall test	การทดสอบขณะหยุดหมุน	๑๒ มี.ค. ๒๕๔๕
starter; cranking motor; starter motor; starting motor	มอเตอร์ติดเครื่อง, มอเตอร์สตาร์ต	๑๒ มี.ค. ๒๕๔๕
starter motor; cranking motor; starter; starting motor	มอเตอร์ติดเครื่อง, มอเตอร์สตาร์ต	๑๒ มี.ค. ๒๕๔๕
starter pinion gear	เฟืองขับมอเตอร์ติดเครื่อง, เฟืองขับมอเตอร์ สตาร์ต	๑๒ มี.ค. ๒๕๔๕
starter relay	รีเลย์สตาร์ต	๑๒ มี.ค. ๒๕๔๕
starting motor; cranking motor; starter; starter motor	มอเตอร์ติดเครื่อง, มอเตอร์สตาร์ต	๑๒ มี.ค. ๒๕๔๕
static balance	ดุลสถิต	๑๒ มี.ค. ๒๕๔๕
static friction	ความเสียดทานสถิต	๑๒ มี.ค. ๒๕๔๕
station wagan; estate car	รถตรวจการ	๑๒ มี.ค. ๒๕๔๕
stator	สเตเตอร์	๑๒ มี.ค. ๒๕๔๕
steering arm	แขนบังคับเลี้ยว	๑๒ มี.ค. ๒๕๔๕
steering axis	แกนบังคับเลี้ยว	๑๒ มี.ค. ๒๕๔๕
steering axis inclination	ความเอียงแกนบังคับเลี้ยว	๑๒ มี.ค. ๒๕๔๕
steering box	กระปุกพวงมาลัย [มีความหมายเหมือนกับ steering gear ๑ และ steering gear box]	๑๒ มี.ค. ๒๕๔๕
steering column; steering shaft	แกนพวงมาลัย	๑๒ มี.ค. ๒๕๔๕
steering feedback	ผลป้อนกลับที่พวงมาลัย	๑๒ มี.ค. ๒๕๔๕
steering gear	๑. เฟืองพวงมาลัย๒. เฟืองบังคับเลี้ยว	๑๒ มี.ค. ๒๕๔๕
steering gear box	กระปุกเฟืองพวงมาลัย	๑๒ มี.ค. ๒๕๔๕
steering geometry	เรขาคณิตบังคับเลี้ยว	๑๒ มี.ค. ๒๕๔๕
steering kickback	พวงมาลัยตีกลับ	๑๒ มี.ค. ๒๕๔๕
steering knuckle; knuckle	หัวต่อแกนล้อ	๑๒ มี.ค. ๒๕๔๕
steering lock	ล็อกแกนพวงมาลัย	๑๒ มี.ค. ๒๕๔๕
steering pivot; steering swivel	เดือยบังคับเลี้ยว	๑๒ มี.ค. ๒๕๔๕
steering play	ระยะฟรีพวงมาลัย	๑๒ มี.ค. ๒๕๔๕
steering ratio	อัตราทดพวงมาลัย	๑๒ มี.ค. ๒๕๔๕
steering rod	ก้านต่อบังคับเลี้ยว	๑๒ มี.ค. ๒๕๔๕
steering shaft; steering column	แกนพวงมาลัย	๑๒ มี.ค. ๒๕๔๕
steering spindle	แกนล้อเลี้ยว	๑๒ มี.ค. ๒๕๔๕
steering swivel; steering pivot	เดือยบังคับเลี้ยว	๑๒ มี.ค. ๒๕๔๕
steering system	ระบบบังคับเลี้ยว	๑๒ มี.ค. ๒๕๔๕
steering wheel	พวงมาลัย	๑๒ มี.ค. ๒๕๔๕
stethoscope	เครื่องฟังตรวจ	๑๒ มี.ค. ๒๕๔๕
sticky clutch	คลัตช์ไม่จาก	๑๒ มี.ค. ๒๕๔๕
Stirling engine	เครื่องยนต์สเตอร์ลิง	๑๒ มี.ค. ๒๕๔๕
stoichiometric ratio	อัตราส่วนปริมาณสัมพันธ์	๑๒ มี.ค. ๒๕๔๕
stop light; brake light	ไฟเบรก	๑๒ มี.ค. ๒๕๔๕
stopping distance	ระยะหยุด	๑๒ มี.ค. ๒๕๔๕
straight eight/six	เครื่องยนต์แปดหรือหกสูบเรียง	๑๒ มี.ค. ๒๕๔๕
straight-cut gear; spur gear	เฟืองฟันตรง	๑๒ มี.ค. ๒๕๔๕
strainer	ตะแกรงกรอง	๑๒ มี.ค. ๒๕๔๕
strangler; choke	โช้ก	๑๒ มี.ค. ๒๕๔๕
strangler flap; choke flap	ลิ้นโช้ก	๑๒ มี.ค. ๒๕๔๕
stratified charge	ประจุไอดีเป็นชั้น	๑๒ มี.ค. ๒๕๔๕
streamlining	การทำให้เพรียวลม	๑๒ มี.ค. ๒๕๔๕
stroboscope	สตอรโบสโคป	๑๒ มี.ค. ๒๕๔๕
stroke	๑. ระยะชัก๒. จังหวะ	๑๒ มี.ค. ๒๕๔๕
striker plate	แผ่นรับกลอนประตู	๑๒ มี.ค. ๒๕๔๕
stroker kit	ชุดเพิ่มระยะชัก	๑๒ มี.ค. ๒๕๔๕
strut	ท่อนยึดปีกนกล่าง	๑๒ มี.ค. ๒๕๔๕
stub axle	แกนล้อ	๑๒ มี.ค. ๒๕๔๕
stud; stud bolt	สลักเกลียวสองปลาย	๑๒ มี.ค. ๒๕๔๕
stud bolt; stud	สลักเกลียวสองปลาย	๑๒ มี.ค. ๒๕๔๕
stud extractor	เครื่องมือถอนสลักขาด	๑๒ มี.ค. ๒๕๔๕
stumble	การสะดุด	๑๒ มี.ค. ๒๕๔๕
sub-frame	โครงย่อย	๑๒ มี.ค. ๒๕๔๕
suction stroke; inlet stroke; intake stroke	จังหวะดูด	๑๒ มี.ค. ๒๕๔๕
sun gear	เฟืองกลาง	๑๒ มี.ค. ๒๕๔๕
sunroof	หลังคารับแดด	๑๒ มี.ค. ๒๕๔๕
sump; oil pan; pan	อ่างน้ำมันเครื่อง	๑๒ มี.ค. ๒๕๔๕
superimposed pattern	แบบคลื่นเรียงซ้อนทับ	๑๒ มี.ค. ๒๕๔๕
supercharger	ตัวอัดบรรจุอากาศ	๑๒ มี.ค. ๒๕๔๕
surface grinder	เครื่องเจียผิวราบ	๑๒ มี.ค. ๒๕๔๕
surface ignition	การจุดระเบิดโดยผิวร้อน	๑๒ มี.ค. ๒๕๔๕
suspension system; suspension	ระบบรองรับ	๑๒ มี.ค. ๒๕๔๕
suspension; suspension system	ระบบรองรับ	๑๒ มี.ค. ๒๕๔๕
suspension arm; control arm; wishbone; wishbone arm	ปีกนก	๑๒ มี.ค. ๒๕๔๕
suspension damper; shock absorber	ตัวหน่วงการสั่นสะเทือน	๑๒ มี.ค. ๒๕๔๕
sway bar; antiroll bar; stabilizer; stabilizer bar	ท่อนกันโคลง	๑๒ มี.ค. ๒๕๔๕
swept volume	ปริมาตรช่วงชักลูกสูบ	๑๒ มี.ค. ๒๕๔๕
swing axle	เพลาขับแบบปีก	๑๒ มี.ค. ๒๕๔๕
swinging caliper	ก้ามปูเหวี่ยง	๑๒ มี.ค. ๒๕๔๕
swivel pin; king pin; knuckle pin	สลักล้อ	๑๒ มี.ค. ๒๕๔๕
synchronizer	ตัวประสานเฟือง	๑๒ มี.ค. ๒๕๔๕
synchromesh transmission	การส่งกำลังแบบประสานกัน, การส่งกำลังแบบซิงโครเมช	๑๒ มี.ค. ๒๕๔๕
synthetic oil	น้ำมันสังเคราะห์	๑๒ มี.ค. ๒๕๔๕
synthetic resin	เรซินสังเคราะห์	๑๒ มี.ค. ๒๕๔๕
tachometer	มาตรอัตรารอบ	๑๒ มี.ค. ๒๕๔๕
tail lamp; rear lamp	ไฟท้าย	๑๒ มี.ค. ๒๕๔๕
tail pipe	ท่อไอเสียท่อนปลาย	๑๒ มี.ค. ๒๕๔๕
tandem master cylinder	แม่ปั๊มเบรกแบบสองตอน	๑๒ มี.ค. ๒๕๔๕
tappet; lifter; valve lifter; valve tappet	ลูกกระทุ้งลิ้น	๑๒ มี.ค. ๒๕๔๕
TBI (throttle-body injection)	ทีบีไอ (การฉีดเข้าช่องลิ้นปีกผีเสื้อ)	๑๒ มี.ค. ๒๕๔๕
TDC (top dead center)	ทีดีซี (ศูนย์ตายบน)	๑๒ มี.ค. ๒๕๔๕
TEL (tetraethyl lead)	ทีอีแอล (เททระเอทิลเลด)	๑๒ มี.ค. ๒๕๔๕
telescopic damper; telescopic shock absorber	ตัวหน่วงการสั่นสะเทือนแบบกระบอก	๑๒ มี.ค. ๒๕๔๕
telescopic shock absorber; telescopic damper	ตัวหน่วงการสั่นสะเทือนแบบกระบอก	๑๒ มี.ค. ๒๕๔๕
telescopic steering column	แกนพวงมาลัยยืดหดได้แบบกระบอก	๑๒ มี.ค. ๒๕๔๕
tempered glass	กระจก(นิรภัย)แบบเทมเปอร์	๑๒ มี.ค. ๒๕๔๕
tetraethyl lead (TEL)	เททระเอทิลเลด (ทีอีแอล)	๑๒ มี.ค. ๒๕๔๕
thermactor; air-injection system	ระบบฉีดอากาศ	๑๒ มี.ค. ๒๕๔๕
thermal reactor	เครื่องปฏิกรณ์อุณหภาพ	๑๒ มี.ค. ๒๕๔๕
thermo-syphon	เทอร์มอไซฟอน	๑๒ มี.ค. ๒๕๔๕
thermostat	เทอร์มอสแตต	๑๒ มี.ค. ๒๕๔๕
thermostatic air cleaner; thermostatically controlled air cleaner	หม้อกรองอากาศควบคุมด้วยเทอร์มอสแตต	๑๒ มี.ค. ๒๕๔๕
thermostatic gauge	เกจเทอร์มอสแตต	๑๒ มี.ค. ๒๕๔๕
thermostatically controlled air cleaner; thermostatic air cleaner	หม้อกรองอากาศควบคุมด้วยเทอร์มอสแตต	๑๒ มี.ค. ๒๕๔๕
three-mode cycle	วัฏจักรสามแบบวิธี	๑๒ มี.ค. ๒๕๔๕
three-way catalytic converter (TWC)	เครื่องฟอกไอเสียเชิงเร่งปฏิกิริยาสามทาง, แคทาลิติกคอนเวอร์เตอร์สามทาง (ทีดับเบิลยูซี)	๑๒ มี.ค. ๒๕๔๕
throat	คอคอด	๑๒ มี.ค. ๒๕๔๕
throttle; butterfly valve; throttle plate; throttle valve	ลิ้นปีกผีเสื้อ	๑๒ มี.ค. ๒๕๔๕
throttle plate; butterfly valve; throttle; throttle valve	ลิ้นปีกผีเสื้อ	๑๒ มี.ค. ๒๕๔๕
throttle solenoid positioner	โซเลนอยด์ควบคุมตำแหน่งลิ้นปีกผีเสื้อ	๑๒ มี.ค. ๒๕๔๕
throttle valve; butterfly valve; throttle; throttle plate	ลิ้นปีกผีเสื้อ	๑๒ มี.ค. ๒๕๔๕
throttle-body injection (TBI)	การฉีดเข้าช่องลิ้นปีกปีเสื้อ (ทีบีไอ)	๑๒ มี.ค. ๒๕๔๕
throttle-return check	ตัวผ่อนการกลับของลิ้นปีกผีเสื้อ	๑๒ มี.ค. ๒๕๔๕
throttle-stop screw; slow-running screw	สกรูปรับเดินเบา	๑๒ มี.ค. ๒๕๔๕
throw	ระยะเหวี่ยง	๑๒ มี.ค. ๒๕๔๕
throwout bearing; clutch thrust bearing; release bearing; withdrawal bearing	ตลับลูกปืนคลัตช์	๑๒ มี.ค. ๒๕๔๕
thrust bearing	๑. ตลับลูกปืนกันรุน๒. รองลื่นกันรุน	๑๒ มี.ค. ๒๕๔๕
thrust washer	แหวนรองกันรุน	๑๒ มี.ค. ๒๕๔๕
tick-over; idle; idling	เดินเบา	๑๒ มี.ค. ๒๕๔๕
tie rod; track rod	คันส่ง	๑๒ มี.ค. ๒๕๔๕
tilt steering wheel	พวงมาลัยปรับมุม	๑๒ มี.ค. ๒๕๔๕
timer; distributor; ignition distributor	จานจ่าย	๑๒ มี.ค. ๒๕๔๕
timing advance	การตั้งไฟแก่, การปรับไฟแก่	๑๒ มี.ค. ๒๕๔๕
timing belt	สายพานเพลาลูกเบี้ยว	๑๒ มี.ค. ๒๕๔๕
timing chain	โซ่เพลาลูกเบี้ยว	๑๒ มี.ค. ๒๕๔๕
timing gear	เฟืองเพลาลูกเบี้ยว	๑๒ มี.ค. ๒๕๔๕
timing light	แสงตั้งไฟ	๑๒ มี.ค. ๒๕๔๕
timing mark	เครื่องหมายตั้งจังหวะ	๑๒ มี.ค. ๒๕๔๕
tire carcass; carcass; tire casing; tyre carcass; tyre casing	โครงยาง	๑๒ มี.ค. ๒๕๔๕
tire casing; carcass; tire carcass; tyre carcass; tyre casing	โครงยาง	๑๒ มี.ค. ๒๕๔๕
tire groove; tyre groove	ร่องยาง	๑๒ มี.ค. ๒๕๔๕
tire rotation; tyre rotation	การสลับยาง	๑๒ มี.ค. ๒๕๔๕
tire tread; tyre tread	ดอกยาง	๑๒ มี.ค. ๒๕๔๕
tire tube; inner tube; tyre tube	ยางใน	๑๒ มี.ค. ๒๕๔๕
toe contact; short toe contact	สัมผัสปลาย	๑๒ มี.ค. ๒๕๔๕
toe-in	โทอิน	๑๒ มี.ค. ๒๕๔๕
toe-out	โทเอาต์	๑๒ มี.ค. ๒๕๔๕
toe-out on turns	โทเอาต์ขณะเลี้ยว	๑๒ มี.ค. ๒๕๔๕
toothed belt; cog belt	สายพานร่องฟัน	๑๒ มี.ค. ๒๕๔๕
top dead center (TDC)	ศูนย์ตายบน (ทีดีซี)	๑๒ มี.ค. ๒๕๔๕
torque	ทอร์ก, แรงบิด	๑๒ มี.ค. ๒๕๔๕
torque converter	ทอร์กคอนเวอร์เตอร์	๑๒ มี.ค. ๒๕๔๕
torque test	การทดสอบทอร์ก	๑๒ มี.ค. ๒๕๔๕
torsion bar; torsion-bar spring	แท่งบิด, ทอร์ซันบาร์	๑๒ มี.ค. ๒๕๔๕
torsion bar steering gear	เฟืองบังคับเลี้ยวแบบแท่งบิด	๑๒ มี.ค. ๒๕๔๕
torsion-bar spring; torsion bar	แท่งบิด, ทอร์ซันบาร์	๑๒ มี.ค. ๒๕๔๕
toughened glass	กระจก(นิรภัย)แบบเหนียว :	๑๒ มี.ค. ๒๕๔๕
traction	แรงฉุดลาก	๑๒ มี.ค. ๒๕๔๕
tractive effort	ความสามารถฉุดลาก	๑๒ มี.ค. ๒๕๔๕
tractor	๑. หัวลาก๒. รถแทรกเตอร์	๑๒ มี.ค. ๒๕๔๕
tractor breakaway valve	ลิ้นนิรภัยเมื่อหัวลากหลุด	๑๒ มี.ค. ๒๕๔๕
track	ระยะล้อ	๑๒ มี.ค. ๒๕๔๕
track rod; tie rod	คันส่ง	๑๒ มี.ค. ๒๕๔๕
trailer	รถพ่วง	๑๒ มี.ค. ๒๕๔๕
trailing shoe	เกือกเบรกตาม, ฝักเบรกตาม	๑๒ มี.ค. ๒๕๔๕
transaxle	ชุดเพลาส่งกำลัง	๑๒ มี.ค. ๒๕๔๕
transmission	๑. ชุดส่งกำลัง๒. กระปุกเกียร์	๑๒ มี.ค. ๒๕๔๕
tread	๑. ดอกยาง๒. ระยะล้อ	๑๒ มี.ค. ๒๕๔๕
trip meter; trip odometer; trip recorder	มาตรเดินทาง	๑๒ มี.ค. ๒๕๔๕
trip odometer; trip meter; trip recorder	มาตรเดินทาง	๑๒ มี.ค. ๒๕๔๕
trip recorder; trip meter; trip odometer	มาตรเดินทาง	๑๒ มี.ค. ๒๕๔๕
trouble shooting	การหาเหตุแก้ไขข้อขัดข้อง	๑๒ มี.ค. ๒๕๔๕
truck tractor	หัวลาก	๑๒ มี.ค. ๒๕๔๕
trunk; boot	ห้องเก็บของ	๑๒ มี.ค. ๒๕๔๕
tube-and-fin-radiator	หม้อน้ำแบบท่อครีบ	๑๒ มี.ค. ๒๕๔๕
tubeless tire; tubeless tyre	ยางไร้ยางใน	๑๒ มี.ค. ๒๕๔๕
tubeless tyre; tubeless tire	ยางไร้ยางใน	๑๒ มี.ค. ๒๕๔๕
tune-up; tuning	การปรับแต่งเครื่องยนต์	๑๒ มี.ค. ๒๕๔๕
tuned intake system	ระบบ (ท่อร่วม) ไอดีแบบปรับแต่ง	๑๒ มี.ค. ๒๕๔๕
tuning; tune-up	การปรับแต่งเครื่องยนต์	๑๒ มี.ค. ๒๕๔๕
turbocharger	ตัวอัดบรรจุอากาศเทอร์โบ	๑๒ มี.ค. ๒๕๔๕
turn signal; directional signal	สัญญาณไฟเลี้ยว	๑๒ มี.ค. ๒๕๔๕
TWC (three-way catalytic converter)	ทีดับเบิลยูซี (เครื่องฟอกไอเสียเชิงเร่งปฏิกิริยาสามทาง, แคทาลิติกคอนเวอร์เตอร์สามทาง)	๑๒ มี.ค. ๒๕๔๕
turning circle	เส้นผ่านศูนย์กลางวงเลี้ยวแคบสุด	๑๒ มี.ค. ๒๕๔๕
turning radius	รัศมีเลี้ยว	๑๒ มี.ค. ๒๕๔๕
two-leading-shoe brakes	เบรกแบบเกือบนำสองตัว	๑๒ มี.ค. ๒๕๔๕
two-speed rear axle	เพลาท้ายทดความเร็วสองระดับ	๑๒ มี.ค. ๒๕๔๕
two cycle engine; two-stroke cycle engine; two-stroke engine	เครื่องยนต์สองจังหวะ	๑๒ มี.ค. ๒๕๔๕
two-stroke cycle engine; two cycle engine; two-stroke engine	เครื่องยนต์สองจังหวะ	๑๒ มี.ค. ๒๕๔๕
two-stroke engine; two cycle engine; two-stroke cycle engine	เครื่องยนต์สองจังหวะ	๑๒ มี.ค. ๒๕๔๕
two-wire system; insulated-return system	ระบบไฟสองสาย	๑๒ มี.ค. ๒๕๔๕
U-bolt	สลักเกลียวรูปตัวยู	๑๒ มี.ค. ๒๕๔๕
tyre carcass; carcass; tire carcass; tire casing; tyre casing	โครงยาง	๑๒ มี.ค. ๒๕๔๕
tyre casing; carcass; tire carcass; tire casing; tyre carcass	โครงยาง	๑๒ มี.ค. ๒๕๔๕
tyre groove; tire groove	ร่องยาง	๑๒ มี.ค. ๒๕๔๕
tyre rotation; tire rotation	การสลับยาง	๑๒ มี.ค. ๒๕๔๕
tyre tread; tire tread	ดอกยาง	๑๒ มี.ค. ๒๕๔๕
tyre tube; inner tube; tire tube	ยางใน	๑๒ มี.ค. ๒๕๔๕
ULG (unleaded gasolene)	ยูแอลจี (แกโซลีนไร้สารตะกั่ว)	๑๒ มี.ค. ๒๕๔๕
ULP (unleaded petrol)	ยูแอลดี (เบนซินไร้สารตะกั่ว)	๑๒ มี.ค. ๒๕๔๕
undercoat	สีรองหน้า	๑๒ มี.ค. ๒๕๔๕
undersquare engine	เครื่องยนต์ช่วงชักยาว	๑๒ มี.ค. ๒๕๔๕
understeer	ดื้อโค้ง	๑๒ มี.ค. ๒๕๔๕
unit power plant	ชุดเครื่องยนต์รวมระบบส่งกำลัง	๑๒ มี.ค. ๒๕๔๕
unitary construction; integral construction; monocoque; unitized body; unitized construction	ตัวถังแบบไร้โครง	๑๒ มี.ค. ๒๕๔๕
unitized body; integral construction; monocoque; unitary construction; unitized construction	ตัวถังแบบไร้โครง	๑๒ มี.ค. ๒๕๔๕
unitized construction; integral construction; monocoque; unitary construction; unitized body	ตัวถังแบบไร้โครง	๑๒ มี.ค. ๒๕๔๕
unitversal joint	ข้อต่อสากล, ข้อต่ออ่อน	๑๒ มี.ค. ๒๕๔๕
unleaded gasolene (ULG)	แกโซลีนไร้สารตะกั่ว (ยูแอลจี)	๑๒ มี.ค. ๒๕๔๕
unleaded petrol (ULP)	เบนซินไร้สารตะกั่ว (ยูแอลพี)	๑๒ มี.ค. ๒๕๔๕
unsprung weight	น้ำหนักนอกสปริง	๑๒ มี.ค. ๒๕๔๕
updraft carburetor; downdraught carburettor	คาร์บูเรเตอร์แบบดูดขึ้น	๑๒ มี.ค. ๒๕๔๕
upper beam; high beam; main beam	ไฟสูง	๑๒ มี.ค. ๒๕๔๕
upshift	เปลี่ยนเกียร์ขึ้น	๑๒ มี.ค. ๒๕๔๕
V-engine; V-type engine	เครื่องยนต์แบบรูปตัววี	๑๒ มี.ค. ๒๕๔๕
V-type engine; V-engine	เครื่องยนต์แบบรูปตัววี	๑๒ มี.ค. ๒๕๔๕
vacuum advance	๑. กลไกเร่งไฟสุญญากาศ๒. การเร่งไฟสุญญากาศ	๑๒ มี.ค. ๒๕๔๕
vacuum control unit	ชุดควบคุมสุญญากาศ	๑๒ มี.ค. ๒๕๔๕
vacuum gauge	เกจสุญญากาศ	๑๒ มี.ค. ๒๕๔๕
vacuum motor	มอเตอร์แบบสุญญากาศ	๑๒ มี.ค. ๒๕๔๕
vacuum pump; aspirator	ปั๊มสุญญากาศ	๑๒ มี.ค. ๒๕๔๕
vacuum servo	ระบบเซอร์โวสุญญากาศ	๑๒ มี.ค. ๒๕๔๕
vacuum switch	สวิตช์สุญญากาศ	๑๒ มี.ค. ๒๕๔๕
vacuum-control temperature-sensing valve	วาล์วควบคุมสุญญากาศด้วยอุณหภูมิ	๑๒ มี.ค. ๒๕๔๕
vacuum-control valve; coolant-overrid valve	ลิ้นช่องสุญญากาศ	๑๒ มี.ค. ๒๕๔๕
vacuum-suspended power brake	เบรกเสริมกำลังแบบหม้อสุญญากาศ	๑๒ มี.ค. ๒๕๔๕
valve	ลิ้น, วาล์ว	๑๒ มี.ค. ๒๕๔๕
valve cap	ฝาจุ๊บ	๑๒ มี.ค. ๒๕๔๕
valve clearance; rocker clearance; valve lash	ระยะตั้งลิ้น	๑๒ มี.ค. ๒๕๔๕
valve face	หน้าลิ้น	๑๒ มี.ค. ๒๕๔๕
valve float	ลิ้นลอย	๑๒ มี.ค. ๒๕๔๕
valve grinding	การเจียลิ้น	๑๒ มี.ค. ๒๕๔๕
valve guide; valve stem guide	ปลอกก้านลิ้น	๑๒ มี.ค. ๒๕๔๕
valve head	หัวลิ้น	๑๒ มี.ค. ๒๕๔๕
valve keeper; retainer lock; valve key; valve lock; valve-spring-retainer lock	ตัวประกบตีนลิ้น	๑๒ มี.ค. ๒๕๔๕
valve key; retainer lock; valve keeper; valve lock; valve-spring-retainer lock	ตัวประกบตีนลิ้น	๑๒ มี.ค. ๒๕๔๕
valve lash; rocker clearance; valve clearance	ระยะตั้งลิ้น	๑๒ มี.ค. ๒๕๔๕
valve lift	ช่วงยกลิ้น	๑๒ มี.ค. ๒๕๔๕
valve lifter; lifter; tappet; valve tappet	ลูกกระทุ้งลิ้น	๑๒ มี.ค. ๒๕๔๕
valve lock; retainer lock; valve keeper; valve key; valve-spring-retainer lock	ตัวประกบตีนลิ้น	๑๒ มี.ค. ๒๕๔๕
valve margin	ขอบลิ้น	๑๒ มี.ค. ๒๕๔๕
valve overlap	องศาลิ้นซ้อนเหลี่ยม	๑๒ มี.ค. ๒๕๔๕
valve rack	แท่นวางลิ้น	๑๒ มี.ค. ๒๕๔๕
valve refacer	เครื่องเจียหน้าลิ้น	๑๒ มี.ค. ๒๕๔๕
valve rotator	ตัวหมุนลิ้น	๑๒ มี.ค. ๒๕๔๕
valve seat	บ่าลิ้น	๑๒ มี.ค. ๒๕๔๕
valve spring retainer; spring retainer	ฐานสปริงลิ้น	๑๒ มี.ค. ๒๕๔๕
valve stem	ก้านลิ้น	๑๒ มี.ค. ๒๕๔๕
valve stem guide; valve guide	ปลอกก้านลิ้น	๑๒ มี.ค. ๒๕๔๕
valve stem seal	กันรั่วก้านลิ้น	๑๒ มี.ค. ๒๕๔๕
valve tappet; lifter; tappet; valve lifter	ลูกกระทุ้งลิ้น	๑๒ มี.ค. ๒๕๔๕
valve-seat recession	การสึกของบ่าลิ้น	๑๒ มี.ค. ๒๕๔๕
valve-spring-retainer lock; retainer lock; valve keeper; valve key; valve lock	ตัวประกบตีนลิ้น	๑๒ มี.ค. ๒๕๔๕
valve timing	การตั้งจังหวะการเปิดปิดลิ้น	๑๒ มี.ค. ๒๕๔๕
valve train	ขบวนเปิดปิดลิ้น	๑๒ มี.ค. ๒๕๔๕
valve-in-head engine	เครื่องยนต์แบบลิ้นในฝาสูบ	๑๒ มี.ค. ๒๕๔๕
valve-seat insert	แหวนบ่าลิ้น	๑๒ มี.ค. ๒๕๔๕
vapour lock	ไออุด	๑๒ มี.ค. ๒๕๔๕
vapour return line	ท่อไอเชื้อเพลิงกลับ	๑๒ มี.ค. ๒๕๔๕
vapour-recovery system; evaporative control system; fuel-vapour recovery system; vapour-saver system; vehicle vapour recovery	ระบบควบคุมการระเหย	๑๒ มี.ค. ๒๕๔๕
vapour-saver system; evaporative control system; fuel-vapour recovery system; vapour-recovery system; vehicle vapour recovery	ระบบควบคุมการระเหย	๑๒ มี.ค. ๒๕๔๕
vapour/fuel separator; vapour/liquid separator	ตัวแยกไอและเชื้อเพลิง	๑๒ มี.ค. ๒๕๔๕
vapour/liquid separator; vapour/fuel separator	ตัวแยกไอและเชื้อเพลิง	๑๒ มี.ค. ๒๕๔๕
variable-choke carburetor; variable-venturi carburetor	คาร์บูเรเตอร์แบบคอคอดแปรผันได้ [มีความหมายเหมือนกับ constant vacuum carburetor]	๑๒ มี.ค. ๒๕๔๕
variable-choke carburetor; variable-venturi carburetor	คาร์บูเรเตอร์แบบคอคอดแปรผันได้	๑๒ มี.ค. ๒๕๔๕
variable-ratio power steering	ระบบพวงมาลัยเสริมกำลังแบบอัตราทดแปรผันได้	๑๒ มี.ค. ๒๕๔๕
variable-speed fan	พัดลมอัตราเร็วแปรผันได้	๑๒ มี.ค. ๒๕๔๕
variable-venturi carburetor; variable-choke carburetor	คาร์บูเรเตอร์แบบคอคอดแปรผันได้ [มีความหมายเหมือนกับ constant vacuum carburetor]	๑๒ มี.ค. ๒๕๔๕
variable-venturi carburetor; variable-choke carburetor	คาร์บูเรเตอร์แบบคอคอดแปรผันได้	๑๒ มี.ค. ๒๕๔๕
vehicle identification number (VIN)	เลขตัวถัง (วีไอเอ็น)	๑๒ มี.ค. ๒๕๔๕
vehicle speed sensor (VSS)	ตัวรับรู้อัตราเร็วพาหนะ (วีเอสเอส)	๑๒ มี.ค. ๒๕๔๕
vehicle vapour recovery; evaporative control system; fuel-vapour recovery system; vapour-recovery system; vapour-saver system	ระบบควบคุมการระเหย	๑๒ มี.ค. ๒๕๔๕
vent; air vent	รูลม, รูหายใจ	๑๒ มี.ค. ๒๕๔๕
venturi	คอคอด, เวนจูริ	๑๒ มี.ค. ๒๕๔๕
venturi vacuum	สุญญากาศเวนจูริ	๑๒ มี.ค. ๒๕๔๕
VI (viscosity index)	วีไอ (ดรรชนีความหนืด)	๑๒ มี.ค. ๒๕๔๕
VIN (vehicle identification number)	วีไอเอ็น (เลขตัวถัง)	๑๒ มี.ค. ๒๕๔๕
viscometer; viscosimeter	มาตรความหนืด	๑๒ มี.ค. ๒๕๔๕
viscosimeter; viscometer	มาตรความหนืด	๑๒ มี.ค. ๒๕๔๕
viscosity	ความหนืด	๑๒ มี.ค. ๒๕๔๕
viscosity index (VI)	ดรรชนีความหนืด (วีไอ)	๑๒ มี.ค. ๒๕๔๕
viscosity rating	ค่าประเมินความหนืด	๑๒ มี.ค. ๒๕๔๕
voltage regulator	ตัวคุมค่าแรงเคลื่อนไฟฟ้า	๑๒ มี.ค. ๒๕๔๕
volume-control screw; idle-mixture screw; idling-mixture screw	สกรูปรับไอดีเดินเบา	๑๒ มี.ค. ๒๕๔๕
volumetric efficiency	ประสิทธิภาพเชิงปริมาตร	๑๒ มี.ค. ๒๕๔๕
VSS (vehicle speed sensor)	วีเอสเอส (ตัวรับรู้อัตราเร็วพาหนะ)	๑๒ มี.ค. ๒๕๔๕
wander	แฉลบ	๑๒ มี.ค. ๒๕๔๕
Wankel engine; Wankel rotary engine	เครื่องยนต์วังเกล	๑๒ มี.ค. ๒๕๔๕
Wankel rotary engine; Wankel engine	เครื่องยนต์วังเกล	๑๒ มี.ค. ๒๕๔๕
warning blinker	ไฟกะพริบฉุกเฉิน	๑๒ มี.ค. ๒๕๔๕
warning light	ไฟเตือน	๑๒ มี.ค. ๒๕๔๕
wastegate	ที่ผ่อนไอเสีย	๑๒ มี.ค. ๒๕๔๕
water jacket; cylinder jacket	ช่องน้ำเสื้อสูบ	๑๒ มี.ค. ๒๕๔๕
water-cooled engine	เครื่องยนต์ระบายความร้อนด้วยน้ำ	๑๒ มี.ค. ๒๕๔๕
water-temperature gauge	เกจอุณหภูมิน้ำ	๑๒ มี.ค. ๒๕๔๕
wear limit	ค่าจำกัดการสึกหรอ	๑๒ มี.ค. ๒๕๔๕
wedge combustion chamber	ห้องเผาไหม้ทรงลิ่ม	๑๒ มี.ค. ๒๕๔๕
welch plug; core hole plug; core plug; expansion plug; freeze plug	ปลั๊กตาน้ำ	๑๒ มี.ค. ๒๕๔๕
weigh distribution	การกระจายน้ำหนัก	๑๒ มี.ค. ๒๕๔๕
weight transfer effect	ผลการถ่ายโอนน้ำหนัก	๑๒ มี.ค. ๒๕๔๕
wet liner	ปลอกสูบแบบเปียก	๑๒ มี.ค. ๒๕๔๕
wet sump; wet-sump lubrication	การหล่อลื่นแบบอ่างน้ำมัน	๑๒ มี.ค. ๒๕๔๕
wet-disc clutch	คลัตช์แบบแผ่นเปียก	๑๒ มี.ค. ๒๕๔๕
wet-sump lubrication; wet sump	การหล่อลื่นแบบอ่างน้ำมัน	๑๒ มี.ค. ๒๕๔๕
wheel alignment	๑. การตั้งศูนย์ล้อ๒. ศูนย์ล้อ	๑๒ มี.ค. ๒๕๔๕
wheel balancer	เครื่องถ่วงล้อ	๑๒ มี.ค. ๒๕๔๕
wheel cylinder; brake cylinder; brake wheel cylinder; slave cylinder	ชุดกระบอกเบรก	๑๒ มี.ค. ๒๕๔๕
wheel wobble	ล้อส่าย	๑๒ มี.ค. ๒๕๔๕
wheel-slip; wheel-spin	ล้อหมุนฟรี	๑๒ มี.ค. ๒๕๔๕
wheel-spin; wheel-slip	ล้อหมุนฟรี	๑๒ มี.ค. ๒๕๔๕
wheelbase	ช่วงล้อ	๑๒ มี.ค. ๒๕๔๕
wide-open throttle (WOT)	ลิ้นปีกผีเสื้อเปิดสุด (ดับเบิลยูโอที)	๑๒ มี.ค. ๒๕๔๕
window regulator	กลไกเลื่อนกระจกขึ้นลง	๑๒ มี.ค. ๒๕๔๕
window stabilizer	ตัวกันกระจกโคลง	๑๒ มี.ค. ๒๕๔๕
window stop	ตัวหยุดกระจก	๑๒ มี.ค. ๒๕๔๕
windscreen; windshield	กระจกบังลมหน้า	๑๒ มี.ค. ๒๕๔๕
windshield; windscreen	กระจกบังลมหน้า	๑๒ มี.ค. ๒๕๔๕
wing nut	แป้นเกลียวปีก	๑๒ มี.ค. ๒๕๔๕
wiper arm	แขนปัดน้ำฝน	๑๒ มี.ค. ๒๕๔๕
wiper blade	ใบปัดน้ำฝน	๑๒ มี.ค. ๒๕๔๕
wire feeler gauge	เกจลวดสอด	๑๒ มี.ค. ๒๕๔๕
wiring diagram	แผนภาพระบบไฟ	๑๒ มี.ค. ๒๕๔๕
wiring harness; wiring loom	มัดสายไฟ	๑๒ มี.ค. ๒๕๔๕
wiring loom; wiring harness	มัดสายไฟ	๑๒ มี.ค. ๒๕๔๕
wishbone; control arm; suspension arm; wishbone arm	ปีกนก	๑๒ มี.ค. ๒๕๔๕
wishbone arm; control arm; suspension arm; wishbone	ปีกนก	๑๒ มี.ค. ๒๕๔๕
withdrawal bearing; clutch thrust bearing; release bearing; throwout bearing	ตลับลูกปืนคลัตช์	๑๒ มี.ค. ๒๕๔๕
wobble; runout	การส่าย	๑๒ มี.ค. ๒๕๔๕
worm-drive clip	ตัวรัดแบบเกลียวตัวหนอน	๑๒ มี.ค. ๒๕๔๕
WOT (wide-open throttle)	ดับเบิลยูโอที (ลิ้นปีกผีเสื้อเปิดสุด)	๑๒ มี.ค. ๒๕๔๕
wrist pin; gudgeon pin; piston pin	สลักลูกสูบ	๑๒ มี.ค. ๒๕๔๕
yoke	ก้ามปู	๑๒ มี.ค. ๒๕๔๕
zerk fitting	หัวอัดแบบเซิร์ก	๑๒ มี.ค. ๒๕๔๕
zone tempered glass	กระจก (นิรภัย) แบบโซนเทมเปอร์	๑๒ มี.ค. ๒๕๔๕
zone-toughened glass	กระจก (นิรภัย) แบบเหนียวเฉพาะส่วน[มีความหมายเหมือนกับ zone-toughened glass]	๑๒ มี.ค. ๒๕๔๕
ล็อก	lock	๑๒ มี.ค. ๒๕๔๕
ล็อกแกนพวงมาลัย	steering lock	๑๒ มี.ค. ๒๕๔๕
ล็อกกันเด็ก	childproof lock	๑๒ มี.ค. ๒๕๔๕
ล็อกพิเศษกันประตูเปิด	antiburst lock	๑๒ มี.ค. ๒๕๔๕
ลวดบัดกรีไส้กรด	acid core solder	๑๒ มี.ค. ๒๕๔๕
ล้อแม็ก	mag wheel	๑๒ มี.ค. ๒๕๔๕
ล้อหมุนฟรี	wheel-slip; wheel-spin	๑๒ มี.ค. ๒๕๔๕
ล้อส่าย	wheel wobble	๑๒ มี.ค. ๒๕๔๕
ล้อตาย	locking; locking of wheels	๑๒ มี.ค. ๒๕๔๕
ล้อตุนกำลัง	flywheel	๑๒ มี.ค. ๒๕๔๕
ล้อตุนกำลังแบบของไหล	fluid flywheel	๑๒ มี.ค. ๒๕๔๕
ล้อน็อตเดียว	knock-on wheel	๑๒ มี.ค. ๒๕๔๕
ล้อปรับสายพาน	jockey wheel	๑๒ มี.ค. ๒๕๔๕
ลอน	lobe	๑๒ มี.ค. ๒๕๔๕
ลักษณะผิวส้ม	orange peel	๑๒ มี.ค. ๒๕๔๕
ลายพิมพ์; พิมพ์ลาย	knurl	๑๒ มี.ค. ๒๕๔๕
ลิ่ม	key	๑๒ มี.ค. ๒๕๔๕
ลิ้น, วาล์ว	valve	๑๒ มี.ค. ๒๕๔๕
ลิ้นเม็ดกลม	ball valve	๑๒ มี.ค. ๒๕๔๕
ลิ้นระบายความดัน	pressure-relief valve; relief valve	๑๒ มี.ค. ๒๕๔๕
ลิ้นระบายความดันเพลา, ช่องหายใจเพลา	axle breather	๑๒ มี.ค. ๒๕๔๕
ลิ้นโช้ก	choke flap; strangler flap	๑๒ มี.ค. ๒๕๔๕
ลิ้นเตือนความดันตก	pressure-differential valve	๑๒ มี.ค. ๒๕๔๕
ลิ้นแบ่งความดัน	proportioning valve	๑๒ มี.ค. ๒๕๔๕
ลิ้นเบี่ยง	bypass valve	๑๒ มี.ค. ๒๕๔๕
ลิ้นเบี่ยงไอเสีย; เครื่องยนต์หมดกำลัง; สะพานไฟ	cut-out	๑๒ มี.ค. ๒๕๔๕
ลิ้นแบบใบอ่อน	reed valve	๑๒ มี.ค. ๒๕๔๕
ลิ้นเปลี่ยนเกียร์	shift valve	๑๒ มี.ค. ๒๕๔๕
ลิ้นเปลี่ยนเกียร์ไฮดรอลิก	hydraulic shift valve	๑๒ มี.ค. ๒๕๔๕
ลิ้นเปลี่ยนทางอากาศ	diverter valve	๑๒ มี.ค. ๒๕๔๕
ลิ้นเพิ่มอากาศ	hot-idle compensator	๑๒ มี.ค. ๒๕๔๕
ลิ้นรุทิ้ง	purge valve	๑๒ มี.ค. ๒๕๔๕
ลิ้นหมุน	rotary valve	๑๒ มี.ค. ๒๕๔๕
ลิ้นหลอดด้าย	spool valve	๑๒ มี.ค. ๒๕๔๕
ลิ้นหน่วงการเกิดประกายไฟ (เอสดีวี)	spark delay valve (SDV)	๑๒ มี.ค. ๒๕๔๕
ลิ้นอุ่นไอดี	heat control valve; manifold heat control valve	๑๒ มี.ค. ๒๕๔๕
ลิ้นลอย	valve float	๑๒ มี.ค. ๒๕๔๕
ลิ้นได้ดุล	balanced valve	๑๒ มี.ค. ๒๕๔๕
ลิ้นกระสวย	shuttle valve	๑๒ มี.ค. ๒๕๔๕
ลิ้นกันการจุดระเบิดย้อนกลับ	antibackfire valve; backfire-suppressor valve; gulp valve	๑๒ มี.ค. ๒๕๔๕
ลิ้นไฮดรอลิก	hydraulic valve	๑๒ มี.ค. ๒๕๔๕
ลิ้นไอดี	inlet valve; intake valve	๑๒ มี.ค. ๒๕๔๕
ลิ้นไล่อากาศ	air-bleed valve	๑๒ มี.ค. ๒๕๔๕
ลิ้นไล่ลม	bleeder valve	๑๒ มี.ค. ๒๕๔๕
ลิ้นกันกลับ	check valve; non-return valve	๑๒ มี.ค. ๒๕๔๕
ลิ้นกันกลับเม็ดกลม	ball check valve	๑๒ มี.ค. ๒๕๔๕
ลิ้นความดัน	pressure valve	๑๒ มี.ค. ๒๕๔๕
ลิ้นควบคุม	metering valve	๑๒ มี.ค. ๒๕๔๕
ลิ้นควบคุมการไถล	skid-control valve	๑๒ มี.ค. ๒๕๔๕
ลิ้นจำกัดความดัน	limiting valve; pressure-limiting valve	๑๒ มี.ค. ๒๕๔๕
ลิ้นช่องสุญญากาศ	coolant-override valve; vacuum-control valve	๑๒ มี.ค. ๒๕๔๕
ลิ้นดอกเห็ด	poppet valve	๑๒ มี.ค. ๒๕๔๕
ลิ้นติดเครื่องด้วยลม	air-starting valve	๑๒ มี.ค. ๒๕๔๕
ลิ้นนำ	pilot valve	๑๒ มี.ค. ๒๕๔๕
ลิ้นนิรภัยเมื่อหัวลากหลุด	tractor breakaway valve	๑๒ มี.ค. ๒๕๔๕
ลิ้นบังคับการไหลกลับ	rebound valve	๑๒ มี.ค. ๒๕๔๕
ลิ้นปีกผีเสื้อ	butterfly valve; throttle; throttle plate; throttle valve	๑๒ มี.ค. ๒๕๔๕
ลิ้นปีกผีเสื้อเปิดสุด (ดับเบิลยูโอที)	wide-open throttle (WOT)	๑๒ มี.ค. ๒๕๔๕
ลิ้นพีซีวี	PCV valve	๑๒ มี.ค. ๒๕๔๕
ลำดับการจุดระเบิด	firing order	๑๒ มี.ค. ๒๕๔๕
ลูกเบี้ยว	cam	๑๒ มี.ค. ๒๕๔๕
ลูกเบี้ยวเดินเบารอบสูง	fast-idle cam	๑๒ มี.ค. ๒๕๔๕
ลูกเบี้ยวเบรก	brake cam	๑๒ มี.ค. ๒๕๔๕
ลูกเบี้ยวจาน	eccentric	๑๒ มี.ค. ๒๕๔๕
ลูกเบี้ยวจานจ่าย	breaker cam; distributor cam	๑๒ มี.ค. ๒๕๔๕
(ข้อต่อ)ลูกหมาก	ball joint	๑๒ มี.ค. ๒๕๔๕
ลูกหมาก; สลักเกลียวสองปลายหัวมน	ball stud	๑๒ มี.ค. ๒๕๔๕
ลูกสูบ	piston	๑๒ มี.ค. ๒๕๔๕
ลูกสูบเสริมกำลัง	power piston	๑๒ มี.ค. ๒๕๔๕
ลูกสูบวงรี	cam-ground piston	๑๒ มี.ค. ๒๕๔๕
ลูกลอย	float	๑๒ มี.ค. ๒๕๔๕
ลูกกระทุ้งลิ้น	lifter; tappet; valve lifter; valve tappet	๑๒ มี.ค. ๒๕๔๕
ลูกกระทุ้งลิ้นแบบลูกกลิ้ง	roller tappet	๑๒ มี.ค. ๒๕๔๕
ลูกกระทุ้งลิ้นไฮดรอลิก	hydraulic lifter; hydraulic valve lifter	๑๒ มี.ค. ๒๕๔๕
ลูกตุ้มในจานจ่าย	distributor weights	๑๒ มี.ค. ๒๕๔๕
ลูกปืน; เม็ดกลม	ball	๑๒ มี.ค. ๒๕๔๕
ไวโค้ง	oversteer	๑๒ มี.ค. ๒๕๔๕
ไส้หม้อน้ำ	core	๑๒ มี.ค. ๒๕๔๕
ไส้หม้อน้ำแบบรังผึ้ง	ribbon-cellular radiator core	๑๒ มี.ค. ๒๕๔๕
ไส้กรอง	filter element	๑๒ มี.ค. ๒๕๔๕
ไส้กรอง; ตัวกรอง, หม้อกรอง	filter	๑๒ มี.ค. ๒๕๔๕
ไส้กรองชนิดสักหลาด	felt element	๑๒ มี.ค. ๒๕๔๕
ไส้กรองชนิดกระดาษ	paper element	๑๒ มี.ค. ๒๕๔๕
ไอเสีย	exhaust gases	๑๒ มี.ค. ๒๕๔๕
ไอเอชพี (แรงม้าบ่งชี้)	ihp (indicated horsepower)	๑๒ มี.ค. ๒๕๔๕
ไอเอฟเอส (ระบบรองรับล้อหน้าแบบอิสระ)	IFS (independent front suspension)	๑๒ มี.ค. ๒๕๔๕
ไออาร์เอส (ระบบรองรับล้อหลังแบบอิสระ)	IRS (independent rear suspension)	๑๒ มี.ค. ๒๕๔๕
ไออุด	vapour lock	๑๒ มี.ค. ๒๕๔๕
ไอดี	air-fuel mixture; fuel mixture; mixture	๑๒ มี.ค. ๒๕๔๕
ไอดีริมห้องเผาไหม้	end-gas	๑๒ มี.ค. ๒๕๔๕
ไอดีเดินเบา	idle mixture	๑๒ มี.ค. ๒๕๔๕
ไอดีหนา	rich mixture	๑๒ มี.ค. ๒๕๔๕
ไอดีหนาเกิน	loading; rich running	๑๒ มี.ค. ๒๕๔๕
ไอดีบาง	lean mixture	๑๒ มี.ค. ๒๕๔๕
ไอพี (กำลังบ่งชี้)	ip (indicated power)	๑๒ มี.ค. ๒๕๔๕
ไล่ลม	bleed	๑๒ มี.ค. ๒๕๔๕
ไขควง	screwdriver	๑๒ มี.ค. ๒๕๔๕
ไดอะแฟรม	diaphragm	๑๒ มี.ค. ๒๕๔๕
ไดนาโม	dynamo	๑๒ มี.ค. ๒๕๔๕
ไดนาโมมิเตอร์	dynamometer	๑๒ มี.ค. ๒๕๔๕
ไฟแก่, การจุดระเบิดก่อน	advanced ignition; advanced spark	๑๒ มี.ค. ๒๕๔๕
ไฟเก๋ง	courtesy light	๑๒ มี.ค. ๒๕๔๕
ไฟเตือน	warning light	๑๒ มี.ค. ๒๕๔๕
ไฟเตือนการจุดระเบิด	ignition warning light	๑๒ มี.ค. ๒๕๔๕
ไฟเตือนความดันน้ำมันเครื่อง	oil-pressure warning light	๑๒ มี.ค. ๒๕๔๕
ไฟเบรก	brake light; stop light	๑๒ มี.ค. ๒๕๔๕
ไฟเบอร์กลาสส์	fiberglass	๑๒ มี.ค. ๒๕๔๕
ไฟส่องป้าย	number-plate light	๑๒ มี.ค. ๒๕๔๕
ไฟสูง	high beam; main beam; upper beam	๑๒ มี.ค. ๒๕๔๕
ไฟหน้า	headlamp; headlight	๑๒ มี.ค. ๒๕๔๕
ไฟหน้าแฮโลเจน	halogen headlamp; halogen headlight	๑๒ มี.ค. ๒๕๔๕
ไฟหน้าผนึกสนิท	sealed-beam headlight	๑๒ มี.ค. ๒๕๔๕
ไฟอ่อน	retarded spark	๑๒ มี.ค. ๒๕๔๕
ไฟกะพริบฉุกเฉิน	warning blinker	๑๒ มี.ค. ๒๕๔๕
ไฟจอด	parking light; side-light	๑๒ มี.ค. ๒๕๔๕
ไฟชี้บอก	indicator light	๑๒ มี.ค. ๒๕๔๕
ไฟต่ำ	dipped headlight; low beam; lower beam	๑๒ มี.ค. ๒๕๔๕
ไฟตัดหมอก	fog lamp	๑๒ มี.ค. ๒๕๔๕
ไฟถอยหลัง	backup light; reversing light	๑๒ มี.ค. ๒๕๔๕
ไฟท้าย	rear lamp; tail lamp	๑๒ มี.ค. ๒๕๔๕
ไฟนำ	pilot light	๑๒ มี.ค. ๒๕๔๕
กระแสสลับ (เอซี)	alternating current (AC)	๑๒ มี.ค. ๒๕๔๕
กระแสไฟฟ้าแรงสูง	high-tension current	๑๒ มี.ค. ๒๕๔๕
กระแสไฟฟ้าแรงต่ำ	low-tension current	๑๒ มี.ค. ๒๕๔๕
กระแสปฐมภูมิ	primary current	๑๒ มี.ค. ๒๕๔๕
กระเดื่องกดลิ้น	finger; rocker; rocker arm	๑๒ มี.ค. ๒๕๔๕
กระโปรงลูกสูบ	piston skirt	๑๒ มี.ค. ๒๕๔๕
กระจก(นิรภัย)แบบเหนียว	toughened glass	๑๒ มี.ค. ๒๕๔๕
กระจก(นิรภัย)แบบเหนียวเฉพาะส่วน	zone-toughened glass	๑๒ มี.ค. ๒๕๔๕
กระจก(นิรภัย)แบบโซนเทมเปอร์	zone tempered glass	๑๒ มี.ค. ๒๕๔๕
กระจก(นิรภัย)แบบเทมเปอร์	tempered glass	๑๒ มี.ค. ๒๕๔๕
กระจก(นิรภัย)แบบอัดซ้อน	laminated glass; laminated safety glass	๑๒ มี.ค. ๒๕๔๕
กระจกหูช้าง	quarter light	๑๒ มี.ค. ๒๕๔๕
กระจกนิรภัย	safety glass	๑๒ มี.ค. ๒๕๔๕
กระจก(นิรภัย)แบบเหนียว	toughened glass	๑๒ มี.ค. ๒๕๔๕
กระจก(นิรภัย)แบบเหนียวเฉพาะส่วน	zone-toughened glass	๑๒ มี.ค. ๒๕๔๕
กระจก(นิรภัย)แบบโซนเทมเปอร์	zone tempered glass	๑๒ มี.ค. ๒๕๔๕
กระจก(นิรภัย)แบบเทมเปอร์	tempered glass	๑๒ มี.ค. ๒๕๔๕
กระจก(นิรภัย)แบบอัดซ้อน	laminated glass; laminated safety glass	๑๒ มี.ค. ๒๕๔๕
กระจกบังลมหน้า	windscreen; windshield	๑๒ มี.ค. ๒๕๔๕
กระดาษปิดกันสี	masking paper	๑๒ มี.ค. ๒๕๔๕
กระทะล้อร่องกลาง	drop-center wheel	๑๒ มี.ค. ๒๕๔๕
กระบอก; กระบอกสูบ	cylinder	๑๒ มี.ค. ๒๕๔๕
กระบอกสูบ; ท่อ	barrel	๑๒ มี.ค. ๒๕๔๕
กระบอกสูบเสริมกำลัง	power cylinder	๑๒ มี.ค. ๒๕๔๕
กระปุกเกียร์	gearbox	๑๒ มี.ค. ๒๕๔๕
กระปุกเกียร์; ชุดส่งกำลัง	transmission	๑๒ มี.ค. ๒๕๔๕
กระปุกเกียร์สี่ความเร็ว	four-speed gearbox	๑๒ มี.ค. ๒๕๔๕
กระปุกเกียร์ธรรมดา	manual gearbox	๑๒ มี.ค. ๒๕๔๕
กระปุกเฟืองพวงมาลัย	steering gear box	๑๒ มี.ค. ๒๕๔๕
กระปุกน้ำมันไฮดรอลิก	fluid reservoir	๑๒ มี.ค. ๒๕๔๕
กระปุกพวงมาลัย	steering box	๑๒ มี.ค. ๒๕๔๕
ก่อนศูนย์ตายบน (บีทีดีซี)	before top dead center (BTDC)	๑๒ มี.ค. ๒๕๔๕
ก้ามปู	yoke	๑๒ มี.ค. ๒๕๔๕
ก้ามปูเหวี่ยง	swinging caliper	๑๒ มี.ค. ๒๕๔๕
ก้ามปูเลื่อน	sliding caliper	๑๒ มี.ค. ๒๕๔๕
ก้ามปูเลือกเฟือง	selector fork	๑๒ มี.ค. ๒๕๔๕
ก้ามปูเบรกจานแบบสูบเดียว	single-piston caliper	๑๒ มี.ค. ๒๕๔๕
ก้ามปูลอย	floating caliper	๑๒ มี.ค. ๒๕๔๕
ก้ามปูคลัตช์	clutch fork	๑๒ มี.ค. ๒๕๔๕
ก้านเลือกเฟือง	selector rod	๑๒ มี.ค. ๒๕๔๕
ก้านวัดน้ำมันเครื่อง	dipstick; oil-level indicator	๑๒ มี.ค. ๒๕๔๕
ก้านควบคุมปริมาณเชื้อเพลิง	metering rod	๑๒ มี.ค. ๒๕๔๕
ก้านสูบ	connecting rod; con-rod	๑๒ มี.ค. ๒๕๔๕
ก้านลิ้น	valve stem	๑๒ มี.ค. ๒๕๔๕
ก้านลิ้นเยิน	mushroomed valve stem	๑๒ มี.ค. ๒๕๔๕
ก้านกระทุ้ง	push-rod	๑๒ มี.ค. ๒๕๔๕
ก้านต่อลอย	floating link	๑๒ มี.ค. ๒๕๔๕
ก้านต่อบังคับเลี้ยว	steering rod	๑๒ มี.ค. ๒๕๔๕
ก้านทองขาว	breaker arm	๑๒ มี.ค. ๒๕๔๕
กันรั่ว	seal	๑๒ มี.ค. ๒๕๔๕
กันรั่วก้านลิ้น	valve stem seal	๑๒ มี.ค. ๒๕๔๕
กันรั่วน้ำมันหล่อลื่น	oil seal	๑๒ มี.ค. ๒๕๔๕
กันชน	bumper	๑๒ มี.ค. ๒๕๔๕
กันชนเพรียวลม	aerobumper	๑๒ มี.ค. ๒๕๔๕
การเร่งไฟ	ignition advance; spark advance	๑๒ มี.ค. ๒๕๔๕
การเร่งไฟสุญญากาศ; กลไกเร่งไฟสุญญากาศ	vacuum advance	๑๒ มี.ค. ๒๕๔๕
การระเบิดรุนแรง	detonation	๑๒ มี.ค. ๒๕๔๕
การระบายไอห้องข้อเหวี่ยง	crankcase ventilation	๑๒ มี.ค. ๒๕๔๕
การระบายไอห้องข้อเหวี่ยงแบบปิด (พีซีวี)	positive crankcase ventilation (PCV)	๑๒ มี.ค. ๒๕๔๕
การเหยียบแช่คลัตช์	riding the clutch	๑๒ มี.ค. ๒๕๔๕
การให้แรงเสริมตัวเอง	self-energization	๑๒ มี.ค. ๒๕๔๕
การให้ภาระก่อน	preloading	๑๒ มี.ค. ๒๕๔๕
การเสียรูปของโครงยาง; จุดเครื่องยนต์เฉื่อย	flat spot	๑๒ มี.ค. ๒๕๔๕
การย้ำเบรกกันปัด	cadence braking; pump-braking	๑๒ มี.ค. ๒๕๔๕
การเหนี่ยวนำ; จังหวะดูด	induction	๑๒ มี.ค. ๒๕๔๕
การเหนี่ยวนำตัวเอง	self-induction	๑๒ มี.ค. ๒๕๔๕
การเอียงเลี้ยว	roll steer	๑๒ มี.ค. ๒๕๔๕
การเอียงตัว	banking	๑๒ มี.ค. ๒๕๔๕
การเอื้อต่อการขับขี่	driveability	๑๒ มี.ค. ๒๕๔๕
การเกิดแก๊ส	gassing	๑๒ มี.ค. ๒๕๔๕
การเกาะถนน	road-holding	๑๒ มี.ค. ๒๕๔๕
การเกิดคาร์บอน	carbonize	๑๒ มี.ค. ๒๕๔๕
การโคลง	roll	๑๒ มี.ค. ๒๕๔๕
การเจียลิ้น	valve grinding	๑๒ มี.ค. ๒๕๔๕
การเจือจางน้ำมันเครื่อง	oil dilution	๑๒ มี.ค. ๒๕๔๕
การเจือจางน้ำมันห้องข้อเหวี่ยง	crankcase dilution	๑๒ มี.ค. ๒๕๔๕
การเดือดค้าง	afterboil	๑๒ มี.ค. ๒๕๔๕
การเผาไหม้เสริม	afterburning	๑๒ มี.ค. ๒๕๔๕
การเผาไหม้ย้อนกลับ	blow-back; pop-back; popping back; spit-back	๑๒ มี.ค. ๒๕๔๕
การยุบของกระโปรงลูกสูบ	piston collapse	๑๒ มี.ค. ๒๕๔๕
การวางขวาง	east-west mounting	๑๒ มี.ค. ๒๕๔๕
การวินิจฉัย	diagnosis	๑๒ มี.ค. ๒๕๔๕
การสะดุด	stumble	๑๒ มี.ค. ๒๕๔๕
การสวมอัด	drive-fit; press-fit	๑๒ มี.ค. ๒๕๔๕
การสะท้านของเครื่อง	lugging	๑๒ มี.ค. ๒๕๔๕
การส่าย	runout; wobble	๑๒ มี.ค. ๒๕๔๕
การส่งกำลังแบบเฟืองขบคงตัว	constant mesh transmission	๑๒ มี.ค. ๒๕๔๕
การส่งกำลังแบบซิงโครเมช, การส่งกำลังแบบประสานกัน	synchromesh transmission	๑๒ มี.ค. ๒๕๔๕
การส่งกำลังทางเดียว	free-wheeling; overrunning coupling	๑๒ มี.ค. ๒๕๔๕
การสั่นแกว่ง	shimmy	๑๒ มี.ค. ๒๕๔๕
การสั่นกระตุก	judder	๑๒ มี.ค. ๒๕๔๕
การหาเหตุแก้ไขข้อขัดข้อง	trouble shooting	๑๒ มี.ค. ๒๕๔๕
การหล่อลื่น	lubrication	๑๒ มี.ค. ๒๕๔๕
การหล่อลื่นแบบวิดสาด	splash lubrication	๑๒ มี.ค. ๒๕๔๕
การหล่อลื่นแบบอ่างแห้ง	dry sump; dry sump lubrication	๑๒ มี.ค. ๒๕๔๕
การหล่อลื่นแบบอ่างน้ำมัน	wet sump; wet-sump lubrication	๑๒ มี.ค. ๒๕๔๕
การสลับยาง	tire rotation; tyre rotation	๑๒ มี.ค. ๒๕๔๕
การสึกเป็นร่องของสลักข้อเหวี่ยง	crankpin ridging	๑๒ มี.ค. ๒๕๔๕
การสึกของบ่าลิ้น	valve-seat recession	๑๒ มี.ค. ๒๕๔๕
การสึกจากการเลี้ยวรถ	cornering wear	๑๒ มี.ค. ๒๕๔๕
การอัดแบตเตอรี่, การประจุแบตเตอรี่	battery charging	๑๒ มี.ค. ๒๕๔๕
การอัดสูง	high compression	๑๒ มี.ค. ๒๕๔๕
การอัดไฟแบบกระแสคงตัว, การประจุแบบกระแสคงตัว	constant-current charging	๑๒ มี.ค. ๒๕๔๕
การล้างระบบน้ำมันเบรก	brake flushing	๑๒ มี.ค. ๒๕๔๕
การล้างสวนทาง	reverse flushing	๑๒ มี.ค. ๒๕๔๕
การล้างอย่างเร็ว	fast flushing	๑๒ มี.ค. ๒๕๔๕
การลบมุม	chamfer	๑๒ มี.ค. ๒๕๔๕
การไหลซึม	percolation	๑๒ มี.ค. ๒๕๔๕
การไล่ลมเบรก	brake bleeding	๑๒ มี.ค. ๒๕๔๕
การไล่ลมเบรกด้วยคันเหยียบ	pedal bleeding	๑๒ มี.ค. ๒๕๔๕
การไล่ไอเสีย	scavenging	๑๒ มี.ค. ๒๕๔๕
การไถลบนพื้นเปียก	aquaplaning	๑๒ มี.ค. ๒๕๔๕
การกระจายน้ำหนัก	weight distribution	๑๒ มี.ค. ๒๕๔๕
การกระชาก	power hop	๑๒ มี.ค. ๒๕๔๕
การขัดแต่งเข้าที่	bedding-in	๑๒ มี.ค. ๒๕๔๕
การขับสี่ล้อ	four-wheel drive	๑๒ มี.ค. ๒๕๔๕
การขาดเชื้อเพลิง	fuel starvation	๑๒ มี.ค. ๒๕๔๕
การขบของฟันเฟือง	meshing	๑๒ มี.ค. ๒๕๔๕
การคว้านกระบอกสูบ	boring; rebore; reboring	๑๒ มี.ค. ๒๕๔๕
การควบคุมให้เหมาะ; การปรับให้เหมาะ	metering	๑๒ มี.ค. ๒๕๔๕
การควบคุมไอเสีย	emission control	๑๒ มี.ค. ๒๕๔๕
การควบคุมการจุดระเบิดแบบอิเล็กทรอนิกส์ (อีเอสซี)	electronic spark control (ESC)	๑๒ มี.ค. ๒๕๔๕
การคืนล้อสู่แนวตรงอัตโนมัติ	automatic steering effect	๑๒ มี.ค. ๒๕๔๕
การจุดระเบิดย้อนกลับ	backfire	๑๒ มี.ค. ๒๕๔๕
การจุดระเบิดเอง	autoignition	๑๒ มี.ค. ๒๕๔๕
การจุดระเบิดโดยผิวร้อน	surface ignition	๑๒ มี.ค. ๒๕๔๕
การจุดระเบิดในท่อไอเสีย	afterfire	๑๒ มี.ค. ๒๕๔๕
การจุดระเบิดแบบไร้จานจ่าย	distributorless ignition	๑๒ มี.ค. ๒๕๔๕
การจุดระเบิดแบบไร้ทองขาว	breakerless ignition	๑๒ มี.ค. ๒๕๔๕
การจุดระเบิดไม่ครบสูบ	misfire	๑๒ มี.ค. ๒๕๔๕
การจุดระเบิดก่อน, ไฟแก่	advanced ignition; advanced spark	๑๒ มี.ค. ๒๕๔๕
การจุดระเบิดด้วยคอยล์	coil ignition	๑๒ มี.ค. ๒๕๔๕
การจุดระเบิดด้วยตัวเก็บประจุ (ซีดีไอ)	capacitor-discharge ignition (CDI)	๑๒ มี.ค. ๒๕๔๕
การจุดไฟ, การติดไฟ; การจุดระเบิด	ignition	๑๒ มี.ค. ๒๕๔๕
การฉีดแยกช่องไอดี	multiple-point injection; port injection	๑๒ มี.ค. ๒๕๔๕
การฉีดเบนซิน	petrol injection	๑๒ มี.ค. ๒๕๔๕
การฉีดแบบลูกสูบอัด	solid injection	๑๒ มี.ค. ๒๕๔๕
การฉีดจุดเดียว	single-point injection	๑๒ มี.ค. ๒๕๔๕
การฉีดน้ำมันไขว้	cross-fire injection	๑๒ มี.ค. ๒๕๔๕
การฉาบสารขัดถู	abrasive coating	๑๒ มี.ค. ๒๕๔๕
การฉีดเข้าช่องลิ้นปีกผีเสื้อ (ทีบีไอ)	throttle-body injection (TBI)	๑๒ มี.ค. ๒๕๔๕
การชิงจุดระเบิด	pre-ignition	๑๒ มี.ค. ๒๕๔๕
การต่อประกบ; คู่ต่อประกบ, ชุดต่อประกบ	coupling	๑๒ มี.ค. ๒๕๔๕
การตั้งศูนย์ล้อ; ศูนย์ล้อ	wheel alignment	๑๒ มี.ค. ๒๕๔๕
การตั้งไฟแก่, การปรับไฟแก่	timing advance	๑๒ มี.ค. ๒๕๔๕
การตั้งไฟอ่อน, การปรับไฟอ่อน	ignition retard	๑๒ มี.ค. ๒๕๔๕
การตั้งไฟจุดระเบิด	ignition timing	๑๒ มี.ค. ๒๕๔๕
การตั้งจังหวะการเปิดปิดลิ้น	valve timing	๑๒ มี.ค. ๒๕๔๕
การติดไฟ, การจุดไฟ; การจุดระเบิด	ignition	๑๒ มี.ค. ๒๕๔๕
การทำให้เป็นละออง	atomization	๑๒ มี.ค. ๒๕๔๕
การทำให้สึกเข้าที่	break-in	๑๒ มี.ค. ๒๕๔๕
การทำให้เพรียวลม	streamlining	๑๒ มี.ค. ๒๕๔๕
การทำวงเลี้ยวแคบสุด	full lock	๑๒ มี.ค. ๒๕๔๕
การทดสอบโดยไม่มีภาระ	no-load test	๑๒ มี.ค. ๒๕๔๕
การทดสอบโดยจ่ายไฟกระแสสูง	high-discharge test	๑๒ มี.ค. ๒๕๔๕
การทดสอบขณะหยุดหมุน	stall test	๑๒ มี.ค. ๒๕๔๕
การทดสอบประกายไฟ	spark test	๑๒ มี.ค. ๒๕๔๕
การทดสอบทอร์ก	torque test	๑๒ มี.ค. ๒๕๔๕
การบังคับเลี้ยวไถล	drifting	๑๒ มี.ค. ๒๕๔๕
การบำรุงรักษาแบบป้องกัน	preventive maintenance	๑๒ มี.ค. ๒๕๔๕
การบดผิว, การบดวาล์ว	lapping	๑๒ มี.ค. ๒๕๔๕
การประจุแบตเตอรี่, การอัดแบตเตอรี่	battery charging	๑๒ มี.ค. ๒๕๔๕
การประจุแบบกระแสคงตัว, การอัดไฟแบบกระแสคงตัว	constant-current charging	๑๒ มี.ค. ๒๕๔๕
การปรับให้เหมาะ, การควบคุมให้เหมาะ	metering	๑๒ มี.ค. ๒๕๔๕
การปรับแต่งเครื่องยนต์	tune-up; tuning	๑๒ มี.ค. ๒๕๔๕
การปรับแนว	alignment	๑๒ มี.ค. ๒๕๔๕
การปรับไฟแก่อัตโนมัติ	automatic advance	๑๒ มี.ค. ๒๕๔๕
การปะยางแบบเย็น	cold patching	๑๒ มี.ค. ๒๕๔๕
การปะยางแบบร้อน	hot patching	๑๒ มี.ค. ๒๕๔๕
การปรบแต่งช่องไอดีไอเสีย	porting	๑๒ มี.ค. ๒๕๔๕
การปักแล้วเงย	pitching	๑๒ มี.ค. ๒๕๔๕
การปีนตามแนวรัศมี	radius ride	๑๒ มี.ค. ๒๕๔๕
การปล่อยประจุเอง	self-discharge	๑๒ มี.ค. ๒๕๔๕
การผสมน้ำมันกับอากาศ	carburetion	๑๒ มี.ค. ๒๕๔๕
กำลังรวบยอด	gross power	๑๒ มี.ค. ๒๕๔๕
กำลังเสียดทาน	friction power	๑๒ มี.ค. ๒๕๔๕
กำลังสุทธิ	net power	๑๒ มี.ค. ๒๕๔๕
กำลังเครื่องยนต์	engine power	๑๒ มี.ค. ๒๕๔๕
กำลังเพลา (บีพี)	brake power (bp)	๑๒ มี.ค. ๒๕๔๕
กำลังบ่งชี้ (ไอพี)	indicated power (ip)	๑๒ มี.ค. ๒๕๔๕
กำลังตามโฆษณา	advertised power	๑๒ มี.ค. ๒๕๔๕
กากบาท	spider	๑๒ มี.ค. ๒๕๔๕
กาบรองลื่น; ปลอกสูบ	liner	๑๒ มี.ค. ๒๕๔๕
กาบรองลื่นผ่าครึ่ง	half-liners	๑๒ มี.ค. ๒๕๔๕
กล่องควบคุม	control box	๑๒ มี.ค. ๒๕๔๕
กล่องดักไอน้ำมัน	canister	๑๒ มี.ค. ๒๕๔๕
กล่องดักไอน้ำมันแบบใช้ถ่าน	carbon canister; charcoal canister	๑๒ มี.ค. ๒๕๔๕
กล่องฟิวส์	fuse box	๑๒ มี.ค. ๒๕๔๕
กลไกเร่งไฟ	advance mechanism ignition advance mechanism; spark advance mechanism	๑๒ มี.ค. ๒๕๔๕
กลไกเร่งไฟสุญญากาศ; การเร่งไฟสุญญากาศ	vacuum advance	๑๒ มี.ค. ๒๕๔๕
กลไกเร่งไฟสุญญากาศไดอะแฟรมคู่	dual-diaphragm vacuum advance	๑๒ มี.ค. ๒๕๔๕
กลไกเลื่อนกระจกขึ้นลง	window regulator	๑๒ มี.ค. ๒๕๔๕
กลไกเลือกเกียร์	selector mechanism	๑๒ มี.ค. ๒๕๔๕
กลไกก้านต่อแบบขนาน	parallelogram linkage	๑๒ มี.ค. ๒๕๔๕
กลไกก้านต่อก้าวหน้า	progressive linkage	๑๒ มี.ค. ๒๕๔๕
ข้อเหวี่ยง	crank	๑๒ มี.ค. ๒๕๔๕
ข้อสัมผัส, เจอร์นัล	journal	๑๒ มี.ค. ๒๕๔๕
ข้อสัมผัสหลัก, เจอร์นัลหลัก	main journal	๑๒ มี.ค. ๒๕๔๕
ข้อต่อร่องฟัน	spline joint	๑๒ มี.ค. ๒๕๔๕
ข้อต่อเลื่อน	sliding joint; slip joint	๑๒ มี.ค. ๒๕๔๕
ข้อต่อสากล, ข้อต่ออ่อน	universal joint	๑๒ มี.ค. ๒๕๔๕
ข้อต่อฮุก	Hooke joint	๑๒ มี.ค. ๒๕๔๕
ข้อต่อลมเบรก	glad hand	๑๒ มี.ค. ๒๕๔๕
(ข้อต่อ)ลูกหมาก	ball joint	๑๒ มี.ค. ๒๕๔๕
ขอบในยางนอก	bead	๑๒ มี.ค. ๒๕๔๕
ขอบในของกระบอกสูบ	ring ridge	๑๒ มี.ค. ๒๕๔๕
ขอบล้อ	rim	๑๒ มี.ค. ๒๕๔๕
ขอบลิ้น	valve margin	๑๒ มี.ค. ๒๕๔๕
ขั้วลบ	negative pole; negative terminal	๑๒ มี.ค. ๒๕๔๕
ขั้วลบลงดิน	negative earth; negative ground	๑๒ มี.ค. ๒๕๔๕
ขั้วไฟฟ้า	electrode	๑๒ มี.ค. ๒๕๔๕
ขั้วดิน, เขี้ยวหัวเทียน	earth electrode	๑๒ มี.ค. ๒๕๔๕
ขั้วต่อขดลวดสนามแม่เหล็ก	field terminal	๑๒ มี.ค. ๒๕๔๕
ขั้วบวก	positive pole; positive terminal	๑๒ มี.ค. ๒๕๔๕
ขาไก่	drop arm	๑๒ มี.ค. ๒๕๔๕
ขี้น้ำมัน, ยางน้ำมัน	gum	๑๒ มี.ค. ๒๕๔๕
ขาตั้งรับรถ	car stand; jack stand; safety stand	๑๒ มี.ค. ๒๕๔๕
ขาตั้งรับเพลา	axle stand	๑๒ มี.ค. ๒๕๔๕
ขดลวดเหนี่ยวนำ	induction coil	๑๒ มี.ค. ๒๕๔๕
ขดลวดสนามแม่เหล็ก	field coil; field winding	๑๒ มี.ค. ๒๕๔๕
ขดลวดจ่ายศักย์เหนี่ยวนำ	pickup coil	๑๒ มี.ค. ๒๕๔๕
ขดลวดปฐมภูมิ	primary winding	๑๒ มี.ค. ๒๕๔๕
ขนาดกระบอกสูบ	bore; cylinder bore	๑๒ มี.ค. ๒๕๔๕
ขบวนเปิดปิดลิ้น	valve train	๑๒ มี.ค. ๒๕๔๕
ขบวนเฟือง	gear train	๑๒ มี.ค. ๒๕๔๕
ขบวนเฟืองแพลเนต	planetary gear train	๑๒ มี.ค. ๒๕๔๕
ขบวนส่งกำลัง	drive train; power train	๑๒ มี.ค. ๒๕๔๕
ครีบ	fin	๑๒ มี.ค. ๒๕๔๕
คว้านกระบอกสูบ	bore out	๑๒ มี.ค. ๒๕๔๕
ความเร่ง	acceleration	๑๒ มี.ค. ๒๕๔๕
ควันในไอเสีย	smoke in exhaust	๑๒ มี.ค. ๒๕๔๕
ความเร็วรถทางทฤษฎี	geared speed	๑๒ มี.ค. ๒๕๔๕
ความเสียดทานสถิต	static friction	๑๒ มี.ค. ๒๕๔๕
ความเอียงแกนบังคับเลี้ยว	steering axis inclination	๑๒ มี.ค. ๒๕๔๕
ความเอียงสลักล้อ	king pin inclination	๑๒ มี.ค. ๒๕๔๕
ความยาวเกลียวหัวเทียน	reach	๑๒ มี.ค. ๒๕๔๕
ความเบี้ยวจากแนวรัศมี, ความส่ายจากแนวรัศมี	radial runout	๑๒ มี.ค. ๒๕๔๕
ความส่ายจากแนวรัศมี, ความเบี้ยวจากแนวรัศมี	radial runout	๑๒ มี.ค. ๒๕๔๕
ความสามารถไต่ความชันได้	gradeability	๑๒ มี.ค. ๒๕๔๕
ความสามารถฉุดลาก	tractive effort	๑๒ มี.ค. ๒๕๔๕
ความสูงภาคตัด	section height	๑๒ มี.ค. ๒๕๔๕
ความหนาของสี	paint film	๑๒ มี.ค. ๒๕๔๕
ความหนืด	viscosity	๑๒ มี.ค. ๒๕๔๕
ความไวปฏิกิริยาไฮโดรคาร์บอน	hydrocarbon reactivity	๑๒ มี.ค. ๒๕๔๕
ความกว้างภาคตัด	section width	๑๒ มี.ค. ๒๕๔๕
ความจุแอมแปร์-ชั่วโมง	ampere-hour capacity	๑๒ มี.ค. ๒๕๔๕
ความจุเครื่องยนต์	displacement; engine displacement	๑๒ มี.ค. ๒๕๔๕
ความจุห้องเดี่ยว	single-chamber capacity	๑๒ มี.ค. ๒๕๔๕
ความจุสำรอง	reserve capacity	๑๒ มี.ค. ๒๕๔๕
ความจุกระบอกสูบ	piston displacement	๑๒ มี.ค. ๒๕๔๕
ความดันเสริมในท่อร่วมไอดี	boost pressure; manifold pressure	๑๒ มี.ค. ๒๕๔๕
ความดันสัมบูรณ์	absolute pressure	๑๒ มี.ค. ๒๕๔๕
ความดันเกจ	gauge pressure	๑๒ มี.ค. ๒๕๔๕
ความดันอัด	compression pressure	๑๒ มี.ค. ๒๕๔๕
ความดันอากาศ	air pressure	๑๒ มี.ค. ๒๕๔๕
ความดันประสิทธิผลเฉลี่ยสำหรับแรงม้าเพลา (บีเอ็มอีพี)	brake mean effective pressure (bmep)	๑๒ มี.ค. ๒๕๔๕
ความดันต้านกลับ	back pressure	๑๒ มี.ค. ๒๕๔๕
ความต้านลม; แรงต้านลม	air resistance	๑๒ มี.ค. ๒๕๔๕
ความต้านทานการขัดถู	abrasion resistance	๑๒ มี.ค. ๒๕๔๕
ความปลอดภัยด้วยตัวเอง, ความปลอดภัยแบบกสานติ์	passive safety	๑๒ มี.ค. ๒๕๔๕
ค่าความร้อน	calorific value	๑๒ มี.ค. ๒๕๔๕
ค่าจำกัดการสึกหรอ	wear limit	๑๒ มี.ค. ๒๕๔๕
ค่าประเมินออกเทน	octane rating	๑๒ มี.ค. ๒๕๔๕
ค่าประเมินกันน็อก	antiknock rating	๑๒ มี.ค. ๒๕๔๕
ค่าประเมินความแข็งแรงชั้นโครงสร้างยางรถ (พีอาร์)	ply rating (PR)	๑๒ มี.ค. ๒๕๔๕
ค่าประเมินความหนืด	viscosity rating	๑๒ มี.ค. ๒๕๔๕
ค่าประเมินน้ำมันเครื่อง	service rating	๑๒ มี.ค. ๒๕๔๕
คอยล์จุดระเบิด	ignition coil	๑๒ มี.ค. ๒๕๔๕
คอคอด	throat	๑๒ มี.ค. ๒๕๔๕
คอคอด, เวนจูริ	venturi	๑๒ มี.ค. ๒๕๔๕
คอคอดทุติยภูมิ	secondary venturi	๑๒ มี.ค. ๒๕๔๕
คันเร่ง	accelerator; accelerator pedal	๑๒ มี.ค. ๒๕๔๕
คันเหยียบเบรกหยุ่นตัว	spongy brake pedal; spongy pedal	๑๒ มี.ค. ๒๕๔๕
คันเหยียบคลัตช์	clutch pedal	๑๒ มี.ค. ๒๕๔๕
คันเกียร์	gear lever; shift lever	๑๒ มี.ค. ๒๕๔๕
คันส่ง	tie rod; track rod	๑๒ มี.ค. ๒๕๔๕
คันดึง	drag link	๑๒ มี.ค. ๒๕๔๕
คาร์บอนมอนอกไซด์	carbon monoxide	๑๒ มี.ค. ๒๕๔๕
คาร์บูเรเตอร์	carburetor; carburettor	๑๒ มี.ค. ๒๕๔๕
คาร์บูเรเตอร์แบบสี่ท่อ	four-barrel carburetor	๑๒ มี.ค. ๒๕๔๕
คาร์บูเรเตอร์แบบสุญญากาศคงตัว	constant vacuum carburetor	๑๒ มี.ค. ๒๕๔๕
คาร์บูเรเตอร์แบบคอคอดแปรผันได้	variable-choke carburetor; variable-venturi carburetor	๑๒ มี.ค. ๒๕๔๕
คาร์บูเรเตอร์แบบดูดลง	downdraft carburetor; downdraught carbuerttor	๑๒ มี.ค. ๒๕๔๕
คาร์บูเรเตอร์แบบดูดขึ้น	updraft carburetor; updraught carburettor	๑๒ มี.ค. ๒๕๔๕
คาร์บูเรเตอร์แบบนมหนูคงที่	fixed-jet carburetor	๑๒ มี.ค. ๒๕๔๕
คาร์บูเรเตอร์แบบป้อนกลับ	feedback carburetor	๑๒ มี.ค. ๒๕๔๕
คาร์บูเรเตอร์ได้ดุล	balanced carburetor	๑๒ มี.ค. ๒๕๔๕
คาร์บูเรเตอร์คู่	dual carbuertors	๑๒ มี.ค. ๒๕๔๕
คิกดาวน์	kick-down	๑๒ มี.ค. ๒๕๔๕
คู่ต่อประกบ, ชุดต่อประกบ; การต่อประกบ	coupling	๑๒ มี.ค. ๒๕๔๕
คู่ต่อประกบวงแหวน, ชุดต่อประกบวงแหวน	doughnut coupling	๑๒ มี.ค. ๒๕๔๕
คลัตช์	clutch	๑๒ มี.ค. ๒๕๔๕
คลัตช์แม่เหล็ก	magnetic clutch	๑๒ มี.ค. ๒๕๔๕
คลัตช์เสียดสี	clutch drag	๑๒ มี.ค. ๒๕๔๕
คลัตช์แบบแผ่นแห้ง	dry-disc clutch	๑๒ มี.ค. ๒๕๔๕
คลัตช์แบบแผ่นเปียก	wet-disc clutch	๑๒ มี.ค. ๒๕๔๕
คลัตช์แบบหลายแผ่น	multiple-disc clutch; multiple-plate clutch	๑๒ มี.ค. ๒๕๔๕
คลัตช์แบบสปริงไดอะแฟรม	diaphragm-spring clutch	๑๒ มี.ค. ๒๕๔๕
คลัตช์สปริงขด	coil-spring clutch	๑๒ มี.ค. ๒๕๔๕
คลัตช์ลื่น	clutch slip	๑๒ มี.ค. ๒๕๔๕
คลัตช์ไม่จาก	sticky clutch	๑๒ มี.ค. ๒๕๔๕
คลัตช์ไฮดรอลิก	hydraulic clutch	๑๒ มี.ค. ๒๕๔๕
คลัตช์ทางเดียว	free-wheel; one-way clutch; overrun clutch; overrunning clutch	๑๒ มี.ค. ๒๕๔๕
คลัตช์ทางเดียวแบบค้ำยัน	sprag clutch	๑๒ มี.ค. ๒๕๔๕
คลัตช์ฟัน	dog clutch	๑๒ มี.ค. ๒๕๔๕
คุณภาพรถบนถนน	roadability	๑๒ มี.ค. ๒๕๔๕
จังหวะอัด	compression stroke	๑๒ มี.ค. ๒๕๔๕
จังหวะกำลัง	power stroke	๑๒ มี.ค. ๒๕๔๕
จังหวะ; ระยะชัก	stroke	๑๒ มี.ค. ๒๕๔๕
จังหวะดูด	inlet stroke; intake stroke; suction stroke	๑๒ มี.ค. ๒๕๔๕
จังหวะดูด; การเหนี่ยวนำ	induction	๑๒ มี.ค. ๒๕๔๕
จาระบี	grease	๑๒ มี.ค. ๒๕๔๕
จาระบีแกรไฟต์	graphite grease	๑๒ มี.ค. ๒๕๔๕
จีวีดับเบิลยู (น้ำหนักยานยนต์รวบยอด)	GVW (gross vehicle weight)	๑๒ มี.ค. ๒๕๔๕
จีซีดับเบิลยู (น้ำหนักรวมรวบยอด)	GCW (gross combination weight)	๑๒ มี.ค. ๒๕๔๕
จีที (รถเก๋งหรูสมรรถนะสูง)	GT (Grand Touring; Gran Turismo)	๑๒ มี.ค. ๒๕๔๕
จานเบรก	brake disc	๑๒ มี.ค. ๒๕๔๕
จำนวนแอมแปร์	amperage	๑๒ มี.ค. ๒๕๔๕
จานจ่าย	distributor; ignition distributor; timer	๑๒ มี.ค. ๒๕๔๕
จานทองขาว	distributor plate	๑๒ มี.ค. ๒๕๔๕
จานที่ห้า	fifth wheel	๑๒ มี.ค. ๒๕๔๕
จุกเกลียวถ่าย	drain-plug	๑๒ มี.ค. ๒๕๔๕
จุดเริ่มไหล	pour point	๑๒ มี.ค. ๒๕๔๕
จุดร้อน	hot spot	๑๒ มี.ค. ๒๕๔๕
จุดเครื่องยนต์เฉื่อย; การเสียรูปของโครงยาง	flat spot	๑๒ มี.ค. ๒๕๔๕
จุดวาบไฟ	flash point	๑๒ มี.ค. ๒๕๔๕
จุดขึ้นแม่แรง	jacking point	๑๒ มี.ค. ๒๕๔๕
จุดติดไฟ	fire point	๑๒ มี.ค. ๒๕๔๕
ช่วงเกิดประกายไฟ	spark duration	๑๒ มี.ค. ๒๕๔๕
ช่วงยกลิ้น	valve lift	๑๒ มี.ค. ๒๕๔๕
ช่วงล่าช้าก่อนการเผาไหม้	ignition lag	๑๒ มี.ค. ๒๕๔๕
ช่วงความร้อนหัวเทียน	heat range; spark plug heat range	๑๒ มี.ค. ๒๕๔๕
ช่องระบาย, ช่องหายใจ	breather	๑๒ มี.ค. ๒๕๔๕
ช่องร่วมแฝด	Siamese ports	๑๒ มี.ค. ๒๕๔๕
ช่องเก็บของ	glove compartment	๑๒ มี.ค. ๒๕๔๕
ช่องว่าง	gap	๑๒ มี.ค. ๒๕๔๕
ช่องหายใจ, ช่องระบาย	breather	๑๒ มี.ค. ๒๕๔๕
ช่องหายใจเพลา, ลิ้นระบายความดันเพลา	axle breather	๑๒ มี.ค. ๒๕๔๕
ช่องหายใจห้องข้อเหวี่ยง	crankcase breather	๑๒ มี.ค. ๒๕๔๕
ช่องสุญญากาศ	ported vacuum	๑๒ มี.ค. ๒๕๔๕
ช่องอากาศ	air gap	๑๒ มี.ค. ๒๕๔๕
ช่องอากาศเดินเบา	idle vent	๑๒ มี.ค. ๒๕๔๕
ช่องอากาศเดินเบา; ช่องไล่อากาศ	air bleed	๑๒ มี.ค. ๒๕๔๕
ช่องอุ่นไอดี	heat riser	๑๒ มี.ค. ๒๕๔๕
ช่องว่างเขี้ยวหัวเทียน	plug gap; spark gap	๑๒ มี.ค. ๒๕๔๕
ช่องล้อ	wheelbase	๑๒ มี.ค. ๒๕๔๕
ช่องลดความดัน	antipercolator	๑๒ มี.ค. ๒๕๔๕
ช่องไล่อากาศ; ช่องอากาศเดินเบา	air bleed	๑๒ มี.ค. ๒๕๔๕
ช่องทางน้ำมันหล่อลื่น	gallery; oil gallery	๑๒ มี.ค. ๒๕๔๕
ช่องน้ำเสื้อสูบ	cylinder jacket; water jacket	๑๒ มี.ค. ๒๕๔๕
ช่องน้ำมันเดินเบา	idle port	๑๒ มี.ค. ๒๕๔๕
ช่องพ่นน้ำมัน	spurt-hole	๑๒ มี.ค. ๒๕๔๕
ช่างยนต์	auto mechanic; automotive mechanic	๑๒ มี.ค. ๒๕๔๕
ชั้นโครงสร้างยางรถ	ply	๑๒ มี.ค. ๒๕๔๕
ชิ้นรองรับชุดเฟืองแพลเนต	planet carrier	๑๒ มี.ค. ๒๕๔๕
ชิ้นส่วนหลัก	member	๑๒ มี.ค. ๒๕๔๕
ชุดแผ่นธาตุ	battery element; element	๑๒ มี.ค. ๒๕๔๕
ชุดเพิ่มระยะชัก	stroker kit	๑๒ มี.ค. ๒๕๔๕
ชุดเพลาส่งกำลัง	transaxle	๑๒ มี.ค. ๒๕๔๕
ชุดเพลาขับ	drive line	๑๒ มี.ค. ๒๕๔๕
ชุดเครื่องยนต์รวมระบบส่งกำลัง	unit power plant	๑๒ มี.ค. ๒๕๔๕
ชุดเฟืองระหว่างเพลาขับ	interaxle differential	๑๒ มี.ค. ๒๕๔๕
ชุดเฟืองท้าย	final drive	๑๒ มี.ค. ๒๕๔๕
ชุดวัสดุถ่วงล้อ	balanced weight assortment	๑๒ มี.ค. ๒๕๔๕
ชุดส่งกำลัง; กระปุกเกียร์	transmission	๑๒ มี.ค. ๒๕๔๕
ชุดส่งกำลังสี่ความเร็ว	four-speed transmission	๑๒ มี.ค. ๒๕๔๕
ชุดส่งกำลังอัตโนมัติ, เกียร์อัตโนมัติ	automatic transmission	๑๒ มี.ค. ๒๕๔๕
ชุดสายไฟแรงสูง	leads	๑๒ มี.ค. ๒๕๔๕
ชุดลดแรงสั่นข้อเหวี่ยง	harmonic balancer; harmonic damper	๑๒ มี.ค. ๒๕๔๕
ชุดกระบอกเบรก	brake cylinder; brake wheel cylinder; slave cylinder; wheel cylinder	๑๒ มี.ค. ๒๕๔๕
ชุดกระบอกคลัตช์	clutch slave cylinder	๑๒ มี.ค. ๒๕๔๕
ชุดกันรั่วน้ำมันหล่อลื่น	oil-seal-and-shield	๑๒ มี.ค. ๒๕๔๕
ชุดขับแบบดายเออร์	Dyer drive	๑๒ มี.ค. ๒๕๔๕
ชุดขับด้วยของไหล	fluid drive	๑๒ มี.ค. ๒๕๔๕
ชุดควบคุมระดับอัตโนมัติ	automatic level control	๑๒ มี.ค. ๒๕๔๕
ชุดควบคุมแบบอิเล็กทรอนิกส์ (อีซียู)	electronic control unit (ECU)	๑๒ มี.ค. ๒๕๔๕
ชุดควบคุมสุญญากาศ	vacuum control unit	๑๒ มี.ค. ๒๕๔๕
ชุดควบคุมปริมาณเชื้อเพลิง	metering unit	๑๒ มี.ค. ๒๕๔๕
ชุดคันเกียร์	gearshift	๑๒ มี.ค. ๒๕๔๕
ชุดดัดโครงรถ	fram straightener	๑๒ มี.ค. ๒๕๔๕
ชุดปรับไฟอัตโนมัติ	automatic advance and retard coupling; automatic advance and retard unit	๑๒ มี.ค. ๒๕๔๕
ชุดต่อประกบ, คู่ต่อประกบ; การต่อประกบ	coupling	๑๒ มี.ค. ๒๕๔๕
ชุดต่อประกบแบบของไหล	fluid coupling	๑๒ มี.ค. ๒๕๔๕
ชุดต่อประกบวงแหวน, คู่ต่อประกบวงแหวน	doughnut coupling	๑๒ มี.ค. ๒๕๔๕
ชุดต่อประกบไฮดรอลิก	hydraulic coupling	๑๒ มี.ค. ๒๕๔๕
ซีดีไอ (การจุดระเบิดด้วยตัวเก็บประจุ)	CDI (capacitor-discharge ignition)	๑๒ มี.ค. ๒๕๔๕
ฐานสปริงลิ้น	spring retainer; valve spring retainer	๑๒ มี.ค. ๒๕๔๕
ดรรชนีกันน็อก	antiknock index	๑๒ มี.ค. ๒๕๔๕
ดรรชนีความหนืด (วีไอ)	viscosity index (VI)	๑๒ มี.ค. ๒๕๔๕
ดอกยาง	tire tread; tyre tread	๑๒ มี.ค. ๒๕๔๕
ดอกยาง; ระยะล้อ	tread	๑๒ มี.ค. ๒๕๔๕
ดับเบิลยูโอที (ลิ้นปีกผีเสื้อเปิดสุด)	WOT (wide-open throttle)	๑๒ มี.ค. ๒๕๔๕
ดีน (สำนักงานมาตรฐานอุตสาหกรรมของสหพันธ์สาธารณรัฐเยอรมนี)	DIN (Deutsche Industrie Norm)	๑๒ มี.ค. ๒๕๔๕
ดุมเบรก	brake drum	๑๒ มี.ค. ๒๕๔๕
ดุมล้อ	hub	๑๒ มี.ค. ๒๕๔๕
ดื้อโค้ง	understeer	๑๒ มี.ค. ๒๕๔๕
ดุลพลวัต	dynamic balance	๑๒ มี.ค. ๒๕๔๕
ดุลสถิต	static balance	๑๒ มี.ค. ๒๕๔๕
ตะแกรงกรอง	strainer	๑๒ มี.ค. ๒๕๔๕
ตะแกรงกรองน้ำมันเครื่อง	oil strainer	๑๒ มี.ค. ๒๕๔๕
ตัวแยกไอและเชื้อเพลิง	vapour/fuel separator; vapour/liquid separator	๑๒ มี.ค. ๒๕๔๕
ตัวเรือน, ตัวเสื้อ	housing	๑๒ มี.ค. ๒๕๔๕
ตัวเสื้อ, ตัวเรือน	housing	๑๒ มี.ค. ๒๕๔๕
ตัวรองแท่นเครื่อง	engine mounts	๑๒ มี.ค. ๒๕๔๕
ตัวรัดแหนบ	spring clip	๑๒ มี.ค. ๒๕๔๕
ตัวรัดแบบเกลียวตัวหนอน	worm-drive clip	๑๒ มี.ค. ๒๕๔๕
ตัวรับรู้	sensor	๑๒ มี.ค. ๒๕๔๕
ตัวรับรู้แลมบ์ดา	Lambda sensor	๑๒ มี.ค. ๒๕๔๕
ตัวรับรู้อัตราเร็วพาหนะ (วีเอสเอส)	vehicle speed sensor (VSS)	๑๒ มี.ค. ๒๕๔๕
ตัวรัดจูบิลี	jubilee clip	๑๒ มี.ค. ๒๕๔๕
ตัวยึดกันคลาย	prevailing-torque fasteners	๑๒ มี.ค. ๒๕๔๕
ตัวเก็บประจุ	capacitor	๑๒ มี.ค. ๒๕๔๕
ตัวหยุดกระจก	window stop	๑๒ มี.ค. ๒๕๔๕
ตัวหมุน	rotor	๑๒ มี.ค. ๒๕๔๕
ตัวหมุนลิ้น	valve rotator	๑๒ มี.ค. ๒๕๔๕
ตัวหน่วง; ตัวหน่วงการสั่นสะเทือน	damper	๑๒ มี.ค. ๒๕๔๕
ตัวหน่วงไฮดรอลิก	hydraulic damper	๑๒ มี.ค. ๒๕๔๕
ตัวหน่วงการสั่นสะเทือน	shock absorber; suspension damper	๑๒ มี.ค. ๒๕๔๕
ตัวหน่วงการสั่นสะเทือน; ตัวหน่วง	damper	๑๒ มี.ค. ๒๕๔๕
ตัวหน่วงการสั่นสะเทือนแบบกระบอก	telescopic damper; telescopic shock absorber	๑๒ มี.ค. ๒๕๔๕
ตัวอัดบรรจุอากาศ	supercharger	๑๒ มี.ค. ๒๕๔๕
ตัวอัดบรรจุอากาศเทอร์โบ	turbocharger	๑๒ มี.ค. ๒๕๔๕
ตัวลดเสียงไอเสีย	resonator	๑๒ มี.ค. ๒๕๔๕
ตัวกระจาย	dispersant	๑๒ มี.ค. ๒๕๔๕
ตัวกรอง, หม้อกรอง; ไส้กรอง	filter	๑๒ มี.ค. ๒๕๔๕
ตัวกรองเชื้อเพลิง, หม้อกรองเชื้อเพลิง	fuel filter	๑๒ มี.ค. ๒๕๔๕
ตัวกรองแบบเซรามิก	ceramic filter	๑๒ มี.ค. ๒๕๔๕
ตัวกันกระแทก	bump stop	๑๒ มี.ค. ๒๕๔๕
ตัวกันกระจกโคลง	window stabilizer	๑๒ มี.ค. ๒๕๔๕
ตัวคุมค่าแรงเคลื่อนไฟฟ้า	voltage regulator	๑๒ มี.ค. ๒๕๔๕
ตัวคุมค่าแบบโซลิดสเตต	solid-state regulator	๑๒ มี.ค. ๒๕๔๕
ตัวคุมค่ากระแส	current regulator	๑๒ มี.ค. ๒๕๔๕
ตัวคุมค่าความดัน	pressure regulator	๑๒ มี.ค. ๒๕๔๕
ตัวคุม	modulator	๑๒ มี.ค. ๒๕๔๕
ตัวจำกัดเดินเบา	idle limiter	๑๒ มี.ค. ๒๕๔๕
ตัวฉีด	injector	๑๒ มี.ค. ๒๕๔๕
ตัวชี้บอกระดับอิเล็กโทรไลต์	electrolyte-level indicator	๑๒ มี.ค. ๒๕๔๕
ตัวฉีดเชื้อเพลิง	fuel injector	๑๒ มี.ค. ๒๕๔๕
ตัวต้านทานการจุดระเบิด	ignition resistor	๑๒ มี.ค. ๒๕๔๕
ตัวถังรถ	autobody	๑๒ มี.ค. ๒๕๔๕
ตัวถังแบบไร้โครง	integral construction; monocoque; unitary construction; unitized body; unitzed construction	๑๒ มี.ค. ๒๕๔๕
ตัวตามลูกเบี้ยว	cam follower	๑๒ มี.ค. ๒๕๔๕
ตัวทำให้เย็น	coolant	๑๒ มี.ค. ๒๕๔๕
ตัวทำละออง	atomizer	๑๒ มี.ค. ๒๕๔๕
ตัวทำไฟกะพริบ	flasher	๑๒ มี.ค. ๒๕๔๕
ตัวประหยัดน้ำมัน	economizer	๑๒ มี.ค. ๒๕๔๕
ตัวประสานเฟือง	synchronizer	๑๒ มี.ค. ๒๕๔๕
ตัวประกบตีนลิ้น	retainer lock; valve keeper; valve key; valve lock; valve-spring-retainer lock	๑๒ มี.ค. ๒๕๔๕
ตัวปรับเอง	self-adjuster	๑๒ มี.ค. ๒๕๔๕
ตัวปรับความตึงโซ่	chain tensioner	๑๒ มี.ค. ๒๕๔๕
ตัวผ่อนการกลับของลิ้นปีกผีเสื้อ	throttle-return check	๑๒ มี.ค. ๒๕๔๕
ตั้งไฟอ่อน, ปรับไฟอ่อน	retard; spark retard	๑๒ มี.ค. ๒๕๔๕
ตำแหน่งเร่งเต็มที่	full throttle	๑๒ มี.ค. ๒๕๔๕
ตำแหน่งเลือกเกียร์ต่ำ	manual low	๑๒ มี.ค. ๒๕๔๕
ติดเครื่องด้วยการพ่วงไฟ	jump-starting	๑๒ มี.ค. ๒๕๔๕
ตลับลูกปืน; รองลื่น	bearing	๑๒ มี.ค. ๒๕๔๕
ตลับลูกปืนเม็ดยาว	roller bearing	๑๒ มี.ค. ๒๕๔๕
ตลับลูกปืนเม็ดกลม	ball bearing	๑๒ มี.ค. ๒๕๔๕
ตลับลูกปืนเข็ม	needle bearing	๑๒ มี.ค. ๒๕๔๕
ตลับลูกปืนหัวเพลาคลัตช์	pilot bearing	๑๒ มี.ค. ๒๕๔๕
ตลับลูกปืนกันรุน; รองลื่นกันรุน	thrust bearing	๑๒ มี.ค. ๒๕๔๕
ตลับลูกปืนคลัตช์	clutch thrust bearing; release bearing; throwout bearing; withdrawal bearing	๑๒ มี.ค. ๒๕๔๕
ตลับลูกปืนดุมล้อ	hub bearing	๑๒ มี.ค. ๒๕๔๕
ถ่านจานจ่าย	high-tension pick-up	๑๒ มี.ค. ๒๕๔๕
ถอดประกอบ (อาร์แอนด์อาร์)	remove and reinstall (R and R)	๑๒ มี.ค. ๒๕๔๕
ถังเชื้อเพลิง	fuel tank	๑๒ มี.ค. ๒๕๔๕
ถังสะสม; หม้อสะสมไฟฟ้า	accumulator	๑๒ มี.ค. ๒๕๔๕
ถุงลม	air bag	๑๒ มี.ค. ๒๕๔๕
ท่อระบายไอน้ำมันเครื่อง	road-draft tube	๑๒ มี.ค. ๒๕๔๕
ท่อร่วม	manifold	๑๒ มี.ค. ๒๕๔๕
ท่อ; กระบอกสูบ	barrel	๑๒ มี.ค. ๒๕๔๕
ท่อร่วมไอเสีย	exhaust manifold	๑๒ มี.ค. ๒๕๔๕
ท่อร่วมไอดี	induction manifold; inlet manifold; intake manifold	๑๒ มี.ค. ๒๕๔๕
ท่อโช้ก	choke tube	๑๒ มี.ค. ๒๕๔๕
ท่อส่งเชื้อเพลิง	fuel line	๑๒ มี.ค. ๒๕๔๕
ท่ออากาศเข้าคาร์บูเรเตอร์; แตรลม	air horn	๑๒ มี.ค. ๒๕๔๕
ท่อสุญญากาศปรับการจุดระเบิด	ignition vacuum pipe	๑๒ มี.ค. ๒๕๔๕
ท่ออ่อนหม้อน้ำ	radiator hose	๑๒ มี.ค. ๒๕๔๕
ท่อไอเสียท่อนปลาย	tail pipe	๑๒ มี.ค. ๒๕๔๕
ท่อไอเชื้อเพลิงกลับ	vapour return line	๑๒ มี.ค. ๒๕๔๕
ท่อนยึดปีกนกล่าง	strut	๑๒ มี.ค. ๒๕๔๕
ท่อนกันโคลง	antiroll bar; stabilizer; stabilizer bar; sway bar	๑๒ มี.ค. ๒๕๔๕
ท่อผสม	emulsion tube	๑๒ มี.ค. ๒๕๔๕
ท้ายรถแบบคัมม์	Kamm back; Kamm tail	๑๒ มี.ค. ๒๕๔๕
ท้ายรถปัดส่าย	bump-steer	๑๒ มี.ค. ๒๕๔๕
ทอร์ก, แรงบิด	torque	๑๒ มี.ค. ๒๕๔๕
ทอร์กรวบยอด	gross torque	๑๒ มี.ค. ๒๕๔๕
ทอร์กสุทธิ	net torque	๑๒ มี.ค. ๒๕๔๕
ทอร์กคอนเวอร์เตอร์	torque converter	๑๒ มี.ค. ๒๕๔๕
ทอร์กคอนเวอร์เตอร์แบบล็อกได้	lockup torque converter	๑๒ มี.ค. ๒๕๔๕
ทอร์กคืนศูนย์	aligning torque; self-aligning torque	๑๒ มี.ค. ๒๕๔๕
ทอร์กบนเสื้อเพลาท้าย	rear-end torque	๑๒ มี.ค. ๒๕๔๕
ทอร์ชันบาร์, แท่งบิด	torsion bar; torsion-bar spring	๑๒ มี.ค. ๒๕๔๕
ที่รองค้อนเคาะ	dolly	๑๒ มี.ค. ๒๕๔๕
ที่ผ่อนไอเสีย	wastegate	๑๒ มี.ค. ๒๕๔๕
ทีอีแอล (เททระเอทิลเลด)	TEL (tetraethyl lead)	๑๒ มี.ค. ๒๕๔๕
ทีบีไอ (การฉีดเข้าช่องลิ้นปีกผีเสื้อ)	TBI (throttle-body injection)	๑๒ มี.ค. ๒๕๔๕
ทีดับเบิลยูซี (เครื่องฟอกไอเสียเชิงเร่งปฏิกิริยาสามทาง, แคทาลิติกคอนเวอร์เตอร์สามทาง)	TWC (three-way catalytic converter)	๑๒ มี.ค. ๒๕๔๕
ทีดีซี (ศูนย์ตายบน)	TDC (top dead center)	๑๒ มี.ค. ๒๕๔๕
น็อก	knock	๑๒ มี.ค. ๒๕๔๕
น็อกจากเชื้อเพลิง	fuel knock	๑๒ มี.ค. ๒๕๔๕
น็อกจากประกายไฟ	spark knock	๑๒ มี.ค. ๒๕๔๕
น็อต, แป้นเกลียว	nut	๑๒ มี.ค. ๒๕๔๕
นมหนู	jet	๑๒ มี.ค. ๒๕๔๕
นมหนูเดินเบา	idle jet; pilot jet; slow-running jet	๑๒ มี.ค. ๒๕๔๕
นมหนูหลัก	main jet	๑๒ มี.ค. ๒๕๔๕
นมหนูประหยัดน้ำมัน	economy jet	๑๒ มี.ค. ๒๕๔๕
น้ำมันเกียร์	gear lubricant	๑๒ มี.ค. ๒๕๔๕
น้ำมันเครื่อง, น้ำมันหล่อลื่น	lube oil; lubricating oil	๑๒ มี.ค. ๒๕๔๕
น้ำมันเครื่องรั่วผ่านแหวน	oil pumping	๑๒ มี.ค. ๒๕๔๕
น้ำมันเครื่องเกรดรวม	multigrade oil; multiple-viscosity oil	๑๒ มี.ค. ๒๕๔๕
น้ำมันเชื้อเพลิง; น้ำมันเตา	fuel oil	๑๒ มี.ค. ๒๕๔๕
น้ำมัน	oil	๑๒ มี.ค. ๒๕๔๕
น้ำมันเชื้อเพลิงตะกั่วต่ำ	low-lead fuel	๑๒ มี.ค. ๒๕๔๕
น้ำมันเตา; น้ำมันเชื้อเพลิง	fuel oil	๑๒ มี.ค. ๒๕๔๕
น้ำมันเบรก	brake fluid	๑๒ มี.ค. ๒๕๔๕
น้ำมันสังเคราะห์	synthetic oil	๑๒ มี.ค. ๒๕๔๕
น้ำมันหล่อลื่น, น้ำมันเครื่อง	lube oil; lubricating oil	๑๒ มี.ค. ๒๕๔๕
น้ำมันล้างภายในเครื่อง	flushing oil	๑๒ มี.ค. ๒๕๔๕
น้ำมันไฮดรอลิก	hydraulic fluid	๑๒ มี.ค. ๒๕๔๕
น้ำมันดีเซล	deisel oil	๑๒ มี.ค. ๒๕๔๕
น้ำยาลอกสี	paint remover	๑๒ มี.ค. ๒๕๔๕
น้ำยาทาปะเก็น	gasket cement; gasket liquid sealer	๑๒ มี.ค. ๒๕๔๕
น้ำยาปะยางใน	rubber solution	๑๒ มี.ค. ๒๕๔๕
น้ำหนักรวมรวบยอด (จีซีดับเบิลยู)	gross combination weight (GCW)	๑๒ มี.ค. ๒๕๔๕
น้ำหนักยานยนต์รวบยอด (จีวีดับเบิลยู)	gross vehicle weight (GVW)	๑๒ มี.ค. ๒๕๔๕
น้ำหนักรถเปล่า	curb weight	๑๒ มี.ค. ๒๕๔๕
น้ำหนักถ่วง	counterweight	๑๒ มี.ค. ๒๕๔๕
น้ำหนักนอกสปริง	unsprung weight	๑๒ มี.ค. ๒๕๔๕
น้ำหนักบรรทุก	pay load	๑๒ มี.ค. ๒๕๔๕
น้ำหนักบนสปริง	sprung weight	๑๒ มี.ค. ๒๕๔๕
นีโอพรีน	neoprene	๑๒ มี.ค. ๒๕๔๕
นิ้วคลัตช์	release fingers; release lever plate; release levers	๑๒ มี.ค. ๒๕๔๕
บริเวณเย็น	quench area	๑๒ มี.ค. ๒๕๔๕
บริเวณพ่นไอดี	squish area	๑๒ มี.ค. ๒๕๔๕
บ่าลิ้น	valve seat	๑๒ มี.ค. ๒๕๔๕
บ่าลิ้นเม็ดกลม	ball seat	๑๒ มี.ค. ๒๕๔๕
บ่าลิ้นจม	pocketing	๑๒ มี.ค. ๒๕๔๕
บีเอ็มอีพี (ความดันประสิทธิผลเฉลี่ยสำหรับแรงม้าเพลา)	bmep (brake mean effective pressure)	๑๒ มี.ค. ๒๕๔๕
บีเอชพี (แรงม้าเพลา)	bhp (brake horsepower)	๑๒ มี.ค. ๒๕๔๕
บีเอชพีรวบยอดเอสเออี (แรงม้าเพลารวบยอดเอสเออี)	SAE gross bhp (SAE gross brake horsepower)	๑๒ มี.ค. ๒๕๔๕
บีเอชพีสุทธิเอสเออี (แรงม้าเพลาสุทธิเอสเออี)	SAE net bhp (SAE net brake horsepower)	๑๒ มี.ค. ๒๕๔๕
บีดีซี (ศูนย์ตายล่าง)	BDC (bottom dead center)	๑๒ มี.ค. ๒๕๔๕
บีทีดีซี (ก่อนศูนย์ตายบน)	BTDC (before top dead center)	๑๒ มี.ค. ๒๕๔๕
บีพี (กำลังเพลา)	bp (brake power)	๑๒ มี.ค. ๒๕๔๕
บุช, ปลอก	bush	๑๒ มี.ค. ๒๕๔๕
ประแจแหวน	box wrench; ring spanner	๑๒ มี.ค. ๒๕๔๕
ประแจล้อแบบกากบาท	four-way wheel nut wrench	๑๒ มี.ค. ๒๕๔๕
ประแจตัวกรองน้ำมันเครื่อง	oil-filter wrench	๑๒ มี.ค. ๒๕๔๕
ประสิทธิภาพ	efficiency	๑๒ มี.ค. ๒๕๔๕
ประสิทธิภาพเชิงกล	mechanical efficiency	๑๒ มี.ค. ๒๕๔๕
ประสิทธิภาพเชิงปริมาตร	volumetric efficiency	๑๒ มี.ค. ๒๕๔๕
ประกับล็อก	collet; split cone	๑๒ มี.ค. ๒๕๔๕
ประกายไฟ	jump spark; spark	๑๒ มี.ค. ๒๕๔๕
ประจุ	charge	๑๒ มี.ค. ๒๕๔๕
ประจุไอดีเป็นชั้น	stratified charge	๑๒ มี.ค. ๒๕๔๕
ปรับไฟอ่อน, ตั้งไฟอ่อน	retard; spark retard	๑๒ มี.ค. ๒๕๔๕
ปริมาตรช่วงชักลูกสูบ	swept volume	๑๒ มี.ค. ๒๕๔๕
ปะเก็น	gasket	๑๒ มี.ค. ๒๕๔๕
ปะเก็นเหลว	formed-in-place gasket; plastic gasket compound	๑๒ มี.ค. ๒๕๔๕
ปะเก็นฝาสูบ	cylinder-head gasket	๑๒ มี.ค. ๒๕๔๕
ป้ายทะเบียนรถ	number plate	๑๒ มี.ค. ๒๕๔๕
ปั๊ม, เครื่องสูบ	pump	๑๒ มี.ค. ๒๕๔๕
ปั๊มเชื้อเพลิงไฟฟ้า, เครื่องสูบเชื้อเพลิงไฟฟ้า	electric fuel pump	๑๒ มี.ค. ๒๕๔๕
ปั๊มเบนซิน, เครื่องสูบเบนซิน	petrol pump	๑๒ มี.ค. ๒๕๔๕
ปั๊มเฟือง, เครื่องสูบเฟือง	gear pump; gear-type pump	๑๒ มี.ค. ๒๕๔๕
ปั๊มสุญญากาศ	aspirator; vacuum pump	๑๒ มี.ค. ๒๕๔๕
ปั๊มไดอะแฟรม, เครื่องสูบไดอะแฟรม	diaphragm pump	๑๒ มี.ค. ๒๕๔๕
ปั๊มน้ำมันเครื่อง, เครื่องสูบน้ำมันเครื่อง	oil pump	๑๒ มี.ค. ๒๕๔๕
ปั๊มน้ำมันเครื่องแบบตัวหมุน, เครื่องสูบน้ำมันเครื่องแบบตัวหมุน	rotor oil pump	๑๒ มี.ค. ๒๕๔๕
ปั๊มป้อนเชื้อเพลิง, เครื่องสูบป้อนเชื้อเพลิง	fuel feed pump; fuel pump	๑๒ มี.ค. ๒๕๔๕
ปัด	pull	๑๒ มี.ค. ๒๕๔๕
ปิโตรเลียม	petroleum	๑๒ มี.ค. ๒๕๔๕
ปากท่อ; หัวฉีด	nozzle	๑๒ มี.ค. ๒๕๔๕
ปากท่อเชื้อเพลิง	fuel nozzle	๑๒ มี.ค. ๒๕๔๕
ปีกนก	control arm; suspension arm; wishbone; wishbone arm	๑๒ มี.ค. ๒๕๔๕
ปล่อยแห้ง	air dry	๑๒ มี.ค. ๒๕๔๕
ปลอก, บุช	bush	๑๒ มี.ค. ๒๕๔๕
ปลอกสูบ	cylinder liner; cylinder sleeve	๑๒ มี.ค. ๒๕๔๕
ปลอกสูบ; กาบรองลื่น	liner	๑๒ มี.ค. ๒๕๔๕
ปลอกสูบแบบแห้ง	dry liner	๑๒ มี.ค. ๒๕๔๕
ปลอกสูบแบบเปียก	wet liner	๑๒ มี.ค. ๒๕๔๕
ปลอกก้านลิ้น	valve guide; valve stem guide	๑๒ มี.ค. ๒๕๔๕
ปลอกกันฝุ่น	dust excluder	๑๒ มี.ค. ๒๕๔๕
ปลั๊กตรวจระดับน้ำมันเกียร์	level plug	๑๒ มี.ค. ๒๕๔๕
ปลั๊กตาน้ำ	core hole plug; core plug; expansion plug; freeze plug; welch plug	๑๒ มี.ค. ๒๕๔๕
ปลายใหญ่ก้านสูบ	big-end; rod big end	๑๒ มี.ค. ๒๕๔๕
ปลายเล็กก้านสูบ	little-end; rod small end; small-end	๑๒ มี.ค. ๒๕๔๕
ปืนอัดจาระบี	grease gun	๑๒ มี.ค. ๒๕๔๕
ผ้าคลัตช์	clutch lining	๑๒ มี.ค. ๒๕๔๕
ผ้าเบรก	brake lining; lining	๑๒ มี.ค. ๒๕๔๕
ผิวมันลื่น	glaze	๑๒ มี.ค. ๒๕๔๕
ผิวลูกสูบระหว่างแหวน	piston land	๑๒ มี.ค. ๒๕๔๕
ผิวดุมเบรกเรียบลื่น	brake-drum galze	๑๒ มี.ค. ๒๕๔๕
ผลการเสริมแรงตัวเอง	self-servo effect	๑๒ มี.ค. ๒๕๔๕
ผลการยก	jacking effect	๑๒ มี.ค. ๒๕๔๕
ผลการถ่ายโอนน้ำหนัก	weight transfer effect	๑๒ มี.ค. ๒๕๔๕
ผลป้อนกลับที่พวงมาลัย	steering feedback	๑๒ มี.ค. ๒๕๔๕
ผนังห้องเครื่อง	firewall	๑๒ มี.ค. ๒๕๔๕
ผนังห้องเครื่อง; แผงหน้าปัด	dash	๑๒ มี.ค. ๒๕๔๕
ฝักเบรก, เกือกเบรก	brake shoe; shoe	๑๒ มี.ค. ๒๕๔๕
ฝักเบรกตาม, เกือบเบรกตาม	trailing shoe	๑๒ มี.ค. ๒๕๔๕
ฝักเบรกนำ, เกือกเบรกนำ	leading shoe	๑๒ มี.ค. ๒๕๔๕
ฝารองลื่น	bearing cap	๑๒ มี.ค. ๒๕๔๕
ฝาหม้อน้ำ	radiator cap	๑๒ มี.ค. ๒๕๔๕
ฝาหม้อน้ำความดัน	pressure cap; radiator pressure cap	๑๒ มี.ค. ๒๕๔๕
ฝาสูบ	cylinder head; head	๑๒ มี.ค. ๒๕๔๕
ฝาสูบโก่ง	head distortion	๑๒ มี.ค. ๒๕๔๕
ฝากระโปรงห้องเครื่อง	bonnet; hood	๑๒ มี.ค. ๒๕๔๕
ฝากันฝุ่น	dust cap	๑๒ มี.ค. ๒๕๔๕
ฝาครอบลิ้น	rocker cover	๑๒ มี.ค. ๒๕๔๕
ฝาครอบจานจ่าย	distributor cap	๑๒ มี.ค. ๒๕๔๕
ฝาครอบดุมล้อ	nave plate	๑๒ มี.ค. ๒๕๔๕
ฝาจุ๊บ	valve cap	๑๒ มี.ค. ๒๕๔๕
ฝาช่องเติม	filler cap	๑๒ มี.ค. ๒๕๔๕
ฝาช่องเติมน้ำมันเครื่อง	oil filler cap	๑๒ มี.ค. ๒๕๔๕
ฝาดุมล้อ	hub cover	๑๒ มี.ค. ๒๕๔๕
ฝาตัวจำกัดเดินเบา	idle limiter cap	๑๒ มี.ค. ๒๕๔๕
พวงมาลัย	steering wheel	๑๒ มี.ค. ๒๕๔๕
พวงมาลัยตีกลับ	steering kickback	๑๒ มี.ค. ๒๕๔๕
พวงมาลัยปรับมุม	tilt steering wheel	๑๒ มี.ค. ๒๕๔๕
พัดลมอัตราเร็วแปรผันได้	variable-speed fan	๑๒ มี.ค. ๒๕๔๕
พีวีเอส (สวิตช์ช่องสุญญากาศ)	PVS (ported-vacuum switch)	๑๒ มี.ค. ๒๕๔๕
พิมพ์ลาย; ลายพิมพ์	knurl	๑๒ มี.ค. ๒๕๔๕
พีอาร์ (ค่าประเมินความแข็งแรงชั้นโครงสร้างยางรถ)	PR (ply rating)	๑๒ มี.ค. ๒๕๔๕
พีซีวี (การระบายไอห้องข้อเหวี่ยงแบบปิด)	PCV (positive crankcase ventilation)	๑๒ มี.ค. ๒๕๔๕
พลังงาน	energy	๑๒ มี.ค. ๒๕๔๕
พลันเจอร์	plunger	๑๒ มี.ค. ๒๕๔๕
พลาสทิเกจ	Plastigage	๑๒ มี.ค. ๒๕๔๕
พนักพิง	squab	๑๒ มี.ค. ๒๕๔๕
ฟิวส์	fuse	๑๒ มี.ค. ๒๕๔๕
