-ใส่เข้า	input	๒๖ ม.ค. ๒๕๔๕
-ออกใช้	output	๒๖ ม.ค. ๒๕๔๕
-กล	mechanical	๒๖ ม.ค. ๒๕๔๕
-กล; เครื่องกล; เครื่องจักร	machine	๒๖ ม.ค. ๒๕๔๕
โมเมนต์ความเฉื่อย	moment of inertia	๒๖ ม.ค. ๒๕๔๕
A/F ratio; air-fuel ratio	อัตราส่วนเอ/เอฟ, อัตราส่วนอากาศต่อเชื้อเพลิง	๒๖ ม.ค. ๒๕๔๕
โรเตอร์, ตัวหมุน	rotor	๒๖ ม.ค. ๒๕๔๕
แรงเสียดทาน	friction force	๒๖ ม.ค. ๒๕๔๕
แรงยก	lift	๒๖ ม.ค. ๒๕๔๕
แรงเฉื่อย	inertia force	๒๖ ม.ค. ๒๕๔๕
แรงเฉือนลม	wind shear	๒๖ ม.ค. ๒๕๔๕
แรงต้าน	drag	๒๖ ม.ค. ๒๕๔๕
แรงต้านลม; ความต้านลม	air resistance	๒๖ ม.ค. ๒๕๔๕
แรงผลักดัน	thrust	๒๖ ม.ค. ๒๕๔๕
โรงผลิตกำลัง	power plant	๒๖ ม.ค. ๒๕๔๕
โรงผลิตกำลังด้วยรังสีอาทิตย์	solar power plant	๒๖ ม.ค. ๒๕๔๕
เรดิโอมิเตอร์, มาตรรังสี	radiometer	๒๖ ม.ค. ๒๕๔๕
แมนอมิเตอร์, มาตรความดันของไหล	manometer	๒๖ ม.ค. ๒๕๔๕
เรือนกระจก	greenhouse	๒๖ ม.ค. ๒๕๔๕
absolute pressure	ความดันสัมบูรณ์	๒๖ ม.ค. ๒๕๔๕
absolute zero	ศูนย์สัมบูรณ์	๒๖ ม.ค. ๒๕๔๕
absorber	ตัวดูดกลืน	๒๖ ม.ค. ๒๕๔๕
absorber plate	แผ่นดูดกลืน	๒๖ ม.ค. ๒๕๔๕
absorptance	ความดูดกลืน	๒๖ ม.ค. ๒๕๔๕
absorption	การดูดกลืน	๒๖ ม.ค. ๒๕๔๕
absorbant; absorbent	สารดูดกลืน	๒๖ ม.ค. ๒๕๔๕
acceptance half-angle	ครึ่งมุมรับรังสี	๒๖ ม.ค. ๒๕๔๕
acceleration on ridge	ความเร่ง(ของลม)บนยอดเนิน	๒๖ ม.ค. ๒๕๔๕
accumulator	หม้อสะสมไฟฟ้า	๒๖ ม.ค. ๒๕๔๕
active system	ระบบกัมมันต์	๒๖ ม.ค. ๒๕๔๕
มวลอากาศ; แอร์แมส	air mass	๒๖ ม.ค. ๒๕๔๕
เวลาสุริยะ	solar time	๒๖ ม.ค. ๒๕๔๕
เวนจูริ; คอคอด	venturi	๒๖ ม.ค. ๒๕๔๕
additive	สารเติมแต่ง	๒๖ ม.ค. ๒๕๔๕
adiabatic process	กระบวนการแอเดียแบติก	๒๖ ม.ค. ๒๕๔๕
ระบบมวลสปริง	mass-spring system	๒๖ ม.ค. ๒๕๔๕
ระบบโอเท็ก, ระบบการเปลี่ยนรูปพลังงานอุณหภาพมหาสมุทร	OTEC system; ocean thermal energy conversion system	๒๖ ม.ค. ๒๕๔๕
ระบบเครื่องจักร; เครื่องจักร	machinery	๒๖ ม.ค. ๒๕๔๕
ระบบเทอร์มอไซฟอน	thermosyphon system	๒๖ ม.ค. ๒๕๔๕
ระบบเผาไหม้ไอดีบางโดยอิเล็กทรอนิกส์, ระบบอีแอลบี	electronic lean-burn system; ELB system	๒๖ ม.ค. ๒๕๔๕
ระบบเชื้อเพลิง	fuel system	๒๖ ม.ค. ๒๕๔๕
ระบบเชื้อเพลิงใช้คาร์บูเรเตอร์แบบอิเล็กทรอนิกส์	electronic carburetted fuel system	๒๖ ม.ค. ๒๕๔๕
ระบบหมุนเวียนแบบบังคับ	forced circulation system	๒๖ ม.ค. ๒๕๔๕
ระบบหมุนเวียนไอเสีย, ระบบอีจีอาร์	exhaust-gas recirculation system; EGR system	๒๖ ม.ค. ๒๕๔๕
ระบบอีเอฟไอ, ระบบฉีดเชื้อเพลิงแบบอิเล็กทรอนิกส์	EFI system; electronic fuel-injection system	๒๖ ม.ค. ๒๕๔๕
ระบบอากาศร้อน	hot-air system	๒๖ ม.ค. ๒๕๔๕
ระบบอีจีอาร์, ระบบหมุนเวียนไอเสีย	EGR system; exhaust-gas recirculation system	๒๖ ม.ค. ๒๕๔๕
ระบบอุ่นอากาศ	heated-air system	๒๖ ม.ค. ๒๕๔๕
ระบบอุ่นอากาศเข้า	regeneration system	๒๖ ม.ค. ๒๕๔๕
ระบบอุณหภาพรังสีอาทิตย์	solar thermal system	๒๖ ม.ค. ๒๕๔๕
ระบบอีแอลบี, ระบบเผาไหม้ไอดีบางโดยอิเล็กทรอนิกส์	ELB system; electronic lean-burn system	๒๖ ม.ค. ๒๕๔๕
ระบบอีเอฟอี, ระบบทำให้เชื้อเพลิงระเหยก่อน	EFE system; early fuel evaporation system	๒๖ ม.ค. ๒๕๔๕
ระบบการเปลี่ยนรูปพลังงานอุณหภาพมหาสมุทร, ระบบโอเท็ก	ocean thermal energy conversion system; OTEC system	๒๖ ม.ค. ๒๕๔๕
ระบบควบคุม	control system	๒๖ ม.ค. ๒๕๔๕
ระบบควบคุมไอเสียแบบผสม	combination emission control system	๒๖ ม.ค. ๒๕๔๕
ระบบควบคุมไนโตรเจนออกไซด์	NOxcontrol system	๒๖ ม.ค. ๒๕๔๕
ระบบควบคุมการระเหย	evaporative control system; fuel-vapour recovery system; vapour-recovery system; vapour-saver system; vehicle vapour recovery	๒๖ ม.ค. ๒๕๔๕
ระบบการไหลแบบแผ่นขนาน	parallel-plate flow system	๒๖ ม.ค. ๒๕๔๕
ระบบกสานติ์	passive system	๒๖ ม.ค. ๒๕๔๕
ระบบกสานติ์แบบทรอมเบ	Trombe passive system	๒๖ ม.ค. ๒๕๔๕
ระบบกัมมันต์	active system	๒๖ ม.ค. ๒๕๔๕
ระบบจุดระเบิดคู่	dual ignition system	๒๖ ม.ค. ๒๕๔๕
ระบบจุดระเบิดพลังงานสูง (เอชอีไอ)	high-energy ignition system (HEI)	๒๖ ม.ค. ๒๕๔๕
ระบบฉีด	injection system	๒๖ ม.ค. ๒๕๔๕
ระบบฉีดเชื้อเพลิง	fuel-injection system	๒๖ ม.ค. ๒๕๔๕
ระบบฉีดเชื้อเพลิงแบบอิเล็กทรอนิกส์, ระบบอีเอฟไอ	electronic fuel-injection system; EFI system	๒๖ ม.ค. ๒๕๔๕
ระบบฉีดอากาศ	air-injection system; thermactor	๒๖ ม.ค. ๒๕๔๕
ระบบทำให้เชื้อเพลิงระเหยก่อน, ระบบอีเอฟอี	early fuel evaporation system; EFE system	๒๖ ม.ค. ๒๕๔๕
ระบบทำความร้อนแบบใช้น้ำ	hydronic heating system	๒๖ ม.ค. ๒๕๔๕
ระบบท่อไอเสีย	exhaust system	๒๖ ม.ค. ๒๕๔๕
ระบบทำให้เย็น	cooling system	๒๖ ม.ค. ๒๕๔๕
ระบบทำน้ำร้อนด้วยรังสีอาทิตย์	solar water heating system	๒๖ ม.ค. ๒๕๔๕
ระบบน้ำร้อน	hot-water system	๒๖ ม.ค. ๒๕๔๕
ระบบพลังงานรังสีอาทิตย์	solar energy system	๒๖ ม.ค. ๒๕๔๕
ระบบปิด	closed system	๒๖ ม.ค. ๒๕๔๕
เศรษฐศาสตร์พลังงานรังสีอาทิตย์	solar energy economics	๒๖ ม.ค. ๒๕๔๕
เหมาะที่สุด; ค่าเหมาะที่สุด	optimum	๒๖ ม.ค. ๒๕๔๕
เส้นโค้งกำลัง-อัตราเร็ว	power-speed curve	๒๖ ม.ค. ๒๕๔๕
ร้อนเกิน	overheat	๒๖ ม.ค. ๒๕๔๕
aerofoil; airfoil	แพนอากาศ	๒๖ ม.ค. ๒๕๔๕
aerodynamic drag coefficient	สัมประสิทธิ์แรงต้านอากาศพลศาสตร์	๒๖ ม.ค. ๒๕๔๕
aerodynamics	อากาศพลศาสตร์	๒๖ ม.ค. ๒๕๔๕
แหล่งให้ความร้อน	heat source	๒๖ ม.ค. ๒๕๔๕
แหล่งรับความร้อน	heatsink	๒๖ ม.ค. ๒๕๔๕
afterburner	อุปกรณ์เผาไหม้เสริม 	๒๖ ม.ค. ๒๕๔๕
แอร์แมส; มวลอากาศ	air mass	๒๖ ม.ค. ๒๕๔๕
มอเตอร์ไฟฟ้า	electric motor	๒๖ ม.ค. ๒๕๔๕
เอ็มโอเอ็น (เลขออกเทนเครื่องยนต์)	MON (motor octane number)	๒๖ ม.ค. ๒๕๔๕
air chamber	๑. ห้องอากาศ๒. ห้องลม	๒๖ ม.ค. ๒๕๔๕
air compressor	เครื่องอัดอากาศ	๒๖ ม.ค. ๒๕๔๕
air conditioner	เครื่องปรับอากาศ	๒๖ ม.ค. ๒๕๔๕
air conditioning	การปรับอากาศ	๒๖ ม.ค. ๒๕๔๕
air gap	ช่องอากาศ	๒๖ ม.ค. ๒๕๔๕
air mass	๑. แอร์แมส๒. มวลอากาศ	๒๖ ม.ค. ๒๕๔๕
air pollution	มลพิษทางอากาศ	๒๖ ม.ค. ๒๕๔๕
air pressure	ความดันอากาศ	๒๖ ม.ค. ๒๕๔๕
air pump	เครื่องสูบลม	๒๖ ม.ค. ๒๕๔๕
air resistance	๑. ความต้านลม๒. แรงต้านลม	๒๖ ม.ค. ๒๕๔๕
air-fuel mixture; fuel mixture; mixture	ไอดี, สารผสมอากาศกับเชื้อเพลิง	๒๖ ม.ค. ๒๕๔๕
air-fuel ratio; A/F ratio	อัตราส่วนอากาศต่อเชื้อเพลิง, อัตราส่วนเอ/เอฟ	๒๖ ม.ค. ๒๕๔๕
air-injection system; thermactor	ระบบฉีดอากาศ	๒๖ ม.ค. ๒๕๔๕
airflow meter	มาตรอากาศไหล	๒๖ ม.ค. ๒๕๔๕
airfoil; aerofoil	แพนอากาศ	๒๖ ม.ค. ๒๕๔๕
air-cooled collector	ตัวเก็บรังสีแบบหล่อเย็นด้วยอากาศ	๒๖ ม.ค. ๒๕๔๕
แอลบีโด, อัตราส่วนสะท้อน	albedo	๒๖ ม.ค. ๒๕๔๕
แอลพีแก๊ส, แอลพีจี (แก๊สปิโตรเลียมเหลว)	LPG; LP-GAS (liquefied petroleum gas)	๒๖ ม.ค. ๒๕๔๕
เอชอีไอ (ระบบจุดระเบิดพลังงานสูง)	HEI (high-energy ignition system)	๒๖ ม.ค. ๒๕๔๕
เอนโทรปี	entropy	๒๖ ม.ค. ๒๕๔๕
แอนาเล็มมา	analemma	๒๖ ม.ค. ๒๕๔๕
เอนทัลปี	enthalpy	๒๖ ม.ค. ๒๕๔๕
albedo	อัตราส่วนสะท้อน, แอลบีโด	๒๖ ม.ค. ๒๕๔๕
altitude angle	มุมระดับความสูง	๒๖ ม.ค. ๒๕๔๕
ambient temperature	อุณหภูมิโดยรอบ	๒๖ ม.ค. ๒๕๔๕
analemma	แอนาเล็มมา	๒๖ ม.ค. ๒๕๔๕
anemometer	มาตรความเร็วลม	๒๖ ม.ค. ๒๕๔๕
angle of attack	มุมปะทะ	๒๖ ม.ค. ๒๕๔๕
annual irradiation	การอาบรังสีต่อปี	๒๖ ม.ค. ๒๕๔๕
antifreeze	สารกันเยือกแข็ง	๒๖ ม.ค. ๒๕๔๕
antiknock compound	สารกันน็อก	๒๖ ม.ค. ๒๕๔๕
antiknock index	ดรรชนีต้านการน็อก	๒๖ ม.ค. ๒๕๔๕
antiknock rating	ค่าประเมินกันการน็อก	๒๖ ม.ค. ๒๕๔๕
รังสีโลก; การแผ่รังสีโลก	terrestrial radiation	๒๖ ม.ค. ๒๕๔๕
รังสี; การแผ่รังสี	radiation	๒๖ ม.ค. ๒๕๔๕
รังสีรวม	global radiation	๒๖ ม.ค. ๒๕๔๕
รังสีรวมยอด	total radiation	๒๖ ม.ค. ๒๕๔๕
รังสีอาทิตย์; การแผ่รังสีอาทิตย์	solar radiation	๒๖ ม.ค. ๒๕๔๕
รังสีอาทิตย์บนผิวโลก	insolation	๒๖ ม.ค. ๒๕๔๕
รังสีอินฟราเรด; การแผ่รังสีอินฟราเรด	infrared radiation	๒๖ ม.ค. ๒๕๔๕
รังสีกระจาย; การแผ่รังสีกระจาย	diffuse radiation	๒๖ ม.ค. ๒๕๔๕
รังสีตกกระทบ; การแผ่รังสีตกกระทบ	incidence radiation; intercepted radiation	๒๖ ม.ค. ๒๕๔๕
รังสีนอกโลก; การแผ่รังสีนอกโลก	extraterrestrial radiation	๒๖ ม.ค. ๒๕๔๕
ภาระการทำให้เย็น	cooling load	๒๖ ม.ค. ๒๕๔๕
ภาระความร้อน	heating load; heat load	๒๖ ม.ค. ๒๕๔๕
ภาระ	load	๒๖ ม.ค. ๒๕๔๕
มาตรอัตรารอบเชิงกล	mechanical tachometer	๒๖ ม.ค. ๒๕๔๕
มาตรอากาศไหล	airflow meter	๒๖ ม.ค. ๒๕๔๕
มาตรรังสี, เรดิโอมิเตอร์	radiometer	๒๖ ม.ค. ๒๕๔๕
มาตรรังสีอาทิตย์รวม, ไพรานอมิเตอร์	pyranometer	๒๖ ม.ค. ๒๕๔๕
มาตรรังสีอาทิตย์ตรง, ไพร์ฮีลิออมิเตอร์	pyrheliometer	๒๖ ม.ค. ๒๕๔๕
มาตรความร้อน	heat meter	๒๖ ม.ค. ๒๕๔๕
มาตรความเร็วลม	anemometer	๒๖ ม.ค. ๒๕๔๕
มาตรความดันของไหล, แมนอมิเตอร์	manometer	๒๖ ม.ค. ๒๕๔๕
มาตรฐานการปล่อย	emission standard	๒๖ ม.ค. ๒๕๔๕
มาตรดรรชนีหักเห	refractometer	๒๖ ม.ค. ๒๕๔๕
มาตรปริมาณความร้อน, แคลอริมิเตอร์	calorimeter	๒๖ ม.ค. ๒๕๔๕
ยานยนต์	motor vehicle	๒๖ ม.ค. ๒๕๔๕
aperture area	พื้นที่ช่องรับรังสี	๒๖ ม.ค. ๒๕๔๕
aspirator; vacuum pump	ปั๊มสุญญากาศ	๒๖ ม.ค. ๒๕๔๕
asynchronous machine	เครื่องจักรแบบอสมวาร	๒๖ ม.ค. ๒๕๔๕
atmospheric parameter	พารามิเตอร์บรรยากาศ	๒๖ ม.ค. ๒๕๔๕
atomiser; injector	หัวฉีด	๒๖ ม.ค. ๒๕๔๕
ยูแอลจี (แกโซลีนไร้สารตะกั่ว)	ULG (unleaded gasolene)	๒๖ ม.ค. ๒๕๔๕
ยูแอลพี (เบนซินไร้สารตะกั่ว)	ULP (unleaded petrol)	๒๖ ม.ค. ๒๕๔๕
ภูมิอากาศวิทยา	climatology	๒๖ ม.ค. ๒๕๔๕
ยูเทกติก	eutectic	๒๖ ม.ค. ๒๕๔๕
autoignition	การจุดระเบิดเอง	๒๖ ม.ค. ๒๕๔๕
auxiliary vane	ใบช่วย(หลบลม)	๒๖ ม.ค. ๒๕๔๕
available wind power	กำลังลมใช้ได้	๒๖ ม.ค. ๒๕๔๕
average wind speed	อัตราเร็วลมเฉลี่ย	๒๖ ม.ค. ๒๕๔๕
axial induction factor	ตัวประกอบเหนี่ยวนำตามแกน	๒๖ ม.ค. ๒๕๔๕
axial momentum theory	ทฤษฎีโมเมนตัมตามแกน	๒๖ ม.ค. ๒๕๔๕
azimuth angle	มุมแอซิมัท	๒๖ ม.ค. ๒๕๔๕
เลขเรย์โนลดส์	Reynolds number	๒๖ ม.ค. ๒๕๔๕
เลขเรย์ลี	Rayleigh number	๒๖ ม.ค. ๒๕๔๕
เลขออกเทนเครื่องยนต์ (เอ็มโอเอ็น)	motor octane number (MON)	๒๖ ม.ค. ๒๕๔๕
เลขออกเทน	octane number	๒๖ ม.ค. ๒๕๔๕
เลขกราสโฮฟ	Grashof number	๒๖ ม.ค. ๒๕๔๕
เลขซีเทน	cetane number	๒๖ ม.ค. ๒๕๔๕
เลขนัสเซลต์	Nusselt number	๒๖ ม.ค. ๒๕๔๕
เลขพรันด์เทิล	Prandtl number	๒๖ ม.ค. ๒๕๔๕
เลนส์เฟรสเนล	Fresnel lens	๒๖ ม.ค. ๒๕๔๕
มลพิษทางอากาศ	air pollution	๒๖ ม.ค. ๒๕๔๕
เกรเดียนต์อุณหภาพมหาสมุทร	ocean thermal gradient	๒๖ ม.ค. ๒๕๔๕
เกรเดียนต์อุณหภูมิ	temperature gradient	๒๖ ม.ค. ๒๕๔๕
แกโซฮอล	gasohol	๒๖ ม.ค. ๒๕๔๕
แกโซลีน	gasolene; gasoline	๒๖ ม.ค. ๒๕๔๕
แกโซลีนมีสารตะกั่ว	leaded gasolene	๒๖ ม.ค. ๒๕๔๕
แกโซลีนไร้สารตะกั่ว	nonleaded gasolene	๒๖ ม.ค. ๒๕๔๕
แกโซลีนไร้สารตะกั่ว (ยูแอลจี)	unleaded gasolene (ULG)	๒๖ ม.ค. ๒๕๔๕
แกโซลีนธรรมชาติ	casing head gasolene; natural gasolene	๒๖ ม.ค. ๒๕๔๕
แกโซลีนพิเศษ	premium gasolene; super gasolene	๒๖ ม.ค. ๒๕๔๕
แก๊ส	gas	๒๖ ม.ค. ๒๕๔๕
แก๊สปิโตรเลียมเหลว (แอลพีจี, แอลพีแก๊ส)	liquefied petroleum gas (LPG; LP-GAS)	๒๖ ม.ค. ๒๕๔๕
เขตสบาย	comfort zone	๒๖ ม.ค. ๒๕๔๕
โครงสร้างแลตทิซ	lattice structure	๒๖ ม.ค. ๒๕๔๕
เครื่องรับรู้, ตัวรับรู้, อุปกรณ์รับรู้	sensor	๒๖ ม.ค. ๒๕๔๕
เครื่องยนต์	engine	๒๖ ม.ค. ๒๕๔๕
เครื่องยนต์โรทารี	rotary-combustion engine; rotary engine	๒๖ ม.ค. ๒๕๔๕
เครื่องยนต์แวงเกล	Wankel engine; Wankel rotary engine	๒๖ ม.ค. ๒๕๔๕
เครื่องยนต์แก๊ส	gas engine	๒๖ ม.ค. ๒๕๔๕
เครื่องยนต์ใช้เชื้อเพลิงสองชนิด	dual fuel engine	๒๖ ม.ค. ๒๕๔๕
เครื่องยนต์แบบรูปตัววี	V-engine; V-type engine	๒๖ ม.ค. ๒๕๔๕
เครื่องยนต์แบบเผาไหม้ไอดีบาง	lean-burn engine; lean-burning engine	๒๖ ม.ค. ๒๕๔๕
เครื่องยนต์เผาไหม้ภายใน, เครื่องยนต์ไอซี	internal combustion engine; IC engine	๒๖ ม.ค. ๒๕๔๕
เครื่องยนต์เผาไหม้ภายนอก	external combustion engine	๒๖ ม.ค. ๒๕๔๕
เครื่องยนต์ลูกสูบ	piston engine; reciprocating engine	๒๖ ม.ค. ๒๕๔๕
เครื่องยนต์ไฮโดรคาร์บอน	hydrocarbon engine	๒๖ ม.ค. ๒๕๔๕
เครื่องยนต์ไอซี, เครื่องยนต์เผาไหม้ภายใน	IC engine; internal combustion engine	๒๖ ม.ค. ๒๕๔๕
เครื่องยนต์กังหันแก๊ส	gas turbine engine	๒๖ ม.ค. ๒๕๔๕
เครื่องยนต์ความร้อน	heat engine	๒๖ ม.ค. ๒๕๔๕
เครื่องยนต์จุดระเบิดด้วยการอัด, เครื่องยนต์ซีไอ	compression-ignition engine; CI engine	๒๖ ม.ค. ๒๕๔๕
เครื่องยนต์ซีไอ, เครื่องยนต์จุดระเบิดด้วยการอัด	CI engine; compression-ignition engine	๒๖ ม.ค. ๒๕๔๕
เครื่องยนต์ดีเซล	diesel engine	๒๖ ม.ค. ๒๕๔๕
เครื่องเป่าลม	blower	๒๖ ม.ค. ๒๕๔๕
เครื่องเป่าลมความดันต่ำ	low-pressure blower	๒๖ ม.ค. ๒๕๔๕
เครื่องมือกล	machine tool	๒๖ ม.ค. ๒๕๔๕
เครื่องวิเคราะห์แก๊ส	gas analyser	๒๖ ม.ค. ๒๕๔๕
เครื่องวิเคราะห์ไอเสีย	exhaust-gas analyser	๒๖ ม.ค. ๒๕๔๕
เครื่องสูบแรงเหวี่ยง, ปั๊มหอยโข่ง	centrifugal pump	๒๖ ม.ค. ๒๕๔๕
เครื่องสูบเชิงกล, ปั๊มเชิงกล	mechanical pump	๒๖ ม.ค. ๒๕๔๕
เครื่องสูบ(แบบ)ลูกสูบ, ปั๊ม(แบบ)ลูกสูบ	piston pump	๒๖ ม.ค. ๒๕๔๕
เครื่องสูบลม	air pump	๒๖ ม.ค. ๒๕๔๕
เครื่องสูบ(แบบ)ลูกสูบ, ปั๊ม(แบบ)ลูกสูบ	piston pump	๒๖ ม.ค. ๒๕๔๕
เครื่องสูบ, ปั๊ม; สูบ	pump	๒๖ ม.ค. ๒๕๔๕
เครื่องสูบขับด้วยลม, ปั๊มขับด้วยลม	wind driven pump	๒๖ ม.ค. ๒๕๔๕
เครื่องสูบน้ำรังสีอาทิตย์	solar water pump	๒๖ ม.ค. ๒๕๔๕
เครื่องอัดอากาศ	air compressor	๒๖ ม.ค. ๒๕๔๕
เครื่องกำเนิดไฟฟ้า	electric generator; generator	๒๖ ม.ค. ๒๕๔๕
เครื่องกล; -กล; เครื่องจักร	machine	๒๖ ม.ค. ๒๕๔๕
เครื่องกลั่นแบบถาด	basin still	๒๖ ม.ค. ๒๕๔๕
เครื่องกลั่นด้วยรังสีอาทิตย์	solar still	๒๖ ม.ค. ๒๕๔๕
เครื่องจักร; -กล; เครื่องกล	machine	๒๖ ม.ค. ๒๕๔๕
เครื่องจักร; ระบบเครื่องจักร	machinery	๒๖ ม.ค. ๒๕๔๕
เครื่องจักรแบบสมวาร	synchronous machine	๒๖ ม.ค. ๒๕๔๕
เครื่องจักรแบบสับกระแส	commutator machine	๒๖ ม.ค. ๒๕๔๕
เครื่องจักรแบบอสมวาร	asynchronous machine	๒๖ ม.ค. ๒๕๔๕
เครื่องจักรไอน้ำ	steam engine	๒๖ ม.ค. ๒๕๔๕
เครื่องจักรไอน้ำรังสีอาทิตย์	solar steam engine	๒๖ ม.ค. ๒๕๔๕
เครื่องจักรกล	mechanical machine	๒๖ ม.ค. ๒๕๔๕
เครื่องควบแน่น, คอนเดนเซอร์	condenser	๒๖ ม.ค. ๒๕๔๕
เครื่องประจุแบตเตอรี่	battery charger	๒๖ ม.ค. ๒๕๔๕
เครื่องปรับอากาศ	air conditioner	๒๖ ม.ค. ๒๕๔๕
เครื่องปฏิกรณ์อุณหภาพ	thermal reactor	๒๖ ม.ค. ๒๕๔๕
เครื่องฟอกไอเสียเชิงเร่งปฏิกิริยา, แคทาลิติกคอนเวอร์เตอร์	catalytic converter	๒๖ ม.ค. ๒๕๔๕
เครื่องฟอกไอเสียเชิงเร่งปฏิกิริยาสองทาง, แคทาลิติกคอนเวอร์เตอร์สองทาง	two-way catalytic converter	๒๖ ม.ค. ๒๕๔๕
เครื่องฟอกไอเสียเชิงเร่งปฏิกิริยาสามทาง, แคทาลิติกคอนเวอร์เตอร์สามทาง (ทีดับเบิลยูซี)	three-way catalytic converter (TWC)	๒๖ ม.ค. ๒๕๔๕
แคลอริมิเตอร์, มาตรปริมาณความร้อน	calorimeter	๒๖ ม.ค. ๒๕๔๕
แคทาลิติกคอนเวอร์เตอร์, เครื่องฟอกไอเสียเชิงเร่งปฏิกิริยา	catalytic converter	๒๖ ม.ค. ๒๕๔๕
แคทาลิติกคอนเวอร์เตอร์สองทาง, เครื่องฟอกไอเสียเชิงเร่งปฏิกิริยาสองทาง	two-way catalytic converter	๒๖ ม.ค. ๒๕๔๕
แคทาลิติกคอนเวอร์เตอร์สามทาง, เครื่องฟอกไอเสียเชิงเร่งปฏิกิริยาสามทาง (ทีดับเบิลยูซี)	three-way catalytic converter (TWC)	๒๖ ม.ค. ๒๕๔๕
เชื้อเพลิงดีเซล	diesel fuel	๒๖ ม.ค. ๒๕๔๕
เซลล์	cell	๒๖ ม.ค. ๒๕๔๕
เซลล์เชื้อเพลิง	fuel cell	๒๖ ม.ค. ๒๕๔๕
เซลล์ในแบตเตอรี่	battery cell	๒๖ ม.ค. ๒๕๔๕
เซลล์ซิลิคอน	silicon cell	๒๖ ม.ค. ๒๕๔๕
เซลล์สุริยะ	solar cell	๒๖ ม.ค. ๒๕๔๕
เดินเบา	idle; idling; tick-over	๒๖ ม.ค. ๒๕๔๕
เดคลิเนชัน; มุมบ่ายเบน	declination	๒๖ ม.ค. ๒๕๔๕
เตารังสีอาทิตย์	solar furnace	๒๖ ม.ค. ๒๕๔๕
แท่นทดสอบไดนาโมมิเตอร์เครื่องยนต์	engine dynamometer test bed	๒๖ ม.ค. ๒๕๔๕
เทอร์มอไซฟอน	thermo-syphon	๒๖ ม.ค. ๒๕๔๕
เทอร์มอคัปเปิล, คู่ควบอุณหภูมิ	thermocouple	๒๖ ม.ค. ๒๕๔๕
เที่ยงสุริยะ	solar noon	๒๖ ม.ค. ๒๕๔๕
ใบ	vane	๒๖ ม.ค. ๒๕๔๕
ใบเรือ	sailwing	๒๖ ม.ค. ๒๕๔๕
ใบข้าง(หลบลม)	side vane	๒๖ ม.ค. ๒๕๔๕
ใบข้าง(หลบลม)	side vane	๒๖ ม.ค. ๒๕๔๕
ใบช่วย(หลบลม)	auxiliary vane	๒๖ ม.ค. ๒๕๔๕
ใบช่วย(หลบลม)	auxiliary vane	๒๖ ม.ค. ๒๕๔๕
แบตเตอรี่	battery	๒๖ ม.ค. ๒๕๔๕
เบนซิน	petrol	๒๖ ม.ค. ๒๕๔๕
เบนซินไร้สารตะกั่ว (ยูแอลพี)	unleaded petrol (ULP)	๒๖ ม.ค. ๒๕๔๕
เบนซินพิเศษ	high-grade petrol	๒๖ ม.ค. ๒๕๔๕
แบบอย่างการไหล	flow pattern	๒๖ ม.ค. ๒๕๔๕
แบบจำลองคอมพิวเตอร์; ตัวแบบคอมพิวเตอร์	computer model	๒๖ ม.ค. ๒๕๔๕
แบบจำลองคณิตศาสตร์; ตัวแบบคณิตศาสตร์	mathematical model	๒๖ ม.ค. ๒๕๔๕
ใบพัด	impeller	๒๖ ม.ค. ๒๕๔๕
ใบพัดตัวหมุน, ใบพัดโรเตอร์	rotor blade	๒๖ ม.ค. ๒๕๔๕
ใบพับ(หลบลม)	hinged vane	๒๖ ม.ค. ๒๕๔๕
ใบพับ(หลบลม)	hinged vane	๒๖ ม.ค. ๒๕๔๕
แบบจำลองการแลกเปลี่ยนจลน์; ตัวแบบการแลกเปลี่ยนจลน์	kinetic exchange model	๒๖ ม.ค. ๒๕๔๕
โพรแทรกเตอร์วัดมุมเงา	shadow-angle protractor	๒๖ ม.ค. ๒๕๔๕
โพรไฟล์ภาระ	load profile	๒๖ ม.ค. ๒๕๔๕
โพรไฟล์ภาระอาคาร	building load profile	๒๖ ม.ค. ๒๕๔๕
โพรไฟล์ลม	wind profile	๒๖ ม.ค. ๒๕๔๕
โพลาไรเซชัน; การเกิดขั้ว	polarisation	๒๖ ม.ค. ๒๕๔๕
แพนอากาศ	aerofoil; airfoil	๒๖ ม.ค. ๒๕๔๕
โฟโตเซลล์	photocell	๒๖ ม.ค. ๒๕๔๕
แฟกเตอร์เสื่อมสภาพ; แฟกเตอร์สารติดผิว	fouling factor	๒๖ ม.ค. ๒๕๔๕
แฟกเตอร์มุมเอียง	tilt factor	๒๖ ม.ค. ๒๕๔๕
แฟกเตอร์มุมเอียงรังสีตรง	beam radiation tilt factor; beam tilt factor	๒๖ ม.ค. ๒๕๔๕
แฟกเตอร์สารติดผิว; แฟกเตอร์เสื่อมสภาพ	fouling factor	๒๖ ม.ค. ๒๕๔๕
โฟตอน	photon	๒๖ ม.ค. ๒๕๔๕
แฟนคอยล์	fan coil	๒๖ ม.ค. ๒๕๔๕
แฟกเตอร์กำลัง	power factor	๒๖ ม.ค. ๒๕๔๕
แฟกเตอร์ประสิทธิภาพตัวเก็บรังสี	collector efficiency factor	๒๖ ม.ค. ๒๕๔๕
มุมระดับความสูง	altitude angle	๒๖ ม.ค. ๒๕๔๕
มุมเอียง	tilt angle	๒๖ ม.ค. ๒๕๔๕
มุมแอซิมัท	azimuth angle	๒๖ ม.ค. ๒๕๔๕
มุมโพรไฟล์	profile angle	๒๖ ม.ค. ๒๕๔๕
มุมชั่วโมง	hour angle	๒๖ ม.ค. ๒๕๔๕
มุมตกกระทบ	incidence angle	๒๖ ม.ค. ๒๕๔๕
มุมปะทะ	angle of attack	๒๖ ม.ค. ๒๕๔๕
มุมตกกระทบของรังสีอาทิตย์	solar incidence angle	๒๖ ม.ค. ๒๕๔๕
มุมบ่ายเบน; เดคลิเนชัน	declination	๒๖ ม.ค. ๒๕๔๕
backfire	๑. จุดระเบิดย้อนกลับ๒. การจุดระเบิดย้อนกลับ	๒๖ ม.ค. ๒๕๔๕
basin still	เครื่องกลั่นแบบถาด	๒๖ ม.ค. ๒๕๔๕
battery element; element	ชุดแผ่นธาตุ	๒๖ ม.ค. ๒๕๔๕
battery separator; separator	แผ่นกั้นในแบตเตอรี่	๒๖ ม.ค. ๒๕๔๕
battery-capacity test; battery-load test	การทดสอบความจุแบตเตอรี่	๒๖ ม.ค. ๒๕๔๕
battery-load test; battery-capacity test	การทดสอบความจุแบตเตอรี่	๒๖ ม.ค. ๒๕๔๕
battery	แบตเตอรี่	๒๖ ม.ค. ๒๕๔๕
battery cell	เซลล์ในแบตเตอรี่	๒๖ ม.ค. ๒๕๔๕
battery charger	เครื่องประจุแบตเตอรี่	๒๖ ม.ค. ๒๕๔๕
battery charging	การประจุแบตเตอรี่, การอัดแบตเตอรี่	๒๖ ม.ค. ๒๕๔๕
beam radiation; direct radiation	การแผ่รังสีตรง	๒๖ ม.ค. ๒๕๔๕
beam radiation tilt factor; beam tilt factor	แฟกเตอร์มุมเอียงรังสีตรง	๒๖ ม.ค. ๒๕๔๕
beam tilt factor; beam radiation tilt factor	แฟกเตอร์มุมเอียงรังสีตรง	๒๖ ม.ค. ๒๕๔๕
bending stress	ความเค้นดัดโค้ง	๒๖ ม.ค. ๒๕๔๕
Betz coefficient	สัมประสิทธิ์เบ็ตซ์	๒๖ ม.ค. ๒๕๔๕
bioconversion	การเปลี่ยนเชิงชีวภาพ	๒๖ ม.ค. ๒๕๔๕
biosphere	ชีวภาค	๒๖ ม.ค. ๒๕๔๕
Biot modulus	บิโยต์มอดุลัส	๒๖ ม.ค. ๒๕๔๕
black body	วัตถุดำ	๒๖ ม.ค. ๒๕๔๕
blade element theory	ทฤษฎีส่วนของใบพัด	๒๖ ม.ค. ๒๕๔๕
Blasius equation	สมการเบลเซียส	๒๖ ม.ค. ๒๕๔๕
blow-back; pop-back; popping back; spit-back	การเผาไหม้ย้อนกลับ	๒๖ ม.ค. ๒๕๔๕
blower	เครื่องเป่าลม	๒๖ ม.ค. ๒๕๔๕
Bouguer’s law	กฎของบูแกร์	๒๖ ม.ค. ๒๕๔๕
breakerless ignition	การจุดระเบิดแบบไร้ทองขาว	๒๖ ม.ค. ๒๕๔๕
buckling	การโก่ง	๒๖ ม.ค. ๒๕๔๕
building code	ประมวลกฎหมายควบคุมอาคาร	๒๖ ม.ค. ๒๕๔๕
building load profile	โพรไฟล์ภาระอาคาร	๒๖ ม.ค. ๒๕๔๕
burnt gases	ไอที่ไหม้แล้ว	๒๖ ม.ค. ๒๕๔๕
calorific value	ค่าความร้อน	๒๖ ม.ค. ๒๕๔๕
calorimeter	มาตรปริมาณความร้อน, แคลอริมิเตอร์	๒๖ ม.ค. ๒๕๔๕
capacitor	ตัวเก็บประจุ	๒๖ ม.ค. ๒๕๔๕
carbon canister; charcoal canister	กล่องดักไอน้ำมันแบบใช้ถ่าน	๒๖ ม.ค. ๒๕๔๕
carbon dioxide	คาร์บอนไดออกไซด์	๒๖ ม.ค. ๒๕๔๕
carbon monoxide	คาร์บอนมอนอกไซด์	๒๖ ม.ค. ๒๕๔๕
carbonise	การเกิดคาร์บอน	๒๖ ม.ค. ๒๕๔๕
carburetion	การผสมน้ำมันกับอากาศ	๒๖ ม.ค. ๒๕๔๕
Carnot efficiency	ประสิทธิภาพคาร์โนต์	๒๖ ม.ค. ๒๕๔๕
casing head gasolene; natural gasolene	แกโซลีนธรรมชาติ	๒๖ ม.ค. ๒๕๔๕
catalytic converter	เครื่องฟอกไอเสียเชิงเร่งปฏิกิริยา, แคทาลิติกคอนเวอร์เตอร์	๒๖ ม.ค. ๒๕๔๕
cavitation	การเกิดโพรงเซลล์	๒๖ ม.ค. ๒๕๔๕
central receiver	ตัวรับรังสีรวมกลาง	๒๖ ม.ค. ๒๕๔๕
centrifugal pump	เครื่องสูบแรงเหวี่ยง, ปั๊มหอยโข่ง	๒๖ ม.ค. ๒๕๔๕
cetane number	เลขซีเทน	๒๖ ม.ค. ๒๕๔๕
charcoal canister; carbon canister	กล่องดักไอน้ำมันแบบใช้ถ่าน	๒๖ ม.ค. ๒๕๔๕
chord	คอร์ด	๒๖ ม.ค. ๒๕๔๕
CI engine; compression-ignition engine	เครื่องยนต์ซีไอ, เครื่องยนต์จุดระเบิดด้วยการอัด	๒๖ ม.ค. ๒๕๔๕
CI engine; compression-ignition engine	เครื่องยนต์จุดระเบิดด้วยการอัด, เครื่องยนต์ซีไอ	๒๖ ม.ค. ๒๕๔๕
clearness index	ดรรชนีความใส	๒๖ ม.ค. ๒๕๔๕
climatology	ภูมิอากาศวิทยา	๒๖ ม.ค. ๒๕๔๕
closed system	ระบบปิด	๒๖ ม.ค. ๒๕๔๕
วัสดุโปร่งใส	transparent material	๒๖ ม.ค. ๒๕๔๕
วัสดุฝ้า	opaque material	๒๖ ม.ค. ๒๕๔๕
วัฏจักร	cycle	๒๖ ม.ค. ๒๕๔๕
วัฏจักรแรงคิน	Rankine cycle	๒๖ ม.ค. ๒๕๔๕
วัฏจักรสองจังหวะ	two-cycle; two-stroke; two-stroke cycle	๒๖ ม.ค. ๒๕๔๕
วัฏจักรสี่จังหวะ	four-cycle; four-stroke; four-stroke cycle	๒๖ ม.ค. ๒๕๔๕
วัฏจักรดีเซล	diesel cycle	๒๖ ม.ค. ๒๕๔๕
วัฏจักรทำความเย็น	refrigeration cycle	๒๖ ม.ค. ๒๕๔๕
วัฏจักรอัดไอ	vapour-compression cycle	๒๖ ม.ค. ๒๕๔๕
วัฏจักรขับทดสอบ	driving cycle	๒๖ ม.ค. ๒๕๔๕
วัตถุดำ	black body	๒๖ ม.ค. ๒๕๔๕
coefficient of performance	สัมประสิทธิ์สมรรถนะ	๒๖ ม.ค. ๒๕๔๕
coil ignition	การจุดระเบิดด้วยคอยล์	๒๖ ม.ค. ๒๕๔๕
cold plug	หัวเทียนเย็น	๒๖ ม.ค. ๒๕๔๕
collector efficiency factor	แฟกเตอร์ประสิทธิภาพตัวเก็บรังสี	๒๖ ม.ค. ๒๕๔๕
combination emission control system	ระบบควบคุมไอเสียแบบผสม	๒๖ ม.ค. ๒๕๔๕
combustion	การเผาไหม้	๒๖ ม.ค. ๒๕๔๕
combustion chamber	ห้องเผาไหม้	๒๖ ม.ค. ๒๕๔๕
comfort zone	เขตสบาย	๒๖ ม.ค. ๒๕๔๕
commutator machine	เครื่องจักรแบบสับกระแส	๒๖ ม.ค. ๒๕๔๕
compound parabolic concentrator; compound parabolic concentrating collector; CPC collector	ตัวเก็บรังสีแบบซีพีซี	๒๖ ม.ค. ๒๕๔๕
compound parabolic concentrating collector; compound parabolic concentrator; CPC collector	ตัวเก็บรังสีแบบซีพีซี	๒๖ ม.ค. ๒๕๔๕
compression pressure	ความดันอัด	๒๖ ม.ค. ๒๕๔๕
compression ratio	อัตราส่วนการอัด	๒๖ ม.ค. ๒๕๔๕
compression stroke	จังหวะอัด	๒๖ ม.ค. ๒๕๔๕
compression-ignition engine; CI engine	เครื่องยนต์ซีไอ, เครื่องยนต์จุดระเบิดด้วยการอัด	๒๖ ม.ค. ๒๕๔๕
compression-ignition engine; CI engine	เครื่องยนต์จุดระเบิดด้วยการอัด, เครื่องยนต์ซีไอ	๒๖ ม.ค. ๒๕๔๕
computer model	๑. แบบจำลองคอมพิวเตอร์๒. ตัวแบบคอมพิวเตอร์	๒๖ ม.ค. ๒๕๔๕
concentrating collector	ตัวเก็บรังสีแบบรวม	๒๖ ม.ค. ๒๕๔๕
concentration ratio	อัตราส่วนการรวมรังสี	๒๖ ม.ค. ๒๕๔๕
concentric-tube collector	ตัวเก็บรังสีแบบท่อร่วมศูนย์กลาง	๒๖ ม.ค. ๒๕๔๕
condenser	เครื่องควบแน่น, คอนเดนเซอร์	๒๖ ม.ค. ๒๕๔๕
condensation	การควบแน่น	๒๖ ม.ค. ๒๕๔๕
conductance	ความนำ	๒๖ ม.ค. ๒๕๔๕
conduction	การนำ	๒๖ ม.ค. ๒๕๔๕
conductivity	สภาพนำ	๒๖ ม.ค. ๒๕๔๕
conduit	๑. ท่อร้อยสาย๒. ท่อ	๒๖ ม.ค. ๒๕๔๕
continuous tracking	การติดตามต่อเนื่อง	๒๖ ม.ค. ๒๕๔๕
continuous tracking collector	ตัวเก็บรังสีแบบติดตามต่อเนื่อง	๒๖ ม.ค. ๒๕๔๕
contra flow; counter flow	การไหลสวนทาง	๒๖ ม.ค. ๒๕๔๕
control device	กลอุปกรณ์ควบคุม	๒๖ ม.ค. ๒๕๔๕
control system	ระบบควบคุม	๒๖ ม.ค. ๒๕๔๕
convection	การพา	๒๖ ม.ค. ๒๕๔๕
convection coefficient	สัมประสิทธิ์การพา	๒๖ ม.ค. ๒๕๔๕
cooling load	ภาระการทำให้เย็น	๒๖ ม.ค. ๒๕๔๕
cooling system	ระบบทำให้เย็น	๒๖ ม.ค. ๒๕๔๕
counter flow; contra flow	การไหลสวนทาง	๒๖ ม.ค. ๒๕๔๕
coupling	๑. การคู่ควบ๒. คู่ต่อ	๒๖ ม.ค. ๒๕๔๕
วิชาความเย็นยวดยิ่ง, อติสีตศาสตร์	cryogenics	๒๖ ม.ค. ๒๕๔๕
วิธีการเปลี่ยนรูปพลังงาน	energy conversion method	๒๖ ม.ค. ๒๕๔๕
วิธีองศา-วัน, วิธีดีกรี-เดย์	degree-day method	๒๖ ม.ค. ๒๕๔๕
วิธีการทำให้เหมาะที่สุด	optimisation methodology	๒๖ ม.ค. ๒๕๔๕
วิธีดีกรี-เดย์, วิธีองศา-วัน	degree-day method	๒๖ ม.ค. ๒๕๔๕
CPC collector; compound parabolic concentrating collector; compound parabolic concentrator	ตัวเก็บรังสีแบบซีพีซี	๒๖ ม.ค. ๒๕๔๕
cross flow	การไหลตามขวาง	๒๖ ม.ค. ๒๕๔๕
cryogenics	วิชาความเย็นยวดยิ่ง, อติสีตศาสตร์	๒๖ ม.ค. ๒๕๔๕
cumulative distribution	การแจกแจงสะสม	๒๖ ม.ค. ๒๕๔๕
cut-in wind speed	อัตราเร็วลมเริ่มงาน	๒๖ ม.ค. ๒๕๔๕
cut-out wind speed	อัตราเร็วลมหยุดงาน	๒๖ ม.ค. ๒๕๔๕
cycle	วัฏจักร	๒๖ ม.ค. ๒๕๔๕
cylindrical collector	ตัวเก็บรังสีแบบทรงกระบอก	๒๖ ม.ค. ๒๕๔๕
cylinder	๑. กระบอกสูบ๒. กระบอก	๒๖ ม.ค. ๒๕๔๕
วงจรอุณหภาพ	thermal circuit	๒๖ ม.ค. ๒๕๔๕
วงจรตัวเก็บความร้อน	heat collector loop	๒๖ ม.ค. ๒๕๔๕
วงจรการไหล	flow circuit	๒๖ ม.ค. ๒๕๔๕
daily efficiency	ประสิทธิภาพรายวัน	๒๖ ม.ค. ๒๕๔๕
damping coefficient	สัมประสิทธิ์การหน่วง	๒๖ ม.ค. ๒๕๔๕
declination	๑. เดคลิเนชัน๒. มุมบ่ายเบน	๒๖ ม.ค. ๒๕๔๕
degree-day method	วิธีองศา-วัน, วิธีดีกรี-เดย์	๒๖ ม.ค. ๒๕๔๕
dehumidification	การลดความชื้น	๒๖ ม.ค. ๒๕๔๕
design wind speed	อัตราเร็วลมที่จุดออกแบบ	๒๖ ม.ค. ๒๕๔๕
desiccant	สารดูดความชื้น	๒๖ ม.ค. ๒๕๔๕
detonation	การระเบิดรุนแรง	๒๖ ม.ค. ๒๕๔๕
diesel cycle	วัฏจักรดีเซล	๒๖ ม.ค. ๒๕๔๕
diesel engine	เครื่องยนต์ดีเซล	๒๖ ม.ค. ๒๕๔๕
diesel fuel	เชื้อเพลิงดีเซล	๒๖ ม.ค. ๒๕๔๕
diffusivity	สภาพแพร่	๒๖ ม.ค. ๒๕๔๕
diffuse radiation	๑. การแผ่รังสีกระจาย๒. รังสีกระจาย	๒๖ ม.ค. ๒๕๔๕
diffuser	ดิฟฟิวเซอร์	๒๖ ม.ค. ๒๕๔๕
diffusion	การแพร่	๒๖ ม.ค. ๒๕๔๕
direct injection	การฉีดน้ำมันตรง	๒๖ ม.ค. ๒๕๔๕
direct radiation; beam radiation	การแผ่รังสีตรง	๒๖ ม.ค. ๒๕๔๕
displacement; engine displacement	ความจุเครื่องยนต์	๒๖ ม.ค. ๒๕๔๕
distillation	การกลั่น	๒๖ ม.ค. ๒๕๔๕
distribution	๑. การแจกแจง๒. การจ่าย	๒๖ ม.ค. ๒๕๔๕
distribution conduit	ท่อจ่าย	๒๖ ม.ค. ๒๕๔๕
drag	แรงต้าน	๒๖ ม.ค. ๒๕๔๕
drag coefficient	สัมประสิทธิ์แรงต้าน	๒๖ ม.ค. ๒๕๔๕
drag lift ratio	อัตราส่วนแรงต้านต่อแรงยก	๒๖ ม.ค. ๒๕๔๕
drag propulsion	การขับดันด้วยแรงต้าน	๒๖ ม.ค. ๒๕๔๕
driving cycle	วัฏจักรขับทดสอบ	๒๖ ม.ค. ๒๕๔๕
dual fuel engine	เครื่องยนต์ใช้เชื้อเพลิงสองชนิด	๒๖ ม.ค. ๒๕๔๕
dual ignition system	ระบบจุดระเบิดคู่	๒๖ ม.ค. ๒๕๔๕
duct	๑. ท่อลม๒. ท่อ	๒๖ ม.ค. ๒๕๔๕
duration distribution	การแจกแจงช่วงเวลา	๒๖ ม.ค. ๒๕๔๕
dynamo	ไดนาโม	๒๖ ม.ค. ๒๕๔๕
สมรรถนะ	performance	๒๖ ม.ค. ๒๕๔๕
สระรังสีอาทิตย์	solar pond	๒๖ ม.ค. ๒๕๔๕
สระรังสีอาทิตย์แบบไม่พาความร้อน	nonconvecting solar pond	๒๖ ม.ค. ๒๕๔๕
หม้อสะสมไฟฟ้า	accumulator	๒๖ ม.ค. ๒๕๔๕
หม้อน้ำแบบท่อครีบ	tube-and-fin radiator	๒๖ ม.ค. ๒๕๔๕
หมอกปนควันแบบโฟโตเคมี	photochemical smog	๒๖ ม.ค. ๒๕๔๕
สภาพแพร่	diffusivity	๒๖ ม.ค. ๒๕๔๕
สภาพแพร่โมเมนตัม	momentum diffusivity	๒๖ ม.ค. ๒๕๔๕
สภาพนำ	conductivity	๒๖ ม.ค. ๒๕๔๕
early fuel evaporation system; EFE system	ระบบทำให้เชื้อเพลิงระเหยก่อน, ระบบอีเอฟอี	๒๖ ม.ค. ๒๕๔๕
สมการความส่งผ่านดัดแปร	modified transmittance equation	๒๖ ม.ค. ๒๕๔๕
สมการเบลเซียส	Blasius equation	๒๖ ม.ค. ๒๕๔๕
สมบัติอุณหภาพของโลหะ	thermal properties of metal	๒๖ ม.ค. ๒๕๔๕
สเปกตรัมรังสีอาทิตย์	solar spectrum	๒๖ ม.ค. ๒๕๔๕
สวิตช์แสงอาทิตย์	sunshine switch	๒๖ ม.ค. ๒๕๔๕
economiser	ตัวประหยัดน้ำมัน	๒๖ ม.ค. ๒๕๔๕
ส่วนในล้านส่วน (พีพีเอ็ม)	parts per million (ppm)	๒๖ ม.ค. ๒๕๔๕
ห้องเผาไหม้	combustion chamber	๒๖ ม.ค. ๒๕๔๕
ห้องเผาไหม้ก่อน	prechamber; precombustion chamber	๒๖ ม.ค. ๒๕๔๕
ห้องเผาไหม้ทรงลิ่ม	wedge combustion chamber	๒๖ ม.ค. ๒๕๔๕
ห้องลม; ห้องอากาศ	air chamber	๒๖ ม.ค. ๒๕๔๕
EFE system; early fuel evaporation system	ระบบอีเอฟอี, ระบบทำให้เชื้อเพลิงระเหยก่อน	๒๖ ม.ค. ๒๕๔๕
effectiveness	ความยังผล, ประสิทธิผล	๒๖ ม.ค. ๒๕๔๕
efficiency	ประสิทธิภาพ	๒๖ ม.ค. ๒๕๔๕
EFI system; electronic fuel-injection system	ระบบอีเอฟไอ, ระบบฉีดเชื้อเพลิงแบบอิเล็กทรอนิกส์	๒๖ ม.ค. ๒๕๔๕
EGR system; exhaust-gas recirculation system	ระบบอีจีอาร์, ระบบหมุนเวียนไอเสีย	๒๖ ม.ค. ๒๕๔๕
หอผลิตกำลัง	power tower	๒๖ ม.ค. ๒๕๔๕
ELB system; electronic lean-burn system	ระบบอีแอลบี, ระบบเผาไหม้ไอดีบางโดยอิเล็กทรอนิกส์	๒๖ ม.ค. ๒๕๔๕
electric generator; generator	เครื่องกำเนิดไฟฟ้า	๒๖ ม.ค. ๒๕๔๕
electric motor	มอเตอร์ไฟฟ้า	๒๖ ม.ค. ๒๕๔๕
electronic carburetted fuel system	ระบบเชื้อเพลิงใช้คาร์บูเรเตอร์แบบอิเล็กทรอนิกส์	๒๖ ม.ค. ๒๕๔๕
electronic fuel-injection system; EFI system	ระบบฉีดเชื้อเพลิงแบบอิเล็กทรอนิกส์, ระบบอีเอฟไอ	๒๖ ม.ค. ๒๕๔๕
electronic lean-burn system; ELB system	ระบบเผาไหม้ไอดีบางโดยอิเล็กทรอนิกส์, ระบบอีแอลบี	๒๖ ม.ค. ๒๕๔๕
element; battery element	ชุดแผ่นธาตุ	๒๖ ม.ค. ๒๕๔๕
emittance	ความเปล่ง	๒๖ ม.ค. ๒๕๔๕
emission control	การควบคุมการปล่อย	๒๖ ม.ค. ๒๕๔๕
emission standard	มาตรฐานการปล่อย	๒๖ ม.ค. ๒๕๔๕
emissive power	กำลังการเปล่ง	๒๖ ม.ค. ๒๕๔๕
สัมประสิทธิ์แรงยก	lift coefficient	๒๖ ม.ค. ๒๕๔๕
สัมประสิทธิ์แรงต้าน	drag coefficient	๒๖ ม.ค. ๒๕๔๕
สัมประสิทธิ์การสูญเสีย	loss coefficient	๒๖ ม.ค. ๒๕๔๕
สัมประสิทธิ์การสูญเสียความร้อน	heat loss coefficient	๒๖ ม.ค. ๒๕๔๕
สัมประสิทธิ์การหน่วง	damping coefficient	๒๖ ม.ค. ๒๕๔๕
สัมประสิทธิ์การถ่ายโอนความร้อน	heat-transfer coefficient	๒๖ ม.ค. ๒๕๔๕
สัมประสิทธิ์แรงต้านอากาศพลศาสตร์	aerodynamic drag coefficient	๒๖ ม.ค. ๒๕๔๕
สัมประสิทธิ์เอกซ์ทิงชัน	extinction coefficient	๒๖ ม.ค. ๒๕๔๕
สัมประสิทธิ์เบ็ตซ์	Betz coefficient	๒๖ ม.ค. ๒๕๔๕
สัมประสิทธิ์สมรรถนะ	coefficient of performance	๒๖ ม.ค. ๒๕๔๕
สัมประสิทธิ์การพา	convection coefficient	๒๖ ม.ค. ๒๕๔๕
สัมประสิทธิ์กำลัง(งาน)	power coefficient	๒๖ ม.ค. ๒๕๔๕
สัมประสิทธิ์กำลัง(งาน)	power coefficient	๒๖ ม.ค. ๒๕๔๕
สัมประสิทธิ์ทอร์ก	torque coefficient	๒๖ ม.ค. ๒๕๔๕
หัวเทียนเย็น	cold plug	๒๖ ม.ค. ๒๕๔๕
หัวฉีด	atomiser; injector	๒๖ ม.ค. ๒๕๔๕
หัวฉีดเชื้อเพลิง	fuel injector	๒๖ ม.ค. ๒๕๔๕
end-gas	ไอดีริมห้องเผาไหม้	๒๖ ม.ค. ๒๕๔๕
endergonic process	กระบวนการเอนเดอร์โกนิก	๒๖ ม.ค. ๒๕๔๕
endothermic reaction	ปฏิกิริยาแบบดูดกลืนความร้อน	๒๖ ม.ค. ๒๕๔๕
energetic efficiency; exergetic efficiency; rational efficiency; second law efficiency	ประสิทธิภาพตามกฎข้อที่สอง	๒๖ ม.ค. ๒๕๔๕
energy consumption	การบริโภคพลังงาน, การสิ้นเปลืองพลังงาน	๒๖ ม.ค. ๒๕๔๕
energy conversion method	วิธีการเปลี่ยนรูปพลังงาน	๒๖ ม.ค. ๒๕๔๕
energy conversion process	กระบวนการเปลี่ยนรูปพลังงาน	๒๖ ม.ค. ๒๕๔๕
energy distribution	การจ่ายพลังงาน	๒๖ ม.ค. ๒๕๔๕
energy gap	ค่าช่องว่างพลังงาน	๒๖ ม.ค. ๒๕๔๕
energy in	พลังงานเข้า	๒๖ ม.ค. ๒๕๔๕
energy input	พลังงานใส่เข้า	๒๖ ม.ค. ๒๕๔๕
energy out	พลังงานออก	๒๖ ม.ค. ๒๕๔๕
energy output	พลังงานออกใช้	๒๖ ม.ค. ๒๕๔๕
energy pattern factor	ตัวประกอบแบบรูปพลังงาน	๒๖ ม.ค. ๒๕๔๕
energy plantation	ไร่พลังงาน	๒๖ ม.ค. ๒๕๔๕
energy transport	การขนส่งพลังงาน	๒๖ ม.ค. ๒๕๔๕
engine	เครื่องยนต์	๒๖ ม.ค. ๒๕๔๕
engine displacement; displacement	ความจุเครื่องยนต์	๒๖ ม.ค. ๒๕๔๕
engine dynamometer test bed	แท่นทดสอบไดนาโมมิเตอร์เครื่องยนต์	๒๖ ม.ค. ๒๕๔๕
engine efficiency	ประสิทธิภาพเครื่องยนต์	๒๖ ม.ค. ๒๕๔๕
engine power	กำลังเครื่องยนต์	๒๖ ม.ค. ๒๕๔๕
engine speed	อัตราเร็วเครื่องยนต์	๒๖ ม.ค. ๒๕๔๕
enthalpy	เอนทัลปี	๒๖ ม.ค. ๒๕๔๕
entropy	เอนโทรปี	๒๖ ม.ค. ๒๕๔๕
ศักย์ลม	wind potential	๒๖ ม.ค. ๒๕๔๕
สารมลพิษในไอเสีย	exhaust emissions	๒๖ ม.ค. ๒๕๔๕
สารเติมแต่ง	additive	๒๖ ม.ค. ๒๕๔๕
สารกันเยือกแข็ง	antifreeze	๒๖ ม.ค. ๒๕๔๕
สารกันน็อก	antiknock compound	๒๖ ม.ค. ๒๕๔๕
สารดูดกลืน	absorbant; absorbent	๒๖ ม.ค. ๒๕๔๕
สารดูดความชื้น	desiccant	๒๖ ม.ค. ๒๕๔๕
สารทำความเย็น	refrigerant	๒๖ ม.ค. ๒๕๔๕
สารผสมอากาศกับเชื้อเพลิง, ไอดี	air-fuel mixture; fuel mixture; mixture	๒๖ ม.ค. ๒๕๔๕
สิ่งปิดโปร่งใส	transparent cover	๒๖ ม.ค. ๒๕๔๕
eutectic	ยูเทกติก	๒๖ ม.ค. ๒๕๔๕
ศูนย์สัมบูรณ์	absolute zero	๒๖ ม.ค. ๒๕๔๕
evaporative control system; fuel-vapour recovery system; vapour-recovery system; vapour-saver system; vehicle vapour recovery	ระบบควบคุมการระเหย	๒๖ ม.ค. ๒๕๔๕
evacuated-tube collector	ตัวเก็บรังสีแบบท่อสุญญากาศ	๒๖ ม.ค. ๒๕๔๕
สูบ; เครื่องสูบ, ปั๊ม	pump	๒๖ ม.ค. ๒๕๔๕
evaporative cooler	ตัวทำความเย็นแบบระเหย	๒๖ ม.ค. ๒๕๔๕
exergetic efficiency; energetic efficiency; rational efficiency; second law efficiency	ประสิทธิภาพตามกฎข้อที่สอง	๒๖ ม.ค. ๒๕๔๕
exergonic process	กระบวนการเอกเซอร์โกนิก	๒๖ ม.ค. ๒๕๔๕
exhaust-gas recirculation system; EGR system	ระบบหมุนเวียนไอเสีย, ระบบอีจีอาร์	๒๖ ม.ค. ๒๕๔๕
exhaust emissions	สารมลพิษในไอเสีย	๒๖ ม.ค. ๒๕๔๕
exhaust stroke	จังหวะคาย	๒๖ ม.ค. ๒๕๔๕
exhaust system	ระบบท่อไอเสีย	๒๖ ม.ค. ๒๕๔๕
exhaust-gas analyser	เครื่องวิเคราะห์ไอเสีย	๒๖ ม.ค. ๒๕๔๕
exothermic reaction	ปฏิกิริยาแบบคายความร้อน	๒๖ ม.ค. ๒๕๔๕
expander turbine	กังหันแบบไอขยายตัว	๒๖ ม.ค. ๒๕๔๕
expansion tank	ถังรับการขยาย	๒๖ ม.ค. ๒๕๔๕
external combustion engine	เครื่องยนต์เผาไหม้ภายนอก	๒๖ ม.ค. ๒๕๔๕
extinction coefficient	สัมประสิทธิ์เอกซ์ทิงชัน	๒๖ ม.ค. ๒๕๔๕
extraterrestrial radiation	๑. การแผ่รังสีนอกโลก๒. รังสีนอกโลก	๒๖ ม.ค. ๒๕๔๕
หลอด; ท่อ	tube	๒๖ ม.ค. ๒๕๔๕
สถิตยศาสตร์ของไหล	fluid statics	๒๖ ม.ค. ๒๕๔๕
สนามการไหล	flow field	๒๖ ม.ค. ๒๕๔๕
f-chart	แผนภูมิเอฟ	๒๖ ม.ค. ๒๕๔๕
fan	พัดลม	๒๖ ม.ค. ๒๕๔๕
fan coil	แฟนคอยล์	๒๖ ม.ค. ๒๕๔๕
fiberglass	ไฟเบอร์กลาสส์	๒๖ ม.ค. ๒๕๔๕
filter	ตัวกรอง	๒๖ ม.ค. ๒๕๔๕
firing order	ลำดับการจุดระเบิด	๒๖ ม.ค. ๒๕๔๕
first law efficiency	ประสิทธิภาพตามกฎข้อที่หนึ่ง	๒๖ ม.ค. ๒๕๔๕
flash point	จุดวาบไฟ	๒๖ ม.ค. ๒๕๔๕
flat-plate collector	ตัวเก็บรังสีแบบแผ่นราบ	๒๖ ม.ค. ๒๕๔๕
flow circuit	วงจรการไหล	๒๖ ม.ค. ๒๕๔๕
flow field	สนามการไหล	๒๖ ม.ค. ๒๕๔๕
flow friction	ความเสียดทานการไหล	๒๖ ม.ค. ๒๕๔๕
flow pattern	แบบอย่างการไหล	๒๖ ม.ค. ๒๕๔๕
flow	การไหล	๒๖ ม.ค. ๒๕๔๕
fluid	ของไหล	๒๖ ม.ค. ๒๕๔๕
fluid dynamics	พลศาสตร์ของไหล	๒๖ ม.ค. ๒๕๔๕
fluid flywheel	ล้อตุนกำลังแบบของไหล	๒๖ ม.ค. ๒๕๔๕
fluid mechanics	กลศาสตร์ของไหล	๒๖ ม.ค. ๒๕๔๕
fluid statics	สถิตยศาสตร์ของไหล	๒๖ ม.ค. ๒๕๔๕
flywheel	ล้อตุนกำลัง	๒๖ ม.ค. ๒๕๔๕
focusing collector	ตัวเก็บรังสีแบบโฟกัส	๒๖ ม.ค. ๒๕๔๕
forced circulation system	ระบบหมุนเวียนแบบบังคับ	๒๖ ม.ค. ๒๕๔๕
forced convection	การพาแบบบังคับ	๒๖ ม.ค. ๒๕๔๕
four-cycle; four-stroke; four-stroke cycle	วัฏจักรสี่จังหวะ	๒๖ ม.ค. ๒๕๔๕
fouling factor	๑. แฟกเตอร์เสื่อมสภาพ๒. แฟกเตอร์สารติดผิว	๒๖ ม.ค. ๒๕๔๕
Fourier’s law	กฎของฟูริเอร์	๒๖ ม.ค. ๒๕๔๕
four-stroke; four-cycle; four-stroke cycle	วัฏจักรสี่จังหวะ	๒๖ ม.ค. ๒๕๔๕
four-stroke cycle; four-cycle; four-stroke	วัฏจักรสี่จังหวะ	๒๖ ม.ค. ๒๕๔๕
free convection	การพาแบบเสรี [มีความหมายเหมือนกับ natural convection]	๒๖ ม.ค. ๒๕๔๕
freeze protection	การป้องกันการเยือกแข็ง	๒๖ ม.ค. ๒๕๔๕
frequency distribution	การแจกแจงความถี่	๒๖ ม.ค. ๒๕๔๕
friction force	แรงเสียดทาน	๒๖ ม.ค. ๒๕๔๕
Fresnel lens	เลนส์เฟรสเนล	๒๖ ม.ค. ๒๕๔๕
friction power	กำลังเสียดทาน	๒๖ ม.ค. ๒๕๔๕
frictional loss	ความสูญเสียจากการเสียดทาน	๒๖ ม.ค. ๒๕๔๕
fuel cell	เซลล์เชื้อเพลิง	๒๖ ม.ค. ๒๕๔๕
fuel system	ระบบเชื้อเพลิง	๒๖ ม.ค. ๒๕๔๕
fuel-injection system	ระบบฉีดเชื้อเพลิง	๒๖ ม.ค. ๒๕๔๕
fuel injector	หัวฉีดเชื้อเพลิง	๒๖ ม.ค. ๒๕๔๕
fuel knock	น็อกจากเชื้อเพลิง	๒๖ ม.ค. ๒๕๔๕
fuel mixture; air-fuel mixture; mixture	ไอดี, สารผสมอากาศกับเชื้อเพลิง	๒๖ ม.ค. ๒๕๔๕
fuel-vapour recovery system; evaporative control system; vapour-recovery system; vapour-saver system; vehicle vapour recovery	ระบบควบคุมการระเหย	๒๖ ม.ค. ๒๕๔๕
gas	แก๊ส	๒๖ ม.ค. ๒๕๔๕
gas analyser	เครื่องวิเคราะห์แก๊ส	๒๖ ม.ค. ๒๕๔๕
gas engine	เครื่องยนต์แก๊ส	๒๖ ม.ค. ๒๕๔๕
gas turbine engine	เครื่องยนต์กังหันแก๊ส	๒๖ ม.ค. ๒๕๔๕
gasoline; gasolene	แกโซลีน	๒๖ ม.ค. ๒๕๔๕
gasohol	แกโซฮอล	๒๖ ม.ค. ๒๕๔๕
gasolene; gasoline	แกโซลีน	๒๖ ม.ค. ๒๕๔๕
generator; electric generator	เครื่องกำเนิดไฟฟ้า	๒๖ ม.ค. ๒๕๔๕
global radiation	รังสีรวม	๒๖ ม.ค. ๒๕๔๕
Grashof number	เลขกราสโฮฟ	๒๖ ม.ค. ๒๕๔๕
greenhouse	เรือนกระจก	๒๖ ม.ค. ๒๕๔๕
gross power	กำลังรวบยอด	๒๖ ม.ค. ๒๕๔๕
gross torque	ทอร์กรวบยอด	๒๖ ม.ค. ๒๕๔๕
gyroscopic effect	ผลไจโรสโคป	๒๖ ม.ค. ๒๕๔๕
heat collector loop	วงจรตัวเก็บความร้อน	๒๖ ม.ค. ๒๕๔๕
heat load; heating load	ภาระความร้อน	๒๖ ม.ค. ๒๕๔๕
heat loss	การสูญเสียความร้อน	๒๖ ม.ค. ๒๕๔๕
heat loss coefficient	สัมประสิทธิ์การสูญเสียความร้อน	๒๖ ม.ค. ๒๕๔๕
heat meter	มาตรความร้อน	๒๖ ม.ค. ๒๕๔๕
heat engine	เครื่องยนต์ความร้อน	๒๖ ม.ค. ๒๕๔๕
heat exchanger	อุปกรณ์แลกเปลี่ยนความร้อน	๒๖ ม.ค. ๒๕๔๕
heat gain	การได้ความร้อน	๒๖ ม.ค. ๒๕๔๕
heat pump	ฮีตปั๊ม	๒๖ ม.ค. ๒๕๔๕
heat source	แหล่งให้ความร้อน	๒๖ ม.ค. ๒๕๔๕
heated-air system	ระบบอุ่นอากาศ	๒๖ ม.ค. ๒๕๔๕
heating	การทำความร้อน	๒๖ ม.ค. ๒๕๔๕
heating control	๑. การควบคุมการทำความร้อน๒. ตัวควบคุมการทำความร้อน	๒๖ ม.ค. ๒๕๔๕
heating load; heat load	ภาระความร้อน	๒๖ ม.ค. ๒๕๔๕
heatsink	แหล่งรับความร้อน	๒๖ ม.ค. ๒๕๔๕
heat transfer	การถ่ายโอนความร้อน	๒๖ ม.ค. ๒๕๔๕
heat-transfer coefficient	สัมประสิทธิ์การถ่ายโอนความร้อน	๒๖ ม.ค. ๒๕๔๕
HEI (high-energy ignition system)	เอชอีไอ (ระบบจุดระเบิดพลังงานสูง)	๒๖ ม.ค. ๒๕๔๕
heliodon	ฮีลิโอดอน	๒๖ ม.ค. ๒๕๔๕
heliostat	ฮีลิโอสแตต	๒๖ ม.ค. ๒๕๔๕
high compression	การอัดสูง	๒๖ ม.ค. ๒๕๔๕
high-energy ignition system (HEI)	ระบบจุดระเบิดพลังงานสูง (เอชอีไอ)	๒๖ ม.ค. ๒๕๔๕
high-grade petrol	เบนซินพิเศษ [มีความหมายเหมือนกับ premium gasolene; super gasolene]	๒๖ ม.ค. ๒๕๔๕
high-pressure line	ท่อความดันสูง	๒๖ ม.ค. ๒๕๔๕
hinged vane	ใบพับ(หลบลม)	๒๖ ม.ค. ๒๕๔๕
honeycomb collector	ตัวเก็บรังสีแบบรังผึ้ง	๒๖ ม.ค. ๒๕๔๕
hot-air system	ระบบอากาศร้อน	๒๖ ม.ค. ๒๕๔๕
hot-water system	ระบบน้ำร้อน	๒๖ ม.ค. ๒๕๔๕
hour angle	มุมชั่วโมง	๒๖ ม.ค. ๒๕๔๕
hydrocarbon engine	เครื่องยนต์ไฮโดรคาร์บอน	๒๖ ม.ค. ๒๕๔๕
hydronic heating system	ระบบทำความร้อนแบบใช้น้ำ	๒๖ ม.ค. ๒๕๔๕
IC engine; internal combustion engine	เครื่องยนต์ไอซี, เครื่องยนต์เผาไหม้ภายใน	๒๖ ม.ค. ๒๕๔๕
IC engine; internal combustion engine	เครื่องยนต์เผาไหม้ภายใน, เครื่องยนต์ไอซี	๒๖ ม.ค. ๒๕๔๕
idle mixture	ไอดีเดินเบา	๒๖ ม.ค. ๒๕๔๕
idle speed	อัตราเร็วเดินเบา	๒๖ ม.ค. ๒๕๔๕
idle; idling; tick-over	เดินเบา	๒๖ ม.ค. ๒๕๔๕
idling; idle; tick-over	เดินเบา	๒๖ ม.ค. ๒๕๔๕
ignition	๑. การจุดระเบิด๒. การจุดไฟ, การติดไฟ	๒๖ ม.ค. ๒๕๔๕
ignition lag	ช่วงล่าช้าก่อนการเผาไหม้	๒๖ ม.ค. ๒๕๔๕
ignition temperature	อุณหภูมิจุดระเบิด	๒๖ ม.ค. ๒๕๔๕
ออกซิเดชัน, การออกซิไดส์	oxidation	๒๖ ม.ค. ๒๕๔๕
impeller	ใบพัด	๒๖ ม.ค. ๒๕๔๕
impulse pump	ตะบันน้ำ	๒๖ ม.ค. ๒๕๔๕
incidence angle	มุมตกกระทบ	๒๖ ม.ค. ๒๕๔๕
incidence radiation; intercepted radiation	๑. การแผ่รังสีตกกระทบ๒. รังสีตกกระทบ	๒๖ ม.ค. ๒๕๔๕
indicated power (ip)	กำลังบ่งชี้ (ไอพี)	๒๖ ม.ค. ๒๕๔๕
induction manifold; inlet manifold; intake manifold	ท่อร่วมไอดี	๒๖ ม.ค. ๒๕๔๕
inertia force	แรงเฉื่อย	๒๖ ม.ค. ๒๕๔๕
infrared radiation	๑. การแผ่รังสีอินฟราเรด๒. รังสีอินฟราเรด	๒๖ ม.ค. ๒๕๔๕
injection	การฉีด	๒๖ ม.ค. ๒๕๔๕
injector; atomiser	หัวฉีด	๒๖ ม.ค. ๒๕๔๕
injection system	ระบบฉีด	๒๖ ม.ค. ๒๕๔๕
inlet manifold; induction manifold; intake manifold	ท่อร่วมไอดี	๒๖ ม.ค. ๒๕๔๕
inlet stroke; intake stroke; suction stroke	จังหวะดูด	๒๖ ม.ค. ๒๕๔๕
inlet valve; intake valve	ลิ้นไอดี	๒๖ ม.ค. ๒๕๔๕
input	-ใส่เข้า	๒๖ ม.ค. ๒๕๔๕
insolation	รังสีอาทิตย์บนผิวโลก	๒๖ ม.ค. ๒๕๔๕
instantaneous efficiency	ประสิทธิภาพขณะหนึ่ง	๒๖ ม.ค. ๒๕๔๕
insulation	๑. ฉนวน๒. การฉนวน	๒๖ ม.ค. ๒๕๔๕
intake manifold; induction manifold; inlet manifold	ท่อร่วมไอดี	๒๖ ม.ค. ๒๕๔๕
intake stroke; inlet stroke; suction stroke	จังหวะดูด	๒๖ ม.ค. ๒๕๔๕
intake valve; inlet valve	ลิ้นไอดี	๒๖ ม.ค. ๒๕๔๕
intercepted radiation; incidence radiation	๑. การแผ่รังสีตกกระทบ๒. รังสีตกกระทบ	๒๖ ม.ค. ๒๕๔๕
internal combustion engine; IC engine	เครื่องยนต์ไอซี, เครื่องยนต์เผาไหม้ภายใน	๒๖ ม.ค. ๒๕๔๕
internal combustion engine; IC engine	เครื่องยนต์เผาไหม้ภายใน, เครื่องยนต์ไอซี	๒๖ ม.ค. ๒๕๔๕
อัตราเร็วลมเริ่มต้น	starting wind speed	๒๖ ม.ค. ๒๕๔๕
อัตราเร็วลมเฉลี่ย	average wind speed	๒๖ ม.ค. ๒๕๔๕
อัตราเร็วลมหยุดงาน	cut-out wind speed	๒๖ ม.ค. ๒๕๔๕
อัตราเร็วลมที่จุดออกแบบ	design wind speed	๒๖ ม.ค. ๒๕๔๕
อัตราเร็วลมพิกัด	rated wind speed	๒๖ ม.ค. ๒๕๔๕
อัตราเร็วเครื่องยนต์	engine speed	๒๖ ม.ค. ๒๕๔๕
อัตราเร็วเดินเบา	idle speed	๒๖ ม.ค. ๒๕๔๕
อัตราเร็วลมเริ่มงาน	cut-in wind speed	๒๖ ม.ค. ๒๕๔๕
อัตราส่วนแรงยกต่อแรงต้าน	lift drag ratio	๒๖ ม.ค. ๒๕๔๕
อัตราส่วนแรงต้านต่อแรงยก	drag lift ratio	๒๖ ม.ค. ๒๕๔๕
อัตราส่วนเอ/เอฟ, อัตราส่วนอากาศต่อเชื้อเพลิง	air-fuel ratio; A/F ratio	๒๖ ม.ค. ๒๕๔๕
อัตราส่วนโซลิดิตี	solidity ratio	๒๖ ม.ค. ๒๕๔๕
อัตราส่วนการรวมรังสี	concentration ratio	๒๖ ม.ค. ๒๕๔๕
อัตราส่วนการอัด	compression ratio	๒๖ ม.ค. ๒๕๔๕
อัตราส่วนสะท้อน, แอลบีโด	albedo	๒๖ ม.ค. ๒๕๔๕
อัตราส่วนอัตราเร็วปลายใบพัด	tip speed ratio	๒๖ ม.ค. ๒๕๔๕
อัตราส่วนอากาศต่อเชื้อเพลิง, อัตราส่วนเอ/เอฟ	air-fuel ratio; A/F ratio	๒๖ ม.ค. ๒๕๔๕
อัตราส่วนของอัตราเร็วเฉพาะที่	local speed ratio	๒๖ ม.ค. ๒๕๔๕
ฮีลิโอสแตต	heliostat	๒๖ ม.ค. ๒๕๔๕
ฮีลิโอดอน	heliodon	๒๖ ม.ค. ๒๕๔๕
อากาศพลศาสตร์	aerodynamics	๒๖ ม.ค. ๒๕๔๕
ฮีตปั๊ม	heat pump	๒๖ ม.ค. ๒๕๔๕
ip (indicated power)	ไอพี (กำลังบ่งชี้)	๒๖ ม.ค. ๒๕๔๕
irradiance	ความรับอาบรังสี	๒๖ ม.ค. ๒๕๔๕
irradiation	๑. การอาบรังสี๒. การฉายรังสี	๒๖ ม.ค. ๒๕๔๕
องศา-วันปรกติ, ดีกรี-เดย์ปรกติ	normal degree-days	๒๖ ม.ค. ๒๕๔๕
อติสีตศาสตร์, วิชาความเย็นยวดยิ่ง	cryogenics	๒๖ ม.ค. ๒๕๔๕
อนุจลน์	wake	๒๖ ม.ค. ๒๕๔๕
อุณหภูมิโดยรอบ	ambient temperature	๒๖ ม.ค. ๒๕๔๕
อุณหภูมิจุดระเบิด	ignition temperature	๒๖ ม.ค. ๒๕๔๕
อุปกรณ์เผาไหม้เสริม	afterburner	๒๖ ม.ค. ๒๕๔๕
อุปกรณ์เพิ่มภาระ	load device	๒๖ ม.ค. ๒๕๔๕
อุปกรณ์แลกเปลี่ยน(ความร้อน)แบบเปลือกและท่อ	shell and tube (heat) exchanger	๒๖ ม.ค. ๒๕๔๕
อุปกรณ์แลกเปลี่ยนความร้อน	heat exchanger	๒๖ ม.ค. ๒๕๔๕
อุปกรณ์แลกเปลี่ยน(ความร้อน)แบบเปลือกและท่อ	shell and tube (heat) exchanger	๒๖ ม.ค. ๒๕๔๕
อุปกรณ์รับรู้, เครื่องรับรู้, ตัวรับรู้	sensor	๒๖ ม.ค. ๒๕๔๕
kinetic energy	พลังงานจลน์	๒๖ ม.ค. ๒๕๔๕
kinetic exchange model	๑. แบบจำลองการแลกเปลี่ยนจลน์๒. ตัวแบบการแลกเปลี่ยนจลน์	๒๖ ม.ค. ๒๕๔๕
Kirchhoff’s law	กฎของเคิร์ชฮอฟฟ์	๒๖ ม.ค. ๒๕๔๕
Lambda sensor	ตัวรับรู้แลมบ์ดา	๒๖ ม.ค. ๒๕๔๕
laminar flow	การไหลแบบแลมินาร์ [มีความหมายเหมือนกับ streamline flow]	๒๖ ม.ค. ๒๕๔๕
latent-heat storage	๑. ตัวสะสมความร้อนแฝง๒. การสะสมความร้อนแฝง	๒๖ ม.ค. ๒๕๔๕
lattice structure	โครงสร้างแลตทิซ	๒๖ ม.ค. ๒๕๔๕
leaded gasolene	แกโซลีนมีสารตะกั่ว	๒๖ ม.ค. ๒๕๔๕
leak holes simplified theory	ทฤษฎีแบบง่ายเกี่ยวกับช่องน้ำผ่าน	๒๖ ม.ค. ๒๕๔๕
lean mixture	ไอดีบาง	๒๖ ม.ค. ๒๕๔๕
lean-burn engine; lean-burning engine	เครื่องยนต์แบบเผาไหม้ไอดีบาง	๒๖ ม.ค. ๒๕๔๕
lean-burning engine; lean-burn engine	เครื่องยนต์แบบเผาไหม้ไอดีบาง	๒๖ ม.ค. ๒๕๔๕
lift	แรงยก	๒๖ ม.ค. ๒๕๔๕
lift coefficient	สัมประสิทธิ์แรงยก	๒๖ ม.ค. ๒๕๔๕
lift drag ratio	อัตราส่วนแรงยกต่อแรงต้าน	๒๖ ม.ค. ๒๕๔๕
lift propulsion	การขับดันด้วยแรงยก	๒๖ ม.ค. ๒๕๔๕
liquefied petroleum gas (LPG; LP-GAS)	แก๊สปิโตรเลียมเหลว (แอลพีจี, แอลพีแก๊ส)	๒๖ ม.ค. ๒๕๔๕
load	ภาระ	๒๖ ม.ค. ๒๕๔๕
load device	อุปกรณ์เพิ่มภาระ	๒๖ ม.ค. ๒๕๔๕
load profile	โพรไฟล์ภาระ	๒๖ ม.ค. ๒๕๔๕
local speed ratio	อัตราส่วนของอัตราเร็วเฉพาะที่	๒๖ ม.ค. ๒๕๔๕
loss coefficient	สัมประสิทธิ์การสูญเสีย	๒๖ ม.ค. ๒๕๔๕
low-lead fuel	น้ำมันเชื้อเพลิงตะกั่วต่ำ	๒๖ ม.ค. ๒๕๔๕
low-pressure blower	เครื่องเป่าลมความดันต่ำ	๒๖ ม.ค. ๒๕๔๕
low-temperature storage	๑. ตัวสะสมพลังงานอุณหภูมิต่ำ๒. การสะสมพลังงานอุณหภูมิต่ำ	๒๖ ม.ค. ๒๕๔๕
LPG; LP-GAS (liquefied petroleum gas)	แอลพีจี, แอลพีแก๊ส (แก๊สปิโตรเลียมเหลว)	๒๖ ม.ค. ๒๕๔๕
LP-GAS; LPG (liquefied petroleum gas)	แอลพีจี, แอลพีแก๊ส (แก๊สปิโตรเลียมเหลว)	๒๖ ม.ค. ๒๕๔๕
machine	๑. เครื่องกล๒. เครื่องจักร๓. -กล	๒๖ ม.ค. ๒๕๔๕
machine tool	เครื่องมือกล	๒๖ ม.ค. ๒๕๔๕
machinery	๑. เครื่องจักร๒. ระบบเครื่องจักร	๒๖ ม.ค. ๒๕๔๕
manometer	มาตรความดันของไหล, แมนอมิเตอร์	๒๖ ม.ค. ๒๕๔๕
mass transfer	การถ่ายโอนมวล	๒๖ ม.ค. ๒๕๔๕
mass-spring system	ระบบมวลสปริง	๒๖ ม.ค. ๒๕๔๕
matching	การจับคู่	๒๖ ม.ค. ๒๕๔๕
mathematical model	๑. แบบจำลองคณิตศาสตร์๒. ตัวแบบคณิตศาสตร์	๒๖ ม.ค. ๒๕๔๕
mechanical	-กล	๒๖ ม.ค. ๒๕๔๕
mechanism	กลไก	๒๖ ม.ค. ๒๕๔๕
mechanical machine	เครื่องจักรกล	๒๖ ม.ค. ๒๕๔๕
mechanical pump	เครื่องสูบเชิงกล, ปั๊มเชิงกล	๒๖ ม.ค. ๒๕๔๕
mechanical tachometer	มาตรอัตรารอบเชิงกล	๒๖ ม.ค. ๒๕๔๕
misfire; miss	๑. จุดระเบิดไม่ครบสูบ๒. การจุดระเบิดไม่ครบสูบ	๒๖ ม.ค. ๒๕๔๕
miss; misfire	๑. จุดระเบิดไม่ครบสูบ๒. การจุดระเบิดไม่ครบสูบ	๒๖ ม.ค. ๒๕๔๕
mixture; air-fuel mixture; fuel mixture	ไอดี, สสารผสมอากาศกับเชื้อเพลิง	๒๖ ม.ค. ๒๕๔๕
modified transmittance equation	สมการความส่งผ่านดัดแปร	๒๖ ม.ค. ๒๕๔๕
molecular sieve	ตัวกรองระดับโมเลกุล	๒๖ ม.ค. ๒๕๔๕
moment of inertia	โมเมนต์ความเฉื่อย	๒๖ ม.ค. ๒๕๔๕
momentum diffusivity	สภาพแพร่โมเมนตัม	๒๖ ม.ค. ๒๕๔๕
momentum transfer	การถ่ายโอนโมเมนตัม	๒๖ ม.ค. ๒๕๔๕
MON (motor octane number)	เอ็มโอเอ็น (เลขออกเทนเครื่องยนต์)	๒๖ ม.ค. ๒๕๔๕
monochromatic characteristics	ลักษณะเฉพาะเอกรงค์	๒๖ ม.ค. ๒๕๔๕
motor octane number (MON)	เลขออกเทนเครื่องยนต์ส(เอ็มโอเอ็น)	๒๖ ม.ค. ๒๕๔๕
motor vehicle	ยานยนต์	๒๖ ม.ค. ๒๕๔๕
natural convection	การพาแบบธรรมชาติ [มีความหมายเหมือนกับ free convection]	๒๖ ม.ค. ๒๕๔๕
natural gasolene; casing head gasolene	แกโซลีนธรรมชาติ	๒๖ ม.ค. ๒๕๔๕
net torque	ทอร์กสุทธิ	๒๖ ม.ค. ๒๕๔๕
net power	กำลังสุทธิ	๒๖ ม.ค. ๒๕๔๕
no-load test	การทดสอบโดยไม่มีภาระ	๒๖ ม.ค. ๒๕๔๕
NO control system	ระบบควบคุมไนโตรเจนออกไซด์	๒๖ ม.ค. ๒๕๔๕
nonconvecting solar pond	สระรังสีอาทิตย์แบบไม่พาความร้อน	๒๖ ม.ค. ๒๕๔๕
nonleaded gasolene	แกโซลีนไร้สารตะกั่ว [มีความหมายเหมือนกับ unleaded gasolene (ULG) และ unleaded petrol (ULP)]	๒๖ ม.ค. ๒๕๔๕
normal degree-days	องศา-วันปรกติ, ดีกรี-เดย์ปรกติ	๒๖ ม.ค. ๒๕๔๕
normal distribution	การแจกแจงปรกติ	๒๖ ม.ค. ๒๕๔๕
nuclear power	กำลังนิวเคลียร์	๒๖ ม.ค. ๒๕๔๕
Nusselt number	เลขนัสเซลต์	๒๖ ม.ค. ๒๕๔๕
ocean thermal energy conversion system; OTEC system	ระบบการเปลี่ยนรูปพลังงานอุณหภาพมหาสมุทร, ระบบโอเท็ก	๒๖ ม.ค. ๒๕๔๕
ocean thermal gradient	เกรเดียนต์อุณหภาพมหาสมุทร	๒๖ ม.ค. ๒๕๔๕
octane number	เลขออกเทน	๒๖ ม.ค. ๒๕๔๕
octane rating	ค่าประเมินออกเทน	๒๖ ม.ค. ๒๕๔๕
oil	๑. น้ำมันหล่อลื่น [มีความหมายเหมือนกับ lube oil; lubricating oil]๒. น้ำมันเครื่อง๓. น้ำมันเชื้อเพลิง [ใช้กับเครื่องยนต์ดีเซล]	๒๖ ม.ค. ๒๕๔๕
opaque material	วัสดุฝ้า	๒๖ ม.ค. ๒๕๔๕
operational test; performance test	การทดสอบสมรรถนะ	๒๖ ม.ค. ๒๕๔๕
optical booster	ตัวเพิ่มความเข้มรังสี	๒๖ ม.ค. ๒๕๔๕
optical efficiency	ประสิทธิภาพเชิงรังสี, ประสิทธิภาพเชิงแสง	๒๖ ม.ค. ๒๕๔๕
optimisation	การทำให้เหมาะที่สุด	๒๖ ม.ค. ๒๕๔๕
optimisation methodology	วิธีการทำให้เหมาะที่สุด	๒๖ ม.ค. ๒๕๔๕
optimise	ทำให้เหมาะที่สุด	๒๖ ม.ค. ๒๕๔๕
optimum	๑. ค่าเหมาะที่สุด๒. เหมาะที่สุด	๒๖ ม.ค. ๒๕๔๕
orbiting station collector	ตัวเก็บรังสีแบบสถานีโคจร	๒๖ ม.ค. ๒๕๔๕
orbital eccentricity	ความเยื้องศูนย์กลางของวงโคจร	๒๖ ม.ค. ๒๕๔๕
orientation of collector	การจัดทิศทางตัวเก็บรังสี	๒๖ ม.ค. ๒๕๔๕
OTEC system; ocean thermal energy conversion system	ระบบโอเท็ก, ระบบการเปลี่ยนรูปพลังงานอุณหภาพมหาสมุทร	๒๖ ม.ค. ๒๕๔๕
output	-ออกใช้	๒๖ ม.ค. ๒๕๔๕
overheat	ร้อนเกิน	๒๖ ม.ค. ๒๕๔๕
oxidation	ออกซิเดชัน, การออกซิไดส์	๒๖ ม.ค. ๒๕๔๕
oxidation catalyst	ตัวเร่งออกซิเดชัน	๒๖ ม.ค. ๒๕๔๕
oxygen sensor	ตัวรับรู้ปริมาณออกซิเจน	๒๖ ม.ค. ๒๕๔๕
parabolic trough collector	ตัวเก็บรังสีแบบรางพาราโบลา	๒๖ ม.ค. ๒๕๔๕
parallel flow	การไหลขนาน	๒๖ ม.ค. ๒๕๔๕
parallel-plate flow system	ระบบการไหลแบบแผ่นขนาน	๒๖ ม.ค. ๒๕๔๕
parameter	๑. ตัวแปรเสริม๒. พารามิเตอร์	๒๖ ม.ค. ๒๕๔๕
particle-bed storage	๑. ตัวสะสมแบบถังอนุภาค๒. การสะสมแบบถังอนุภาค	๒๖ ม.ค. ๒๕๔๕
parts per million (ppm)	ส่วนในล้านส่วน (พีพีเอ็ม)	๒๖ ม.ค. ๒๕๔๕
passive system	ระบบกสานติ์	๒๖ ม.ค. ๒๕๔๕
pebble-bed storage	๑. ตัวสะสมแบบถังกรวด๒. การสะสมแบบถังกรวด	๒๖ ม.ค. ๒๕๔๕
performance	สมรรถนะ	๒๖ ม.ค. ๒๕๔๕
performance test; operational test	การทดสอบสมรรถนะ	๒๖ ม.ค. ๒๕๔๕
performance test; operational test	การทดสอบสมรรถนะ	๒๖ ม.ค. ๒๕๔๕
petrol	เบนซิน	๒๖ ม.ค. ๒๕๔๕
petroleum	ปิโตรเลียม	๒๖ ม.ค. ๒๕๔๕
phase-change storage	๑. ตัวสะสมแบบเปลี่ยนสถานะ๒. การสะสมแบบเปลี่ยนสถานะ	๒๖ ม.ค. ๒๕๔๕
photocell	โฟโตเซลล์	๒๖ ม.ค. ๒๕๔๕
photochemical process	กระบวนการโฟโตเคมี	๒๖ ม.ค. ๒๕๔๕
photochemical smog	หมอกปนควันแบบโฟโตเคมี	๒๖ ม.ค. ๒๕๔๕
photon	โฟตอน	๒๖ ม.ค. ๒๕๔๕
photosynthesis	การสังเคราะห์ด้วยแสง	๒๖ ม.ค. ๒๕๔๕
photovoltaic conversion	การเปลี่ยนรูป(พลังงาน)โฟโตวอลเทอิก	๒๖ ม.ค. ๒๕๔๕
pipe	ท่อ	๒๖ ม.ค. ๒๕๔๕
piston engine; reciprocating engine	เครื่องยนต์ลูกสูบ	๒๖ ม.ค. ๒๕๔๕
piston pump	เครื่องสูบ(แบบ)ลูกสูบ, สปั๊ม(แบบ)ลูกสูบ	๒๖ ม.ค. ๒๕๔๕
Planck’s law	กฎของพลังค์	๒๖ ม.ค. ๒๕๔๕
polarisation	๑. การเกิดขั้ว๒. โพลาไรเซชัน	๒๖ ม.ค. ๒๕๔๕
pop-back; blow-back; popping back; spit-back	การเผาไหม้ย้อนกลับ	๒๖ ม.ค. ๒๕๔๕
popping back; blow-back; pop-back; spit-back	การเผาไหม้ย้อนกลับ	๒๖ ม.ค. ๒๕๔๕
power coefficient	สัมประสิทธิ์กำลัง(งาน)	๒๖ ม.ค. ๒๕๔๕
power factor	แฟกเตอร์กำลัง	๒๖ ม.ค. ๒๕๔๕
power stroke	จังหวะกำลัง	๒๖ ม.ค. ๒๕๔๕
power tower	หอผลิตกำลัง	๒๖ ม.ค. ๒๕๔๕
power-speed curve	เส้นโค้งกำลัง-อัตราเร็ว	๒๖ ม.ค. ๒๕๔๕
power plant	โรงผลิตกำลัง	๒๖ ม.ค. ๒๕๔๕
ppm (parts per million)	พีพีเอ็ม (ส่วนในล้านส่วน)	๒๖ ม.ค. ๒๕๔๕
Prandtl number	เลขพรันด์เทิล	๒๖ ม.ค. ๒๕๔๕
pre-ignition	การชิงจุด(ระเบิด)	๒๖ ม.ค. ๒๕๔๕
prechamber; precombustion chamber	ห้องเผาไหม้ก่อน	๒๖ ม.ค. ๒๕๔๕
precombustion chamber; prechamber	ห้องเผาไหม้ก่อน	๒๖ ม.ค. ๒๕๔๕
preheating	การให้ความร้อนก่อน	๒๖ ม.ค. ๒๕๔๕
premium gasolene; super gasolene	แกโซลีนพิเศษ [มีความหมายเหมือนกับ high-grade petrol]	๒๖ ม.ค. ๒๕๔๕
pressure-relief valve; relief valve	ลิ้นระบายความดัน	๒๖ ม.ค. ๒๕๔๕
profile angle	มุมโพรไฟล์	๒๖ ม.ค. ๒๕๔๕
pump	๑. สูบ๒. เครื่องสูบ, ปั๊ม	๒๖ ม.ค. ๒๕๔๕
pump efficiency	ประสิทธิภาพเครื่องสูบ, ประสิทธิภาพปั๊ม	๒๖ ม.ค. ๒๕๔๕
pump torque	ทอร์กของเครื่องสูบ, ทอร์กของปั๊ม	๒๖ ม.ค. ๒๕๔๕
pyranometer	มาตรรังสีอาทิตย์รวม, ไพรานอมิเตอร์	๒๖ ม.ค. ๒๕๔๕
pyrheliometer	มาตรรังสีอาทิตย์ตรง, ไพร์ฮีลิออมิเตอร์	๒๖ ม.ค. ๒๕๔๕
pyrolysis	การแยกสลายด้วยความร้อน	๒๖ ม.ค. ๒๕๔๕
radiation data	ข้อมูลการแผ่รังสี	๒๖ ม.ค. ๒๕๔๕
radiation flux	๑. ฟลักซ์การแผ่รังสี๒. ฟลักซ์รังสี	๒๖ ม.ค. ๒๕๔๕
radiation heat transfer	การถ่ายโอนความร้อนโดยการแผ่รังสี	๒๖ ม.ค. ๒๕๔๕
radiation intensity	ความเข้มรังสี	๒๖ ม.ค. ๒๕๔๕
radiation	๑. การแผ่รังสี๒. รังสี	๒๖ ม.ค. ๒๕๔๕
radiometer	มาตรรังสี, เรดิโอมิเตอร์	๒๖ ม.ค. ๒๕๔๕
Rankine cycle	วัฏจักรแรงคิน	๒๖ ม.ค. ๒๕๔๕
rated wind speed	อัตราเร็วลมพิกัด	๒๖ ม.ค. ๒๕๔๕
rational efficiency; energetic efficiency; exergetic efficiency; second law efficiency	ประสิทธิภาพตามกฎข้อที่สอง	๒๖ ม.ค. ๒๕๔๕
Rayleigh distribution	การแจกแจงเรย์ลี	๒๖ ม.ค. ๒๕๔๕
Rayleigh mechanism	กลไกเรย์ลี	๒๖ ม.ค. ๒๕๔๕
Rayleigh number	เลขเรย์ลี	๒๖ ม.ค. ๒๕๔๕
receiver	ตัวรับรังสีรวม	๒๖ ม.ค. ๒๕๔๕
reciprocating engine; piston engine	เครื่องยนต์ลูกสูบ	๒๖ ม.ค. ๒๕๔๕
recirculation flow	การไหลเวียนกลับ	๒๖ ม.ค. ๒๕๔๕
reflection	การสะท้อน	๒๖ ม.ค. ๒๕๔๕
reflector	แผ่นสะท้อนแสง	๒๖ ม.ค. ๒๕๔๕
reflectance	ความสะท้อน	๒๖ ม.ค. ๒๕๔๕
refractive index	ดรรชนีหักเห	๒๖ ม.ค. ๒๕๔๕
refractometer	มาตรดรรชนีหักเห	๒๖ ม.ค. ๒๕๔๕
refrigerant	สารทำความเย็น	๒๖ ม.ค. ๒๕๔๕
refrigeration	การทำความเย็น	๒๖ ม.ค. ๒๕๔๕
refrigeration cycle	วัฏจักรทำความเย็น	๒๖ ม.ค. ๒๕๔๕
regeneration system	ระบบอุ่นอากาศเข้า	๒๖ ม.ค. ๒๕๔๕
relative humidity	ความชื้นสัมพัทธ์	๒๖ ม.ค. ๒๕๔๕
relief valve; pressure-relief valve	ลิ้นระบายความดัน	๒๖ ม.ค. ๒๕๔๕
resonance frequency; resonant frequency	ความถี่พ้อง, ความถี่เรโซแนนซ์	๒๖ ม.ค. ๒๕๔๕
resonant frequency; resonance frequency	ความถี่พ้อง, ความถี่เรโซแนนซ์	๒๖ ม.ค. ๒๕๔๕
Reynolds number	เลขเรย์โนลดส์	๒๖ ม.ค. ๒๕๔๕
rich mixture	ไอดีหนา	๒๖ ม.ค. ๒๕๔๕
rock wool insulation	การฉนวนด้วยใยหิน	๒๖ ม.ค. ๒๕๔๕
rotary engine; rotary-combustion engine	เครื่องยนต์โรทารี	๒๖ ม.ค. ๒๕๔๕
rotary-combustion engine; rotary engine	เครื่องยนต์โรทารี	๒๖ ม.ค. ๒๕๔๕
rotor	ตัวหมุน, โรเตอร์	๒๖ ม.ค. ๒๕๔๕
rotor blade	ใบพัดตัวหมุน, ใบพัดโรเตอร์	๒๖ ม.ค. ๒๕๔๕
sailwing	ใบเรือ	๒๖ ม.ค. ๒๕๔๕
saline water	น้ำเกลือ	๒๖ ม.ค. ๒๕๔๕
Salter duck	ทุ่นแบบซอลเตอร์	๒๖ ม.ค. ๒๕๔๕
satellite solar power station	ดาวเทียมผลิตกำลังด้วยรังสีอาทิตย์	๒๖ ม.ค. ๒๕๔๕
scale parameter	พารามิเตอร์บ่งขนาด	๒๖ ม.ค. ๒๕๔๕
seasonal performance factor	ตัวประกอบสมรรถนะตามฤดูกาล	๒๖ ม.ค. ๒๕๔๕
second law efficiency; energetic efficiency; exergetic efficiency; rational efficiency	ประสิทธิภาพตามกฎข้อที่สอง	๒๖ ม.ค. ๒๕๔๕
selective surface	ผิวเลือกรังสี	๒๖ ม.ค. ๒๕๔๕
sensor	ตัวรับรู้, เครื่องรับรู้, อุปกรณ์รับรู้	๒๖ ม.ค. ๒๕๔๕
separation of boundary layer	การแยกของชั้นขอบเขต	๒๖ ม.ค. ๒๕๔๕
separator; battery separator	แผ่นกั้นในแบตเตอรี่	๒๖ ม.ค. ๒๕๔๕
shadow-angle protractor	โพรแทรกเตอร์วัดมุมเงา	๒๖ ม.ค. ๒๕๔๕
shape parameter	พารามิเตอร์บ่งรูปร่าง	๒๖ ม.ค. ๒๕๔๕
shearing stress	ความเค้นเฉือน	๒๖ ม.ค. ๒๕๔๕
shell and tube (heat) exchanger	อุปกรณ์แลกเปลี่ยน (ความร้อน) แบบเปลือกและท่อ	๒๖ ม.ค. ๒๕๔๕
shell and tube (heat) exchanger	อุปกรณ์แลกเปลี่ยน (ความร้อน) แบบเปลือกและท่อ	๒๖ ม.ค. ๒๕๔๕
shroud	แผ่นประกับ	๒๖ ม.ค. ๒๕๔๕
side vane	ใบข้าง(หลบลม)	๒๖ ม.ค. ๒๕๔๕
silicon cell	เซลล์ซิลิคอน	๒๖ ม.ค. ๒๕๔๕
solar air system collector	ตัวเก็บรังสีอาทิตย์ระบบอากาศ	๒๖ ม.ค. ๒๕๔๕
solar cell	เซลล์สุริยะ	๒๖ ม.ค. ๒๕๔๕
solar collector	ตัวเก็บรังสีอาทิตย์	๒๖ ม.ค. ๒๕๔๕
solar concentrator	ตัวรวมรังสีอาทิตย์	๒๖ ม.ค. ๒๕๔๕
solar constant	ค่าคงตัวรังสีอาทิตย์	๒๖ ม.ค. ๒๕๔๕
solar distillation	การกลั่นด้วยรังสีอาทิตย์	๒๖ ม.ค. ๒๕๔๕
solar energy economics	เศรษฐศาสตร์พลังงานรังสีอาทิตย์	๒๖ ม.ค. ๒๕๔๕
solar energy system	ระบบพลังงานรังสีอาทิตย์	๒๖ ม.ค. ๒๕๔๕
solar furnace	เตารังสีอาทิตย์	๒๖ ม.ค. ๒๕๔๕
solar incidence angle	มุมตกกระทบของรังสีอาทิตย์	๒๖ ม.ค. ๒๕๔๕
solar noon	เที่ยงสุริยะ	๒๖ ม.ค. ๒๕๔๕
solar pond	สระรังสีอาทิตย์	๒๖ ม.ค. ๒๕๔๕
solar power plant	โรงผลิตกำลังด้วยรังสีอาทิตย์	๒๖ ม.ค. ๒๕๔๕
solar radiation	๑. การแผ่รังสีอาทิตย์๒. รังสีอาทิตย์	๒๖ ม.ค. ๒๕๔๕
solar spectrum	สเปกตรัมรังสีอาทิตย์	๒๖ ม.ค. ๒๕๔๕
solar steam engine	เครื่องจักรไอน้ำรังสีอาทิตย์	๒๖ ม.ค. ๒๕๔๕
solar still	เครื่องกลั่นด้วยรังสีอาทิตย์	๒๖ ม.ค. ๒๕๔๕
solar thermal system	ระบบอุณหภาพรังสีอาทิตย์	๒๖ ม.ค. ๒๕๔๕
solar time	เวลาสุริยะ	๒๖ ม.ค. ๒๕๔๕
solar water heating system	ระบบทำน้ำร้อนด้วยรังสีอาทิตย์	๒๖ ม.ค. ๒๕๔๕
solar water pump	เครื่องสูบน้ำรังสีอาทิตย์	๒๖ ม.ค. ๒๕๔๕
solid-phase storage	๑. ตัวสะสมในสถานะของแข็ง๒. การสะสมในสถานะของแข็ง	๒๖ ม.ค. ๒๕๔๕
solidity ratio	อัตราส่วนโซลิดิตี	๒๖ ม.ค. ๒๕๔๕
spit-back; blow-back; pop-back; popping back	การเผาไหม้ย้อนกลับ	๒๖ ม.ค. ๒๕๔๕
spoke	ซี่ล้อ, กำ	๒๖ ม.ค. ๒๕๔๕
standard deviation	ค่าเบี่ยงเบนมาตรฐาน	๒๖ ม.ค. ๒๕๔๕
starting wind speed	อัตราเร็วลมเริ่มต้น	๒๖ ม.ค. ๒๕๔๕
steam engine	เครื่องจักรไอน้ำ	๒๖ ม.ค. ๒๕๔๕
storage	๑. ตัวสะสม๒. การสะสม	๒๖ ม.ค. ๒๕๔๕
storage mass heat capacity	ความจุความร้อนของมวลสะสม	๒๖ ม.ค. ๒๕๔๕
storage tank	ถังสะสม(พลังงาน)	๒๖ ม.ค. ๒๕๔๕
streamline flow	การไหลแบบเส้นกระแส [มีความหมายเหมือนกับ laminar flow]	๒๖ ม.ค. ๒๕๔๕
substrate	ซับสเตรต	๒๖ ม.ค. ๒๕๔๕
suction line	ท่อดูด	๒๖ ม.ค. ๒๕๔๕
suction stroke; inlet stroke; intake stroke	จังหวะดูด	๒๖ ม.ค. ๒๕๔๕
sun-path diagram	แผนภาพวิถีโคจรดวงอาทิตย์	๒๖ ม.ค. ๒๕๔๕
sunshine switch	สวิตช์แสงอาทิตย์	๒๖ ม.ค. ๒๕๔๕
super gasolene; premium gasolene	แกโซลีนพิเศษ [มีความหมายเหมือนกับ high-grade petrol]	๒๖ ม.ค. ๒๕๔๕
superheated steam	ไอน้ำร้อนยวดยิ่ง	๒๖ ม.ค. ๒๕๔๕
swept area	พื้นที่กวาด	๒๖ ม.ค. ๒๕๔๕
synchronous machine	เครื่องจักรแบบสมวาร	๒๖ ม.ค. ๒๕๔๕
tangential induction factor	ตัวประกอบเหนี่ยวนำตามแนวสัมผัส	๒๖ ม.ค. ๒๕๔๕
temperature gradient	เกรเดียนต์อุณหภูมิ	๒๖ ม.ค. ๒๕๔๕
tensile stress	ความเค้นดึง	๒๖ ม.ค. ๒๕๔๕
terrestrial radiation	๑. การแผ่รังสีโลก๒. รังสีโลก	๒๖ ม.ค. ๒๕๔๕
thermactor; air-injection system	ระบบฉีดอากาศ	๒๖ ม.ค. ๒๕๔๕
thermal circuit	วงจรอุณหภาพ	๒๖ ม.ค. ๒๕๔๕
thermal conversion	การเปลี่ยนรูปทางอุณหภาพ	๒๖ ม.ค. ๒๕๔๕
thermal efficiency	ประสิทธิภาพอุณหภาพ	๒๖ ม.ค. ๒๕๔๕
thermal properties of metal	สมบัติอุณหภาพของโลหะ	๒๖ ม.ค. ๒๕๔๕
thermal reactor	เครื่องปฏิกรณ์อุณหภาพ	๒๖ ม.ค. ๒๕๔๕
thermal storage tank	ถังสะสม(พลังงาน)อุณหภาพ	๒๖ ม.ค. ๒๕๔๕
thermo-syphon	เทอร์มอไซฟอน	๒๖ ม.ค. ๒๕๔๕
thermocouple	คู่ควบอุณหภูมิ, เทอร์มอคัปเปิล	๒๖ ม.ค. ๒๕๔๕
thermosyphon system	ระบบเทอร์มอไซฟอน	๒๖ ม.ค. ๒๕๔๕
three-way catalytic converter (TWC)	เครื่องฟอกไอเสียเชิงเร่งปฏิกิริยาสามทาง, แคทาลิติกคอนเวอร์เตอร์สามทาง (ทีดับเบิลยูซี)	๒๖ ม.ค. ๒๕๔๕
throat	คอคอด [มีความหมายเหมือนกับ venturi ๑]	๒๖ ม.ค. ๒๕๔๕
thrust	แรงผลักดัน	๒๖ ม.ค. ๒๕๔๕
tick-over; idle; idling	เดินเบา	๒๖ ม.ค. ๒๕๔๕
tilt angle	มุมเอียง	๒๖ ม.ค. ๒๕๔๕
tilt factor	แฟกเตอร์มุมเอียง	๒๖ ม.ค. ๒๕๔๕
time constant	ค่าคงตัวเวลา	๒๖ ม.ค. ๒๕๔๕
time distribution	การแจกแจงเวลา	๒๖ ม.ค. ๒๕๔๕
tip loss	ความสูญเสียปลายใบพัด	๒๖ ม.ค. ๒๕๔๕
tip speed ratio	อัตราส่วนอัตราเร็วปลายใบพัด	๒๖ ม.ค. ๒๕๔๕
torque coefficient	สัมประสิทธิ์ทอร์ก	๒๖ ม.ค. ๒๕๔๕
total radiation	รังสีรวมยอด	๒๖ ม.ค. ๒๕๔๕
transient effect	ผลชั่วครู่	๒๖ ม.ค. ๒๕๔๕
transmittance	ความส่งผ่าน	๒๖ ม.ค. ๒๕๔๕
transparent cover	สิ่งปิดโปร่งใส	๒๖ ม.ค. ๒๕๔๕
transparent material	วัสดุโปร่งใส	๒๖ ม.ค. ๒๕๔๕
Trombe passive system	ระบบกสานติ์แบบทรอมเบ	๒๖ ม.ค. ๒๕๔๕
trough-type concentrator	ตัวรวมรังสีแบบราง	๒๖ ม.ค. ๒๕๔๕
tube	๑. ท่อ๒. หลอด	๒๖ ม.ค. ๒๕๔๕
tube-and-fin radiator	หม้อน้ำแบบท่อครีบ	๒๖ ม.ค. ๒๕๔๕
tubular collector	ตัวเก็บรังสีแบบท่อ	๒๖ ม.ค. ๒๕๔๕
turbulence	ความปั่นป่วน	๒๖ ม.ค. ๒๕๔๕
turbulent flow	การไหลปั่นป่วน	๒๖ ม.ค. ๒๕๔๕
TWC (three-way catalytic converter)	ทีดับเบิลยูซี (เครื่องฟอกไอเสียเชิงเร่งปฏิกิริยาสามทาง, แคทาลิติกคอนเวอร์เตอร์สามทาง)	๒๖ ม.ค. ๒๕๔๕
two-cycle; two-stroke; two-stroke cycle	วัฏจักรสองจังหวะ	๒๖ ม.ค. ๒๕๔๕
two-stroke; two-cycle; two-stroke cycle	วัฏจักรสองจังหวะ	๒๖ ม.ค. ๒๕๔๕
two-stroke cycle; two-cycle; two-stroke	วัฏจักรสองจังหวะ	๒๖ ม.ค. ๒๕๔๕
two-way catalytic converter	เครื่องฟอกไอเสียเชิงเร่งปฏิกิริยาสองทาง, แคทาลิติกคอนเวอร์เตอร์สองทาง	๒๖ ม.ค. ๒๕๔๕
ULG (unleaded gasolene)	ยูแอลจี (แกโซลีนไร้สารตะกั่ว) [มีความหมายเหมือนกับ nonleaded gasolene และ ULP (unleaded petrol)]	๒๖ ม.ค. ๒๕๔๕
ULP (unleaded petrol)	ยูแอลพี (เบนซินไร้สารตะกั่ว) [มีความหมายเหมือนกับ nonleaded gasolene และ ULG (unleaded gasolene)]	๒๖ ม.ค. ๒๕๔๕
unleaded gasolene (ULG)	แกโซลีนไร้สารตะกั่ว (ยูแอลจี) [มีความหมายเหมือนกับ nonleaded gasolene และ unleaded petrol (ULP)]	๒๖ ม.ค. ๒๕๔๕
unleaded petrol (ULP)	เบนซินไร้สารตะกั่ว (ยูแอลพี) [มีความหมายเหมือนกับ nonleaded gasolene และ unleaded gasolene (ULG)]	๒๖ ม.ค. ๒๕๔๕
V-engine; V-type engine	เครื่องยนต์แบบรูปตัววี	๒๖ ม.ค. ๒๕๔๕
V-trough collector	ตัวเก็บรังสีแบบรางตัววี	๒๖ ม.ค. ๒๕๔๕
V-trough concentrator	ตัวรวมรังสีแบบรางตัววี	๒๖ ม.ค. ๒๕๔๕
V-type engine; V-engine	เครื่องยนต์แบบรูปตัววี	๒๖ ม.ค. ๒๕๔๕
vacuum pump; aspirator	ปั๊มสุญญากาศ	๒๖ ม.ค. ๒๕๔๕
vacuum-insulated heat pipe	ท่อความร้อนแบบฉนวนสุญญากาศ	๒๖ ม.ค. ๒๕๔๕
valve	ลิ้น	๒๖ ม.ค. ๒๕๔๕
vane	ใบ	๒๖ ม.ค. ๒๕๔๕
vapour-compression cycle	วัฏจักรอัดไอ	๒๖ ม.ค. ๒๕๔๕
vapour-fuel separator; vapour-liquid separator	ตัวแยกไอและเชื้อเพลิง	๒๖ ม.ค. ๒๕๔๕
vapour-liquid separator; vapour-fuel separator	ตัวแยกไอและเชื้อเพลิง	๒๖ ม.ค. ๒๕๔๕
vapour-recovery system; evaporative control system; fuel-vapour recovery system; vapour-saver system; vehicle vapour recovery	ระบบควบคุมการระเหย	๒๖ ม.ค. ๒๕๔๕
vapour-saver system; evaporative control system; fuel-vapour recovery system; vapour-recovery system; vehicle vapour recovery	ระบบควบคุมการระเหย	๒๖ ม.ค. ๒๕๔๕
vehicle vapour recovery; evaporative control system; fuel-vapour recovery system; vapour-recovery system; vapour-saver system	ระบบควบคุมการระเหย	๒๖ ม.ค. ๒๕๔๕
venturi	๑. คอคอด [มีความหมายเหมือนกับ throat]๒. เวนจูริ	๒๖ ม.ค. ๒๕๔๕
viscosity	ความหนืด	๒๖ ม.ค. ๒๕๔๕
volumetric efficiency	ประสิทธิภาพเชิงปริมาตร	๒๖ ม.ค. ๒๕๔๕
wake	อนุจลน์	๒๖ ม.ค. ๒๕๔๕
Wankel engine; Wankel rotary engine	เครื่องยนต์แวงเกล	๒๖ ม.ค. ๒๕๔๕
Wankel rotary engine; Wankel engine	เครื่องยนต์แวงเกล	๒๖ ม.ค. ๒๕๔๕
wedge combustion chamber	ห้องเผาไหม้ทรงลิ่ม	๒๖ ม.ค. ๒๕๔๕
Weibull distribution	การแจกแจงไวบุลล์	๒๖ ม.ค. ๒๕๔๕
wind driven pump	เครื่องสูบขับด้วยลม, ปั๊มขับด้วยลม	๒๖ ม.ค. ๒๕๔๕
wind potential	ศักย์ลม	๒๖ ม.ค. ๒๕๔๕
wind power	กำลังลม	๒๖ ม.ค. ๒๕๔๕
wind profile	โพรไฟล์ลม	๒๖ ม.ค. ๒๕๔๕
wind shear	แรงเฉือนลม	๒๖ ม.ค. ๒๕๔๕
wind turbine	กังหันลม	๒๖ ม.ค. ๒๕๔๕
working fluid	ของไหลใช้งาน	๒๖ ม.ค. ๒๕๔๕
ล้อตุนกำลัง	flywheel	๒๖ ม.ค. ๒๕๔๕
ล้อตุนกำลังแบบของไหล	fluid flywheel	๒๖ ม.ค. ๒๕๔๕
ลักษณะเฉพาะเอกรงค์	monochromatic characteristics	๒๖ ม.ค. ๒๕๔๕
ลิ้น	valve	๒๖ ม.ค. ๒๕๔๕
ลิ้นระบายความดัน	pressure-relief valve; relief valve	๒๖ ม.ค. ๒๕๔๕
ลิ้นไอดี	inlet valve; intake valve	๒๖ ม.ค. ๒๕๔๕
ลำดับการจุดระเบิด	firing order	๒๖ ม.ค. ๒๕๔๕
ไร่พลังงาน	energy plantation	๒๖ ม.ค. ๒๕๔๕
ไอดี, สารผสมอากาศกับเชื้อเพลิง	air-fuel mixture; fuel mixture; mixture	๒๖ ม.ค. ๒๕๔๕
ไอดีริมห้องเผาไหม้	end-gas	๒๖ ม.ค. ๒๕๔๕
ไอดีเดินเบา	idle mixture	๒๖ ม.ค. ๒๕๔๕
ไอดีหนา	rich mixture	๒๖ ม.ค. ๒๕๔๕
ไอดีบาง	lean mixture	๒๖ ม.ค. ๒๕๔๕
ไอที่ไหม้แล้ว	burnt gases	๒๖ ม.ค. ๒๕๔๕
ไอน้ำร้อนยวดยิ่ง	superheated steam	๒๖ ม.ค. ๒๕๔๕
ไอพี (กำลังบ่งชี้)	ip (indicated power)	๒๖ ม.ค. ๒๕๔๕
ไดนาโม	dynamo	๒๖ ม.ค. ๒๕๔๕
ไพร์ฮีลิออมิเตอร์, มาตรรังสีอาทิตย์ตรง	pyrheliometer	๒๖ ม.ค. ๒๕๔๕
ไพรานอมิเตอร์, มาตรรังสีอาทิตย์รวม	pyranometer	๒๖ ม.ค. ๒๕๔๕
ไฟเบอร์กลาสส์	fiberglass	๒๖ ม.ค. ๒๕๔๕
กระบวนการแอเดียแบติก	adiabatic process	๒๖ ม.ค. ๒๕๔๕
กระบวนการเอกเซอร์โกนิก	exergonic process	๒๖ ม.ค. ๒๕๔๕
กระบวนการเอนเดอร์โกนิก	endergonic process	๒๖ ม.ค. ๒๕๔๕
กระบอก; กระบอกสูบ	cylinder	๒๖ ม.ค. ๒๕๔๕
กระบวนการเปลี่ยนรูปพลังงาน	energy conversion process	๒๖ ม.ค. ๒๕๔๕
กระบวนการโฟโตเคมี	photochemical process	๒๖ ม.ค. ๒๕๔๕
กังหันลม	wind turbine	๒๖ ม.ค. ๒๕๔๕
กังหันแบบไอขยายตัว	expander turbine	๒๖ ม.ค. ๒๕๔๕
กำ, ซี่ล้อ	spoke	๒๖ ม.ค. ๒๕๔๕
การแยกสลายด้วยความร้อน	pyrolysis	๒๖ ม.ค. ๒๕๔๕
การแยกของชั้นขอบเขต	separation of boundary layer	๒๖ ม.ค. ๒๕๔๕
การระเบิดรุนแรง	detonation	๒๖ ม.ค. ๒๕๔๕
การให้ความร้อนก่อน	preheating	๒๖ ม.ค. ๒๕๔๕
การโก่ง	buckling	๒๖ ม.ค. ๒๕๔๕
การเกิดโพรง	cavitation	๒๖ ม.ค. ๒๕๔๕
การเกิดขั้ว; โพลาไรเซชัน	polarisation	๒๖ ม.ค. ๒๕๔๕
การเกิดคาร์บอน	carbonise	๒๖ ม.ค. ๒๕๔๕
การแจกแจง; การจ่าย	distribution	๒๖ ม.ค. ๒๕๔๕
การแจกแจงเรย์ลี	Rayleigh distribution	๒๖ ม.ค. ๒๕๔๕
การแจกแจงเวลา	time distribution	๒๖ ม.ค. ๒๕๔๕
การแจกแจงสะสม	cumulative distribution	๒๖ ม.ค. ๒๕๔๕
การแจกแจงไวบุลล์	Weibull distribution	๒๖ ม.ค. ๒๕๔๕
การแจกแจงความถี่	frequency distribution	๒๖ ม.ค. ๒๕๔๕
การแจกแจงช่วงเวลา	duration distribution	๒๖ ม.ค. ๒๕๔๕
การแจกแจงปรกติ	normal distribution	๒๖ ม.ค. ๒๕๔๕
การเปลี่ยนรูป(พลังงาน)โฟโตวอลเทอิก	photovoltaic conversion	๒๖ ม.ค. ๒๕๔๕
การเปลี่ยนรูปทางอุณหภาพ	thermal conversion	๒๖ ม.ค. ๒๕๔๕
การเปลี่ยนรูป(พลังงาน)โฟโตวอลเทอิก	photovoltaic conversion	๒๖ ม.ค. ๒๕๔๕
การเปลี่ยนเชิงชีวภาพ	bioconversion	๒๖ ม.ค. ๒๕๔๕
การแผ่รังสี; รังสี	radiation	๒๖ ม.ค. ๒๕๔๕
การแผ่รังสีโลก; รังสีโลก	terrestrial radiation	๒๖ ม.ค. ๒๕๔๕
การแผ่รังสีอาทิตย์; รังสีอาทิตย์	solar radiation	๒๖ ม.ค. ๒๕๔๕
การแผ่รังสีอินฟราเรด; รังสีอินฟราเรด	infrared radiation	๒๖ ม.ค. ๒๕๔๕
การแผ่รังสีกระจาย; รังสีกระจาย	diffuse radiation	๒๖ ม.ค. ๒๕๔๕
การแผ่รังสีตรง	beam radiation; direct radiation	๒๖ ม.ค. ๒๕๔๕
การแผ่รังสีตกกระทบ; รังสีตกกระทบ	incidence radiation; intercepted radiation	๒๖ ม.ค. ๒๕๔๕
การแผ่รังสีนอกโลก; รังสีนอกโลก	extraterrestrial radiation	๒๖ ม.ค. ๒๕๔๕
การเผาไหม้	combustion	๒๖ ม.ค. ๒๕๔๕
การเผาไหม้ย้อนกลับ	blow-back; pop-back; popping back; spit-back	๒๖ ม.ค. ๒๕๔๕
การแพร่	diffusion	๒๖ ม.ค. ๒๕๔๕
การสะสมพลังงานอุณหภูมิต่ำ; ตัวสะสมพลังงานอุณหภูมิต่ำ	low-temperature storage	๒๖ ม.ค. ๒๕๔๕
การสะสม; ตัวสะสม	storage	๒๖ ม.ค. ๒๕๔๕
การสะสมในสถานะของแข็ง; ตัวสะสมในสถานะของแข็ง	solid-phase storage	๒๖ ม.ค. ๒๕๔๕
การสะสมแบบเปลี่ยนสถานะ; ตัวสะสมแบบเปลี่ยนสถานะ	phase-change storage	๒๖ ม.ค. ๒๕๔๕
การสะสมแบบถังอนุภาค; ตัวสะสมแบบถังอนุภาค	particle-bed storage	๒๖ ม.ค. ๒๕๔๕
การสะสมแบบถังกรวด; ตัวสะสมแบบถังกรวด	pebble-bed storage	๒๖ ม.ค. ๒๕๔๕
การสะสมความร้อนแฝง; ตัวสะสมความร้อนแฝง	latent-heat storage	๒๖ ม.ค. ๒๕๔๕
การสะท้อน	reflection	๒๖ ม.ค. ๒๕๔๕
การสังเคราะห์ด้วยแสง	photosynthesis	๒๖ ม.ค. ๒๕๔๕
การสิ้นเปลืองพลังงาน, การบริโภคพลังงาน	energy consumption	๒๖ ม.ค. ๒๕๔๕
การสูญเสียความร้อน	heat loss	๒๖ ม.ค. ๒๕๔๕
การออกซิไดส์, ออกซิเดชัน	oxidation	๒๖ ม.ค. ๒๕๔๕
การอัดแบตเตอรี่, การประจุแบตเตอรี่	battery charging	๒๖ ม.ค. ๒๕๔๕
การอัดสูง	high compression	๒๖ ม.ค. ๒๕๔๕
การอาบรังสี; การฉายรังสี	irradiation	๒๖ ม.ค. ๒๕๔๕
การอาบรังสีต่อปี	annual irradiation	๒๖ ม.ค. ๒๕๔๕
การลดความชื้น	dehumidification	๒๖ ม.ค. ๒๕๔๕
การไหล	flow	๒๖ ม.ค. ๒๕๔๕
การไหลเวียนกลับ	recirculation flow	๒๖ ม.ค. ๒๕๔๕
การไหลแบบเส้นกระแส	streamline flow	๒๖ ม.ค. ๒๕๔๕
การไหลแบบแลมินาร์	laminar flow	๒๖ ม.ค. ๒๕๔๕
การไหลสวนทาง	contra flow; counter flow	๒๖ ม.ค. ๒๕๔๕
การไหลขนาน	parallel flow	๒๖ ม.ค. ๒๕๔๕
การไหลตามขวาง	cross flow	๒๖ ม.ค. ๒๕๔๕
การไหลปั่นป่วน	turbulent flow	๒๖ ม.ค. ๒๕๔๕
การได้ความร้อน	heat gain	๒๖ ม.ค. ๒๕๔๕
การกลั่น	distillation	๒๖ ม.ค. ๒๕๔๕
การกลั่นด้วยรังสีอาทิตย์	solar distillation	๒๖ ม.ค. ๒๕๔๕
การขับดันด้วยแรงยก	lift propulsion	๒๖ ม.ค. ๒๕๔๕
การขับดันด้วยแรงต้าน	drag propulsion	๒๖ ม.ค. ๒๕๔๕
การขนส่งพลังงาน	energy transport	๒๖ ม.ค. ๒๕๔๕
การควบแน่น	condensation	๒๖ ม.ค. ๒๕๔๕
การควบคุมการทำความร้อน; ตัวควบคุมการทำความร้อน	heating control	๒๖ ม.ค. ๒๕๔๕
การควบคุมการปล่อย	emission control	๒๖ ม.ค. ๒๕๔๕
การคู่ควบ; คู่ต่อ	coupling	๒๖ ม.ค. ๒๕๔๕
การจ่าย; การแจกแจง	distribution	๒๖ ม.ค. ๒๕๔๕
การจ่ายพลังงาน	energy distribution	๒๖ ม.ค. ๒๕๔๕
การจัดทิศทางตัวเก็บรังสี	orientation of collector	๒๖ ม.ค. ๒๕๔๕
การจับคู่	matching	๒๖ ม.ค. ๒๕๔๕
การจุดระเบิดย้อนกลับ; จุดระเบิดย้อนกลับ	backfire	๒๖ ม.ค. ๒๕๔๕
การจุดระเบิดเอง	autoignition	๒๖ ม.ค. ๒๕๔๕
การจุดระเบิดแบบไร้ทองขาว	breakerless ignition	๒๖ ม.ค. ๒๕๔๕
การจุดระเบิดไม่ครบสูบ; จุดระเบิดไม่ครบสูบ	misfire; miss	๒๖ ม.ค. ๒๕๔๕
การจุดระเบิดด้วยคอยล์	coil ignition	๒๖ ม.ค. ๒๕๔๕
การจุดไฟ, การติดไฟ; การจุดระเบิด	ignition	๒๖ ม.ค. ๒๕๔๕
การฉายรังสี; การอาบรังสี	irradiation	๒๖ ม.ค. ๒๕๔๕
การฉีด	injection	๒๖ ม.ค. ๒๕๔๕
การฉีดน้ำมันตรง	direct injection	๒๖ ม.ค. ๒๕๔๕
การฉนวน; ฉนวน	insulation	๒๖ ม.ค. ๒๕๔๕
การฉนวนด้วยใยหิน	rock wool insulation	๒๖ ม.ค. ๒๕๔๕
การชิงจุด(ระเบิด)	pre-ignition	๒๖ ม.ค. ๒๕๔๕
การชิงจุด(ระเบิด)	pre-ignition	๒๖ ม.ค. ๒๕๔๕
การดูดกลืน	absorption	๒๖ ม.ค. ๒๕๔๕
การติดไฟ, การจุดไฟ;สการจุดระเบิด	ignition	๒๖ ม.ค. ๒๕๔๕
การติดตามต่อเนื่อง	continuous tracking	๒๖ ม.ค. ๒๕๔๕
การถ่ายโอนโมเมนตัม	momentum transfer	๒๖ ม.ค. ๒๕๔๕
การถ่ายโอนมวล	mass transfer	๒๖ ม.ค. ๒๕๔๕
การถ่ายโอนความร้อน	heat transfer	๒๖ ม.ค. ๒๕๔๕
การถ่ายโอนความร้อนโดยการแผ่รังสี	radiation heat transfer	๒๖ ม.ค. ๒๕๔๕
การทำให้เหมาะที่สุด	optimisation	๒๖ ม.ค. ๒๕๔๕
การทำความเย็น	refrigeration	๒๖ ม.ค. ๒๕๔๕
การทำความร้อน	heating	๒๖ ม.ค. ๒๕๔๕
การทดสอบสมรรถนะ	operational test; performance test	๒๖ ม.ค. ๒๕๔๕
การทดสอบโดยไม่มีภาระ	no-load test	๒๖ ม.ค. ๒๕๔๕
การทดสอบความจุแบตเตอรี่	battery-capacity test; battery-load test	๒๖ ม.ค. ๒๕๔๕
การนำ	conduction	๒๖ ม.ค. ๒๕๔๕
การบริโภคพลังงาน, การสิ้นเปลืองพลังงาน	energy consumption	๒๖ ม.ค. ๒๕๔๕
การประจุแบตเตอรี่, การอัดแบตเตอรี่	battery charging	๒๖ ม.ค. ๒๕๔๕
การปรับอากาศ	air conditioning	๒๖ ม.ค. ๒๕๔๕
การป้องกันการเยือกแข็ง	freeze protection	๒๖ ม.ค. ๒๕๔๕
การผสมน้ำมันกับอากาศ	carburetion	๒๖ ม.ค. ๒๕๔๕
การพา	convection	๒๖ ม.ค. ๒๕๔๕
การพาแบบเสรี	free convection	๒๖ ม.ค. ๒๕๔๕
การพาแบบธรรมชาติ	natural convection	๒๖ ม.ค. ๒๕๔๕
การพาแบบบังคับ	forced convection	๒๖ ม.ค. ๒๕๔๕
กำลังรวบยอด	gross power	๒๖ ม.ค. ๒๕๔๕
กำลังเสียดทาน	friction power	๒๖ ม.ค. ๒๕๔๕
กำลังเครื่องยนต์	engine power	๒๖ ม.ค. ๒๕๔๕
กำลังสุทธิ	net power	๒๖ ม.ค. ๒๕๔๕
กำลังนิวเคลียร์	nuclear power	๒๖ ม.ค. ๒๕๔๕
กำลังบ่งชี้ (ไอพี)	indicated power (ip)	๒๖ ม.ค. ๒๕๔๕
กำลังลม	wind power	๒๖ ม.ค. ๒๕๔๕
กำลังลมใช้ได้	available wind power	๒๖ ม.ค. ๒๕๔๕
กำลังการเปล่ง	emissive power	๒๖ ม.ค. ๒๕๔๕
กล่องดักไอน้ำมันแบบใช้ถ่าน	carbon canister; charcoal canister	๒๖ ม.ค. ๒๕๔๕
กลศาสตร์ของไหล	fluid mechanics	๒๖ ม.ค. ๒๕๔๕
กลอุปกรณ์ควบคุม	control device	๒๖ ม.ค. ๒๕๔๕
กลไก	mechanism	๒๖ ม.ค. ๒๕๔๕
กลไกเรย์ลี	Rayleigh mechanism	๒๖ ม.ค. ๒๕๔๕
กฎของเคิร์ชฮอฟฟ์	Kirchhoff’s law	๒๖ ม.ค. ๒๕๔๕
กฎของบูแกร์	Bouguer’s law	๒๖ ม.ค. ๒๕๔๕
กฎของพลังค์	Planck’s law	๒๖ ม.ค. ๒๕๔๕
กฎของฟูริเอร์	Fourier’s law	๒๖ ม.ค. ๒๕๔๕
ข้อมูลการแผ่รังสี	radiation data	๒๖ ม.ค. ๒๕๔๕
ของไหล	fluid	๒๖ ม.ค. ๒๕๔๕
ของไหลใช้งาน	working fluid	๒๖ ม.ค. ๒๕๔๕
ครึ่งมุมรับรังสี	acceptance half-angle	๒๖ ม.ค. ๒๕๔๕
ความเร่ง(ของลม)บนยอดเนิน	acceleration on ridge	๒๖ ม.ค. ๒๕๔๕
ความเร่ง(ของลม)บนยอดเนิน	acceleration on ridge	๒๖ ม.ค. ๒๕๔๕
ความเยื้องศูนย์กลางของวงโคจร	orbital eccentricity	๒๖ ม.ค. ๒๕๔๕
ความเสียดทานการไหล	flow friction	๒๖ ม.ค. ๒๕๔๕
ความยังผล, ประสิทธิผล	effectiveness	๒๖ ม.ค. ๒๕๔๕
ความรับอาบรังสี	irradiance	๒๖ ม.ค. ๒๕๔๕
ความเข้มรังสี	radiation intensity	๒๖ ม.ค. ๒๕๔๕
ความเค้นเฉือน	shearing stress	๒๖ ม.ค. ๒๕๔๕
ความเค้นดัดโค้ง	bending stress	๒๖ ม.ค. ๒๕๔๕
ความเค้นดึง	tensile stress	๒๖ ม.ค. ๒๕๔๕
ความเปล่ง	emittance	๒๖ ม.ค. ๒๕๔๕
ความสะท้อน	reflectance	๒๖ ม.ค. ๒๕๔๕
ความส่งผ่าน	transmittance	๒๖ ม.ค. ๒๕๔๕
ความสูญเสียจากการเสียดทาน	frictional loss	๒๖ ม.ค. ๒๕๔๕
ความสูญเสียปลายใบพัด	tip loss	๒๖ ม.ค. ๒๕๔๕
ความหนืด	viscosity	๒๖ ม.ค. ๒๕๔๕
ความจุเครื่องยนต์	displacement; engine displacement	๒๖ ม.ค. ๒๕๔๕
ความจุความร้อนของมวลสะสม	storage mass heat capacity	๒๖ ม.ค. ๒๕๔๕
ความชื้นสัมพัทธ์	relative humidity	๒๖ ม.ค. ๒๕๔๕
ความดันสัมบูรณ์	absolute pressure	๒๖ ม.ค. ๒๕๔๕
ความดันอัด	compression pressure	๒๖ ม.ค. ๒๕๔๕
ความดันอากาศ	air pressure	๒๖ ม.ค. ๒๕๔๕
ความดูดกลืน	absorptance	๒๖ ม.ค. ๒๕๔๕
ความต้านลม; แรงต้านลม	air resistance	๒๖ ม.ค. ๒๕๔๕
ความถี่พ้อง, ความถี่เรโซแนนซ์	resonance frequency; resonant frequency	๒๖ ม.ค. ๒๕๔๕
ความนำ	conductance	๒๖ ม.ค. ๒๕๔๕
ความปั่นป่วน	turbulence	๒๖ ม.ค. ๒๕๔๕
ค่าเหมาะที่สุด; เหมาะที่สุด	optimum	๒๖ ม.ค. ๒๕๔๕
ค่าเบี่ยงเบนมาตรฐาน	standard deviation	๒๖ ม.ค. ๒๕๔๕
ค่าความร้อน	calorific value	๒๖ ม.ค. ๒๕๔๕
ค่าคงตัวเวลา	time constant	๒๖ ม.ค. ๒๕๔๕
ค่าคงตัวรังสีอาทิตย์	solar constant	๒๖ ม.ค. ๒๕๔๕
ค่าช่องว่างพลังงาน	energy gap	๒๖ ม.ค. ๒๕๔๕
ค่าประเมินออกเทน	octane rating	๒๖ ม.ค. ๒๕๔๕
ค่าประเมินกันการน็อก	antiknock rating	๒๖ ม.ค. ๒๕๔๕
คอร์ด	chord	๒๖ ม.ค. ๒๕๔๕
คอคอด	throat	๒๖ ม.ค. ๒๕๔๕
คอคอด; เวนจูริ	venturi	๒๖ ม.ค. ๒๕๔๕
คอนเดนเซอร์, เครื่องควบแน่น	condenser	๒๖ ม.ค. ๒๕๔๕
คาร์บอนมอนอกไซด์	carbon monoxide	๒๖ ม.ค. ๒๕๔๕
คาร์บอนไดออกไซด์	carbon dioxide	๒๖ ม.ค. ๒๕๔๕
คู่ควบอุณหภูมิ, เทอร์มอคัปเปิล	thermocouple	๒๖ ม.ค. ๒๕๔๕
คู่ต่อ; การคู่ควบ	coupling	๒๖ ม.ค. ๒๕๔๕
จังหวะอัด	compression stroke	๒๖ ม.ค. ๒๕๔๕
จังหวะกำลัง	power stroke	๒๖ ม.ค. ๒๕๔๕
จังหวะคาย	exhaust stroke	๒๖ ม.ค. ๒๕๔๕
จังหวะดูด	inlet stroke; intake stroke; suction stroke	๒๖ ม.ค. ๒๕๔๕
จุดระเบิดย้อนกลับ; การจุดระเบิดย้อนกลับ	backfire	๒๖ ม.ค. ๒๕๔๕
จุดระเบิดไม่ครบสูบ; การจุดระเบิดไม่ครบสูบ	misfire; miss	๒๖ ม.ค. ๒๕๔๕
จุดวาบไฟ	flash point	๒๖ ม.ค. ๒๕๔๕
ฉนวน; การฉนวน	insulation	๒๖ ม.ค. ๒๕๔๕
ช่วงล่าช้าก่อนการเผาไหม้	ignition lag	๒๖ ม.ค. ๒๕๔๕
ช่องอากาศ	air gap	๒๖ ม.ค. ๒๕๔๕
ชีวภาค	biosphere	๒๖ ม.ค. ๒๕๔๕
ชุดแผ่นธาตุ	battery element; element	๒๖ ม.ค. ๒๕๔๕
ซับสเตรต	substrate	๒๖ ม.ค. ๒๕๔๕
ซี่ล้อ, กำ	spoke	๒๖ ม.ค. ๒๕๔๕
ดรรชนีหักเห	refractive index	๒๖ ม.ค. ๒๕๔๕
ดรรชนีความใส	clearness index	๒๖ ม.ค. ๒๕๔๕
ดรรชนีต้านการน็อก	antiknock index	๒๖ ม.ค. ๒๕๔๕
ดาวเทียมผลิตกำลังด้วยรังสีอาทิตย์	satellite solar power station	๒๖ ม.ค. ๒๕๔๕
ดีกรี-เดย์ปรกติ, องศา-วันปรกติ	normal degree-days	๒๖ ม.ค. ๒๕๔๕
ดิฟฟิวเซอร์	diffuser	๒๖ ม.ค. ๒๕๔๕
ตะบันน้ำ	impulse pump	๒๖ ม.ค. ๒๕๔๕
ตัวเร่งออกซิเดชัน	oxidation catalyst	๒๖ ม.ค. ๒๕๔๕
ตัวแยกไอและเชื้อเพลิง	vapour-fuel separator; vapour-liquid separator	๒๖ ม.ค. ๒๕๔๕
ตัวรวมรังสีแบบราง	trough-type concentrator	๒๖ ม.ค. ๒๕๔๕
ตัวรวมรังสีแบบรางตัววี	V-trough concentrator	๒๖ ม.ค. ๒๕๔๕
ตัวรวมรังสีอาทิตย์	solar concentrator	๒๖ ม.ค. ๒๕๔๕
ตัวรับรู้แลมบ์ดา	Lambda sensor	๒๖ ม.ค. ๒๕๔๕
ตัวรับรู้ปริมาณออกซิเจน	oxygen sensor	๒๖ ม.ค. ๒๕๔๕
ตัวรับรังสีรวม	receiver	๒๖ ม.ค. ๒๕๔๕
ตัวรับรังสีรวมกลาง	central receiver	๒๖ ม.ค. ๒๕๔๕
ตัวรับรู้, เครื่องรับรู้, อุปกรณ์รับรู้	sensor	๒๖ ม.ค. ๒๕๔๕
ตัวเก็บรังสีแบบรวม	concentrating collector	๒๖ ม.ค. ๒๕๔๕
ตัวเก็บรังสีแบบรังผึ้ง	honeycomb collector	๒๖ ม.ค. ๒๕๔๕
ตัวเก็บรังสีแบบรางตัววี	V-trough collector	๒๖ ม.ค. ๒๕๔๕
ตัวเก็บรังสีแบบรางพาราโบลา	parabolic trough collector	๒๖ ม.ค. ๒๕๔๕
ตัวเก็บรังสีแบบแผ่นราบ	flat-plate collector	๒๖ ม.ค. ๒๕๔๕
ตัวเก็บรังสีแบบโฟกัส	focusing collector	๒๖ ม.ค. ๒๕๔๕
ตัวเก็บรังสีแบบหล่อเย็นด้วยอากาศ	air-cooled collector	๒๖ ม.ค. ๒๕๔๕
ตัวเก็บรังสีแบบสถานีโคจร	orbiting station collector	๒๖ ม.ค. ๒๕๔๕
ตัวเก็บรังสีแบบซีพีซี	compound parabolic concentrating collector; compound parabolic concentrator; CPC collector	๒๖ ม.ค. ๒๕๔๕
ตัวเก็บรังสีแบบติดตามต่อเนื่อง	continuous tracking collector	๒๖ ม.ค. ๒๕๔๕
ตัวเก็บรังสีแบบทรงกระบอก	cylindrical collector	๒๖ ม.ค. ๒๕๔๕
ตัวเก็บรังสีแบบท่อ	tubular collector	๒๖ ม.ค. ๒๕๔๕
ตัวเก็บรังสีแบบท่อร่วมศูนย์กลาง	concentric-tube collector	๒๖ ม.ค. ๒๕๔๕
ตัวเก็บรังสีแบบท่อสุญญากาศ	evacuated-tube collector	๒๖ ม.ค. ๒๕๔๕
ตัวเก็บรังสีอาทิตย์	solar collector	๒๖ ม.ค. ๒๕๔๕
ตัวเก็บรังสีอาทิตย์ระบบอากาศ	solar air system collector	๒๖ ม.ค. ๒๕๔๕
ตัวเก็บประจุ	capacitor	๒๖ ม.ค. ๒๕๔๕
ตัวแปรเสริม; พารามิเตอร์	parameter	๒๖ ม.ค. ๒๕๔๕
ตัวแบบการแลกเปลี่ยนจลน์; แบบจำลองการแลกเปลี่ยนจลน์	kinetic exchange model	๒๖ ม.ค. ๒๕๔๕
ตัวแบบคอมพิวเตอร์; แบบจำลองคอมพิวเตอร์	computer model	๒๖ ม.ค. ๒๕๔๕
ตัวแบบคณิตศาสตร์; แบบจำลองคณิตศาสตร์	mathematical model	๒๖ ม.ค. ๒๕๔๕
ตัวเพิ่มความเข้มรังสี	optical booster	๒๖ ม.ค. ๒๕๔๕
ตัวหมุน, โรเตอร์	rotor	๒๖ ม.ค. ๒๕๔๕
ตัวสะสม; การสะสม	storage	๒๖ ม.ค. ๒๕๔๕
ตัวสะสมในสถานะของแข็ง; การสะสมในสถานะของแข็ง	solid-phase storage	๒๖ ม.ค. ๒๕๔๕
ตัวสะสมแบบเปลี่ยนสถานะ; การสะสมแบบเปลี่ยนสถานะ	phase-change storage	๒๖ ม.ค. ๒๕๔๕
ตัวสะสมแบบถังอนุภาค; การสะสมแบบถังอนุภาค	particle-bed storage	๒๖ ม.ค. ๒๕๔๕
ตัวสะสมแบบถังกรวด; การสะสมแบบถังกรวด	pebble-bed storage	๒๖ ม.ค. ๒๕๔๕
ตัวสะสมความร้อนแฝง; การสะสมความร้อนแฝง	latent-heat storage	๒๖ ม.ค. ๒๕๔๕
ตัวสะสมพลังงานอุณหภูมิต่ำ; การสะสมพลังงานอุณหภูมิต่ำ	low-temperature storage	๒๖ ม.ค. ๒๕๔๕
ตัวกรอง	filter	๒๖ ม.ค. ๒๕๔๕
ตัวกรองระดับโมเลกุล	molecular sieve	๒๖ ม.ค. ๒๕๔๕
ตัวควบคุมการทำความร้อน; การควบคุมการทำความร้อน	heating control	๒๖ ม.ค. ๒๕๔๕
ตัวดูดกลืน	absorber	๒๖ ม.ค. ๒๕๔๕
ตัวทำความเย็นแบบระเหย	evaporative cooler	๒๖ ม.ค. ๒๕๔๕
ตัวประหยัดน้ำมัน	economiser	๒๖ ม.ค. ๒๕๔๕
ตัวประกอบเหนี่ยวนำตามแกน	axial induction factor	๒๖ ม.ค. ๒๕๔๕
ตัวประกอบเหนี่ยวนำตามแนวสัมผัส	tangential induction factor	๒๖ ม.ค. ๒๕๔๕
ตัวประกอบแบบรูปพลังงาน	energy pattern factor	๒๖ ม.ค. ๒๕๔๕
ตัวประกอบสมรรถนะตามฤดูกาล	seasonal performance factor	๒๖ ม.ค. ๒๕๔๕
ถังรับการขยาย	expansion tank	๒๖ ม.ค. ๒๕๔๕
ถังสะสม(พลังงาน)	storage tank	๒๖ ม.ค. ๒๕๔๕
ถังสะสม(พลังงาน)อุณหภาพ	thermal storage tank	๒๖ ม.ค. ๒๕๔๕
ถังสะสม(พลังงาน)	storage tank	๒๖ ม.ค. ๒๕๔๕
ถังสะสม(พลังงาน)อุณหภาพ	thermal storage tank	๒๖ ม.ค. ๒๕๔๕
ท่อ	pipe	๒๖ ม.ค. ๒๕๔๕
ท่อ; ท่อร้อยสาย	conduit	๒๖ ม.ค. ๒๕๔๕
ท่อ; ท่อลม	duct	๒๖ ม.ค. ๒๕๔๕
ท่อ; หลอด	tube	๒๖ ม.ค. ๒๕๔๕
ท่อร่วมไอดี	induction manifold; inlet manifold; intake manifold	๒๖ ม.ค. ๒๕๔๕
ท่อร้อยสาย; ท่อ	conduit	๒๖ ม.ค. ๒๕๔๕
ท่อลม; ท่อ	duct	๒๖ ม.ค. ๒๕๔๕
ท่อความร้อนแบบฉนวนสุญญากาศ	vacuum-insulated heat pipe	๒๖ ม.ค. ๒๕๔๕
ท่อความดันสูง	high-pressure line	๒๖ ม.ค. ๒๕๔๕
ท่อจ่าย	distribution conduit	๒๖ ม.ค. ๒๕๔๕
ท่อดูด	suction line	๒๖ ม.ค. ๒๕๔๕
ทอร์กรวบยอด	gross torque	๒๖ ม.ค. ๒๕๔๕
ทอร์กสุทธิ	net torque	๒๖ ม.ค. ๒๕๔๕
ทอร์กของเครื่องสูบ, ทอร์กของปั๊ม	pump torque	๒๖ ม.ค. ๒๕๔๕
ทำให้เหมาะที่สุด	optimise	๒๖ ม.ค. ๒๕๔๕
ทีดับเบิลยูซี (เครื่องฟอกไอเสียเชิงเร่งปฏิกิริยาสามทาง, แคทาลิติกคอนเวอร์เตอร์สามทาง)	TWC (three-way catalytic converter)	๒๖ ม.ค. ๒๕๔๕
ทฤษฎีโมเมนตัมตามแกน	axial momentum theory	๒๖ ม.ค. ๒๕๔๕
ทฤษฎีแบบง่ายเกี่ยวกับช่องน้ำผ่าน	leak holes simplified theory	๒๖ ม.ค. ๒๕๔๕
ทฤษฎีส่วนของใบพัด	blade element theory	๒๖ ม.ค. ๒๕๔๕
ทุ่นแบบซอลเตอร์	Salter duck	๒๖ ม.ค. ๒๕๔๕
น็อกจากเชื้อเพลิง	fuel knock	๒๖ ม.ค. ๒๕๔๕
น้ำมันเครื่อง; น้ำมันเชื้อเพลิง [ใช้กับเครื่องยนต์ดีเซล]; น้ำมันหล่อลื่น	oil	๒๖ ม.ค. ๒๕๔๕
น้ำมันเชื้อเพลิงตะกั่วต่ำ	low-lead fuel	๒๖ ม.ค. ๒๕๔๕
น้ำมันหล่อลื่น; น้ำมันเครื่อง; น้ำมันเชื้อเพลิง [ใช้กับเครื่องยนต์ดีเซล]	oil	๒๖ ม.ค. ๒๕๔๕
น้ำเกลือ	saline water	๒๖ ม.ค. ๒๕๔๕
บิโยต์มอดุลัส	Biot modulus	๒๖ ม.ค. ๒๕๔๕
ประสิทธิภาพรายวัน	daily efficiency	๒๖ ม.ค. ๒๕๔๕
ประสิทธิภาพเครื่องยนต์	engine efficiency	๒๖ ม.ค. ๒๕๔๕
ประสิทธิภาพเครื่องสูบ, ประสิทธิภาพปั๊ม	pump efficiency	๒๖ ม.ค. ๒๕๔๕
ประสิทธิภาพเชิงรังสี, ประสิทธิภาพเชิงแสง	optical efficiency	๒๖ ม.ค. ๒๕๔๕
ประสิทธิภาพเชิงปริมาตร	volumetric efficiency	๒๖ ม.ค. ๒๕๔๕
ประสิทธิภาพอุณหภาพ	thermal efficiency	๒๖ ม.ค. ๒๕๔๕
ประสิทธิภาพคาร์โนต์	Carnot efficiency	๒๖ ม.ค. ๒๕๔๕
ประสิทธิภาพตามกฎข้อที่สอง	energetic efficiency; exergetic efficiency; rational efficiency; second law efficiency	๒๖ ม.ค. ๒๕๔๕
ประสิทธิภาพตามกฎข้อที่หนึ่ง	first law efficiency	๒๖ ม.ค. ๒๕๔๕
ประสิทธิภาพปั๊ม, ประสิทธิภาพเครื่องสูบ	pump efficiency	๒๖ ม.ค. ๒๕๔๕
ปั๊ม, เครื่องสูบ; สูบ	pump	๒๖ ม.ค. ๒๕๔๕
ปั๊มเชิงกล, เครื่องสูบเชิงกล	mechanical pump	๒๖ ม.ค. ๒๕๔๕
ปั๊ม(แบบ)ลูกสูบ, เครื่องสูบ(แบบ)ลูกสูบ	piston pump	๒๖ ม.ค. ๒๕๔๕
ปั๊มหอยโข่ง, เครื่องสูบแรงเหวี่ยง	centrifugal pump	๒๖ ม.ค. ๒๕๔๕
ปั๊มสุญญากาศ	aspirator; vacuum pump	๒๖ ม.ค. ๒๕๔๕
ปั๊ม(แบบ)ลูกสูบ, เครื่องสูบ(แบบ)ลูกสูบ	piston pump	๒๖ ม.ค. ๒๕๔๕
ปั๊มขับด้วยลม, เครื่องสูบขับด้วยลม	wind driven pump	๒๖ ม.ค. ๒๕๔๕
ปิโตรเลียม	petroleum	๒๖ ม.ค. ๒๕๔๕
พัดลม	fan	๒๖ ม.ค. ๒๕๔๕
พารามิเตอร์; ตัวแปรเสริม	parameter	๒๖ ม.ค. ๒๕๔๕
พารามิเตอร์บรรยากาศ	atmospheric parameter	๒๖ ม.ค. ๒๕๔๕
พารามิเตอร์บ่งรูปร่าง	shape parameter	๒๖ ม.ค. ๒๕๔๕
พารามิเตอร์บ่งขนาด	scale parameter	๒๖ ม.ค. ๒๕๔๕
พีพีเอ็ม (ส่วนในล้านส่วน)	ppm (parts per million)	๒๖ ม.ค. ๒๕๔๕
พลังงานใส่เข้า	energy input	๒๖ ม.ค. ๒๕๔๕
พลศาสตร์ของไหล	fluid dynamics	๒๖ ม.ค. ๒๕๔๕
พลังงานเข้า	energy in	๒๖ ม.ค. ๒๕๔๕
พลังงานออก	energy out	๒๖ ม.ค. ๒๕๔๕
พลังงานออกใช้	energy output	๒๖ ม.ค. ๒๕๔๕
พลังงานจลน์	kinetic energy	๒๖ ม.ค. ๒๕๔๕
พื้นที่กวาด	swept area	๒๖ ม.ค. ๒๕๔๕
พื้นที่ช่องรับรังสี	aperture area	๒๖ ม.ค. ๒๕๔๕
ฟลักซ์การแผ่รังสี; ฟลักซ์รังสี	radiation flux	๒๖ ม.ค. ๒๕๔๕
ฟลักซ์รังสี; ฟลักซ์การแผ่รังสี	radiation flux	๒๖ ม.ค. ๒๕๔๕
