โรงละคร; ละคร	theatre	๖ มี.ค. ๒๕๔๕
เรื่องย่อย	sketch	๖ มี.ค. ๒๕๔๕
เรื่องเหลือเชื่อ	yarn	๖ มี.ค. ๒๕๔๕
เรื่องเหนี่ยวนำ	induction	๖ มี.ค. ๒๕๔๕
เรื่องเหนือธรรมชาติ	supernatural story	๖ มี.ค. ๒๕๔๕
เรื่องเล่า	narrative	๖ มี.ค. ๒๕๔๕
เรื่องเล่าโมะโนะงะตะริ	Monogatari	๖ มี.ค. ๒๕๔๕
เรื่องสั้น	short story	๖ มี.ค. ๒๕๔๕
เรื่องสั้น [ฝรั่งเศส]; นวนิยายขนาดสั้น [อังกฤษ]	novelette	๖ มี.ค. ๒๕๔๕
เรื่องเร้ากามารมณ์	pornography	๖ มี.ค. ๒๕๔๕
เรื่องย่อ	summary; synopsis	๖ มี.ค. ๒๕๔๕
เรื่องกุ	cock and bull story	๖ มี.ค. ๒๕๔๕
เรื่องขบขันล้อเลียน	burlesque	๖ มี.ค. ๒๕๔๕
เรื่องจารกรรม	spy story	๖ มี.ค. ๒๕๔๕
เรื่องซ้อนเรื่อง	story within a story	๖ มี.ค. ๒๕๔๕
เรื่องตื่นเต้น	thriller	๖ มี.ค. ๒๕๔๕
เรื่องนักสืบ	detective story	๖ มี.ค. ๒๕๔๕
เรื่องปรัมปรา	myth	๖ มี.ค. ๒๕๔๕
abridged edition	ฉบับตัดย่อ	๖ มี.ค. ๒๕๔๕
abstract	๑. บทคัดย่อ๒. นามธรรม	๖ มี.ค. ๒๕๔๕
abstract poem	สัทกานท์, บทกวีนามธรรม	๖ มี.ค. ๒๕๔๕
รวมเพลงขับ	chansonnier	๖ มี.ค. ๒๕๔๕
academic drama	ละครปัญญาชน	๖ มี.ค. ๒๕๔๕
academy	สํานักวิชา	๖ มี.ค. ๒๕๔๕
accent; stress	๑. พยางค์เน้น๒. การเน้นพยางค์	๖ มี.ค. ๒๕๔๕
acephalous; headless line	บาทไร้หัว	๖ มี.ค. ๒๕๔๕
โวหารย้อนกระทบ	autoclesis	๖ มี.ค. ๒๕๔๕
โวหารย้อนคำ	chiasmus	๖ มี.ค. ๒๕๔๕
โวหารเล่นคำหลากความ	zeugma	๖ มี.ค. ๒๕๔๕
โวหารแบบมารีโว	Marivaudage	๖ มี.ค. ๒๕๔๕
acrostic	อักษรกล	๖ มี.ค. ๒๕๔๕
act	องก์	๖ มี.ค. ๒๕๔๕
action	การดำเนินเรื่อง	๖ มี.ค. ๒๕๔๕
adage	ภาษิต	๖ มี.ค. ๒๕๔๕
adaptation	การดัดแปลง	๖ มี.ค. ๒๕๔๕
addendum	บทเพิ่มเติม	๖ มี.ค. ๒๕๔๕
address	คำปราศรัย	๖ มี.ค. ๒๕๔๕
รสวรรณคดี	rasa	๖ มี.ค. ๒๕๔๕
เสวนาสโมสร, ซาลง	salon	๖ มี.ค. ๒๕๔๕
ร้อยแก้ว	prose	๖ มี.ค. ๒๕๔๕
ร้อยแก้วแนวร้อยกรอง	poetic prose	๖ มี.ค. ๒๕๔๕
ย่อหน้า, อนุเฉท	paragraph	๖ มี.ค. ๒๕๔๕
เสียงแฝง	voice	๖ มี.ค. ๒๕๔๕
เสียงรื่นหู	euphony	๖ มี.ค. ๒๕๔๕
เสียงกระด้าง	cacophony	๖ มี.ค. ๒๕๔๕
มหากาพย์	epic	๖ มี.ค. ๒๕๔๕
มหากาพย์เรื่องสัตว์	beast epic	๖ มี.ค. ๒๕๔๕
มหากาพย์กำมะลอ	mock-epic	๖ มี.ค. ๒๕๔๕
เสี้ยวชีวิต	slice of life	๖ มี.ค. ๒๕๔๕
ร่างพระราชบัญญัติการปฏิรูป ค.ศ. ๑๘๓๒	Reform Bill of 1832	๖ มี.ค. ๒๕๔๕
aestheticism	สุนทรียนิยม	๖ มี.ค. ๒๕๔๕
aesthetic distance	ความเป็นกลางทางสุนทรียภาพ	๖ มี.ค. ๒๕๔๕
โศลก	sloka	๖ มี.ค. ๒๕๔๕
โศกนาฏกรรม	tragedy	๖ มี.ค. ๒๕๔๕
โศกนาฏกรรมแบบเซเนกา	Senecan tragedy	๖ มี.ค. ๒๕๔๕
โศกนาฏกรรมล้างแค้น	revenge tragedy	๖ มี.ค. ๒๕๔๕
โศกนาฏกรรมกรีก	Greek tragedy	๖ มี.ค. ๒๕๔๕
โศกนาฏกรรมครอบครัว	domestic tragedy	๖ มี.ค. ๒๕๔๕
โศกนาฏกรรมชนชั้นกลาง	bourgeois tragedy	๖ มี.ค. ๒๕๔๕
โศกนาฏกรรมนองเลือด	tragedy of blood	๖ มี.ค. ๒๕๔๕
เหตุการณ์พลิกผัน	Coup de Théâtre	๖ มี.ค. ๒๕๔๕
เหตุผลนิยม	rationalism	๖ มี.ค. ๒๕๔๕
โสธนะ	catharsis	๖ มี.ค. ๒๕๔๕
รสนิยม	taste	๖ มี.ค. ๒๕๔๕
affective fallacy	ความผิดพลาดเหตุกระทบใจ	๖ มี.ค. ๒๕๔๕
affectation	ความไม่ผสาน	๖ มี.ค. ๒๕๔๕
Age of reason	ยุคเหตุผล	๖ มี.ค. ๒๕๔๕
agrarians	กลุ่มเกษตรนิยม	๖ มี.ค. ๒๕๔๕
air	เพลง	๖ มี.ค. ๒๕๔๕
เอกภาพ	unity	๖ มี.ค. ๒๕๔๕
เอกสารเฉพาะเรื่อง	monograph	๖ มี.ค. ๒๕๔๕
เอกสารข้อมูล; วรรณกรรม; วรรณคดี	literature	๖ มี.ค. ๒๕๔๕
เอกสิทธิ์กวี	poetic license	๖ มี.ค. ๒๕๔๕
เอกสารตัวเขียน; ต้นฉบับ	manuscript	๖ มี.ค. ๒๕๔๕
akhyana	อาขยาน	๖ มี.ค. ๒๕๔๕
alexandrine	บทร้อยกรองอะเล็กซันดรีน	๖ มี.ค. ๒๕๔๕
allegory	อุปมานิทัศน์	๖ มี.ค. ๒๕๔๕
alliteration	การสัมผัสอักษร	๖ มี.ค. ๒๕๔๕
alliterative verse	บทร้อยกรองสัมผัสอักษร	๖ มี.ค. ๒๕๔๕
allonym	นามยืม	๖ มี.ค. ๒๕๔๕
allusion	การอ้างถึง	๖ มี.ค. ๒๕๔๕
almanac	กาลานุกรม	๖ มี.ค. ๒๕๔๕
altar poem	บทกวีรูปแท่นบูชา	๖ มี.ค. ๒๕๔๕
alternate rhyme	สัมผัสสลับ	๖ มี.ค. ๒๕๔๕
ambiguity	ความกำกวม	๖ มี.ค. ๒๕๔๕
amblysia	การลดความรุนแรง	๖ มี.ค. ๒๕๔๕
amphibrach	คณะแอมฟิแบรก	๖ มี.ค. ๒๕๔๕
amphigory	บทล้อไร้สาระ	๖ มี.ค. ๒๕๔๕
amplification	การขยายความ	๖ มี.ค. ๒๕๔๕
anabasis; rising action	การขมวดปม	๖ มี.ค. ๒๕๔๕
anachorism	อสถานะ	๖ มี.ค. ๒๕๔๕
anachronism	การผิดกาละ	๖ มี.ค. ๒๕๔๕
anacoluthon	ความไม่สืบเนื่อง	๖ มี.ค. ๒๕๔๕
anacrusis	อะนาครูซิส	๖ มี.ค. ๒๕๔๕
anadiplosis	การทวนคำ	๖ มี.ค. ๒๕๔๕
anagram	คำสลับอักษร	๖ มี.ค. ๒๕๔๕
analects	ปกิณกคดี	๖ มี.ค. ๒๕๔๕
analogue	วรรณกรรมคล้ายคลึง	๖ มี.ค. ๒๕๔๕
analogy	แนวเทียบ	๖ มี.ค. ๒๕๔๕
analysed rhyme	สัมผัสวิเคราะห์	๖ มี.ค. ๒๕๔๕
analysis	การวิเคราะห์	๖ มี.ค. ๒๕๔๕
anaphora	การเน้นซ้ำคำ	๖ มี.ค. ๒๕๔๕
anatomy	วรรณวิภาค	๖ มี.ค. ๒๕๔๕
anamnesis	การย้อนรำลึก	๖ มี.ค. ๒๕๔๕
ananym	คำย้อนอักษร	๖ มี.ค. ๒๕๔๕
anapaest; anapaestic foot; anapest; anapestic foot	คณะแอนาเพสต์	๖ มี.ค. ๒๕๔๕
anapaestic foot; anapaest; anapest; anapestic foot	คณะแอนาเพสต์	๖ มี.ค. ๒๕๔๕
anapest; anapaest; anapaestic foot; anapestic foot	คณะแอนาเพสต์	๖ มี.ค. ๒๕๔๕
anapestic foot; anapaest; anapaestic foot; anapest	คณะแอนาเพสต์	๖ มี.ค. ๒๕๔๕
ancients and moderns	หัวเก่ากับหัวใหม่	๖ มี.ค. ๒๕๔๕
anecdote	เกร็ด	๖ มี.ค. ๒๕๔๕
angry young man	กลุ่มหนุ่มเจ้าโทสะ	๖ มี.ค. ๒๕๔๕
anisometric	อสมบาท	๖ มี.ค. ๒๕๔๕
annals	หนังสือรายปี	๖ มี.ค. ๒๕๔๕
annotation	ความเห็นประกอบ	๖ มี.ค. ๒๕๔๕
anonymous	นิรนาม	๖ มี.ค. ๒๕๔๕
antagonist	ปฏิปักษ์	๖ มี.ค. ๒๕๔๕
anthology	ประชุมบทนิพนธ์	๖ มี.ค. ๒๕๔๕
anti-hero	ตัวเอกปฏิลักษณ์	๖ มี.ค. ๒๕๔๕
anti-novel	นวนิยายปฏิลักษณ์	๖ มี.ค. ๒๕๔๕
anti-play	ละครปฏิลักษณ์	๖ มี.ค. ๒๕๔๕
anticlimax	ปฏิบท	๖ มี.ค. ๒๕๔๕
anthypophora	การแสร้งแย้ง	๖ มี.ค. ๒๕๔๕
antiphrasis	ปฏิวลี	๖ มี.ค. ๒๕๔๕
antithesis	ภาวะแย้ง	๖ มี.ค. ๒๕๔๕
antonomasia	สมญานาม	๖ มี.ค. ๒๕๔๕
antonym	คำตรงกันข้าม	๖ มี.ค. ๒๕๔๕
รักเทิดทูน	courtly love	๖ มี.ค. ๒๕๔๕
รัตนกวี	poet laureate	๖ มี.ค. ๒๕๔๕
รายชื่อตัวละคร	dramatis personae	๖ มี.ค. ๒๕๔๕
ภาวะแย้ง	antithesis	๖ มี.ค. ๒๕๔๕
ภาวะเวทนา	pathos	๖ มี.ค. ๒๕๔๕
ภาวะเลอเลิศ	sublime	๖ มี.ค. ๒๕๔๕
ภาษาเร้าอารมณ์	emotive language	๖ มี.ค. ๒๕๔๕
ภาษาเฉพาะวงการ	jargon	๖ มี.ค. ๒๕๔๕
ภาษาเฉพาะกลุ่ม	argot	๖ มี.ค. ๒๕๔๕
ภาษาภาพพจน์	figurative language	๖ มี.ค. ๒๕๔๕
ภาษาอังกฤษใหม่	Modern English	๖ มี.ค. ๒๕๔๕
ภาษาอังกฤษเก่า	Old English	๖ มี.ค. ๒๕๔๕
ภาษาอังกฤษกลาง	Middle English	๖ มี.ค. ๒๕๔๕
ภาษาไพจิตร	aureate language	๖ มี.ค. ๒๕๔๕
ภาษาชนบท	patois	๖ มี.ค. ๒๕๔๕
ภาษิต	adage	๖ มี.ค. ๒๕๔๕
ภาษาถิ่น	dialect	๖ มี.ค. ๒๕๔๕
ภาษาปาก	colloquial; colloquial language	๖ มี.ค. ๒๕๔๕
ภาคผนวก	appendix	๖ มี.ค. ๒๕๔๕
มาตรา	meter; metre	๖ มี.ค. ๒๕๔๕
มาตรายาว	long measure; long meter	๖ มี.ค. ๒๕๔๕
มาตราเจ็ดคณะ	heptameter	๖ มี.ค. ๒๕๔๕
มาตราแปดคณะ	octameter	๖ มี.ค. ๒๕๔๕
มาตราห้าคณะ	pentameter	๖ มี.ค. ๒๕๔๕
มาตราสองคณะ	dimeter	๖ มี.ค. ๒๕๔๕
มาตราสั้น	short measure; short meter	๖ มี.ค. ๒๕๔๕
มาตราไอแอมบ์หกคณะ	iambic hexameter	๖ มี.ค. ๒๕๔๕
มาตราไอแอมบ์คณะเดียว	iambic monometer	๖ มี.ค. ๒๕๔๕
มาตราคณะเดียว	monometer	๖ มี.ค. ๒๕๔๕
มาตราสามัญ	common measure; common meter	๖ มี.ค. ๒๕๔๕
มาตราสามคณะ	trimeter	๖ มี.ค. ๒๕๔๕
มาตราสี่คณะ	tetrameter	๖ มี.ค. ๒๕๔๕
มาตราหกคณะ	hexameter	๖ มี.ค. ๒๕๔๕
มาตราไอแอมบ์แปดคณะ	iambic octameter	๖ มี.ค. ๒๕๔๕
มาตราไอแอมบ์ห้าคณะ	iambic pentameter	๖ มี.ค. ๒๕๔๕
มาตราไอแอมบ์สองคณะ	iambic dimeter	๖ มี.ค. ๒๕๔๕
มาตราไอแอมบ์สามคณะ	iambic trimeter	๖ มี.ค. ๒๕๔๕
มาตราไอแอมบ์สี่คณะ	iambic tetrameter	๖ มี.ค. ๒๕๔๕
ภาพย้อนหลัง	flashback	๖ มี.ค. ๒๕๔๕
ภาพในฝัน	dream vision	๖ มี.ค. ๒๕๔๕
ภาพล้อ	caricature	๖ มี.ค. ๒๕๔๕
ภาพลักษณ์; จินตภาพ	image	๖ มี.ค. ๒๕๔๕
ภาพพจน์	figure of speech	๖ มี.ค. ๒๕๔๕
ภาพพจน์เปรียบเทียบ; การแสดงในพิธีมิสซา	trope	๖ มี.ค. ๒๕๔๕
ภาพพจน์วาทศิลป์	rhetorical figure	๖ มี.ค. ๒๕๔๕
ภาพพจน์ลดค่า	tapinosis	๖ มี.ค. ๒๕๔๕
aphaeresis	การตัดต้นคำ	๖ มี.ค. ๒๕๔๕
aphesis	การกร่อนต้นคำ	๖ มี.ค. ๒๕๔๕
aphorism	คำพังเพย	๖ มี.ค. ๒๕๔๕
apocalyptic literature	วรรณกรรมพยากรณ์	๖ มี.ค. ๒๕๔๕
apocope	การตัดท้ายคำ	๖ มี.ค. ๒๕๔๕
apocrypha	ฉบับเคลือบแคลง	๖ มี.ค. ๒๕๔๕
apologia; apology	บทแถลง	๖ มี.ค. ๒๕๔๕
apologue; fable	นิทานอุทาหรณ์	๖ มี.ค. ๒๕๔๕
apology; apologia	บทแถลง	๖ มี.ค. ๒๕๔๕
apostrophe	สมมุติภาวะ	๖ มี.ค. ๒๕๔๕
appendix	ภาคผนวก	๖ มี.ค. ๒๕๔๕
aptronym	นามลักษณ์	๖ มี.ค. ๒๕๔๕
Arcadia	แดนอาร์เคเดีย	๖ มี.ค. ๒๕๔๕
archetype	ต้นแบบดั้งเดิม	๖ มี.ค. ๒๕๔๕
archaism	คำโบราณ	๖ มี.ค. ๒๕๔๕
archives	๑. จดหมายเหตุ๒. หอจดหมายเหตุ	๖ มี.ค. ๒๕๔๕
argot	ภาษาเฉพาะกลุ่ม	๖ มี.ค. ๒๕๔๕
argument	๑. สังเขปเรื่อง๒. บทอภิปราย	๖ มี.ค. ๒๕๔๕
argumentation	การโต้แย้ง	๖ มี.ค. ๒๕๔๕
argumentum ad	บทอภิปรายแบบอ้าง	๖ มี.ค. ๒๕๔๕
art for art’s sake	ศิลปะเพื่อศิลปะ	๖ มี.ค. ๒๕๔๕
article	บทความ	๖ มี.ค. ๒๕๔๕
aside	การพูดป้อง	๖ มี.ค. ๒๕๔๕
assonance	การกระทบสระ	๖ มี.ค. ๒๕๔๕
association	นัยประหวัด	๖ มี.ค. ๒๕๔๕
asyntactic	นอกกฎ	๖ มี.ค. ๒๕๔๕
atony	การไม่เน้นพยางค์	๖ มี.ค. ๒๕๔๕
atmosphere	บรรยากาศ	๖ มี.ค. ๒๕๔๕
atmosphere of the mind	บรรยากาศแห่งจิต	๖ มี.ค. ๒๕๔๕
Atticism	วาทศิลป์กระชับ	๖ มี.ค. ๒๕๔๕
ยูโทเปีย	Utopia	๖ มี.ค. ๒๕๔๕
Augustan Age	สมัยออกัสตัน	๖ มี.ค. ๒๕๔๕
aureate language	ภาษาไพจิตร	๖ มี.ค. ๒๕๔๕
autoclesis	โวหารย้อนกระทบ	๖ มี.ค. ๒๕๔๕
autobiography	อัตชีวประวัติ	๖ มี.ค. ๒๕๔๕
automatic writing	การเขียนโดยอัตโนมัติ	๖ มี.ค. ๒๕๔๕
รูปแบบ	form	๖ มี.ค. ๒๕๔๕
รูปแบบอินทรียะ	organic form	๖ มี.ค. ๒๕๔๕
รูปแบบกลไก	mechanic form	๖ มี.ค. ๒๕๔๕
รูปแบบนิยม	formalism	๖ มี.ค. ๒๕๔๕
avant-garde	กลุ่มล้ำยุค	๖ มี.ค. ๒๕๔๕
โลกทัศน์	Weltanchauung; world view	๖ มี.ค. ๒๕๔๕
ยึดปัจจุบัน, ทินธร	carpe diem	๖ มี.ค. ๒๕๔๕
เกร็ด	anecdote	๖ มี.ค. ๒๕๔๕
แก่นเรื่อง	theme	๖ มี.ค. ๒๕๔๕
แก่นเรื่องแบบเฟาสต์	Faust theme	๖ มี.ค. ๒๕๔๕
เกณฑ์กำหนดค่า	touchstone	๖ มี.ค. ๒๕๔๕
โครงเรื่อง	plot	๖ มี.ค. ๒๕๔๕
โครงเรื่องรอง	sub-plot	๖ มี.ค. ๒๕๔๕
โครงสร้าง	structure	๖ มี.ค. ๒๕๔๕
โคลง, บทกวี	poem	๖ มี.ค. ๒๕๔๕
โจรกรรมทางวรรณกรรม	plagiarism	๖ มี.ค. ๒๕๔๕
แดนอาร์เคเดีย	Arcadia	๖ มี.ค. ๒๕๔๕
เทวกำเนิด	theogony	๖ มี.ค. ๒๕๔๕
เทวดามาโปรด	deus ex machina	๖ มี.ค. ๒๕๔๕
เทวทัณฑ์	nemesis	๖ มี.ค. ๒๕๔๕
เทอร์ซารีมา, บทสามบาทสัมผัส	terza rima	๖ มี.ค. ๒๕๔๕
เทพนิยาย	fairy tale	๖ มี.ค. ๒๕๔๕
แนวเรื่อง	motif	๖ มี.ค. ๒๕๔๕
แนวเรื่องนำ	leitmotif	๖ มี.ค. ๒๕๔๕
แนวเทียบ	analogy	๖ มี.ค. ๒๕๔๕
เนื้องาน	texture	๖ มี.ค. ๒๕๔๕
มนุษยนิยม	humanism	๖ มี.ค. ๒๕๔๕
มนุษยนิยมแนวใหม่	new humanism	๖ มี.ค. ๒๕๔๕
แบบรูป	pattern	๖ มี.ค. ๒๕๔๕
แบบแผนประเพณี	tradition	๖ มี.ค. ๒๕๔๕
แปดหน้ายก	quarto	๖ มี.ค. ๒๕๔๕
แผนสัมผัส	rhyme scheme	๖ มี.ค. ๒๕๔๕
เพลง	air; song	๖ มี.ค. ๒๕๔๕
เพลงแมดริกัล	madrigal	๖ มี.ค. ๒๕๔๕
เพลงเรือ	barcarole	๖ มี.ค. ๒๕๔๕
เพลงร้อง, เพลง; บทร้อยกรอง	song	๖ มี.ค. ๒๕๔๕
เพลงร้องเดี่ยวไว้อาลัย	monody	๖ มี.ค. ๒๕๔๕
เพลงโศก	dirge	๖ มี.ค. ๒๕๔๕
เพลงรันทด, เพลงบลูส์	blues	๖ มี.ค. ๒๕๔๕
เพลงยาว, บทจดหมาย	epistle	๖ มี.ค. ๒๕๔๕
เพลงเกี้ยวยามค่ำ	serenade	๖ มี.ค. ๒๕๔๕
เพลงเทศกาล	carol; carole	๖ มี.ค. ๒๕๔๕
เพลงเทพสดุดี	dithyramb	๖ มี.ค. ๒๕๔๕
เพลงวีรกรรมสตารินา	starina	๖ มี.ค. ๒๕๔๕
เพลงวีรกรรมบิลีนา	bylina	๖ มี.ค. ๒๕๔๕
เพลงสวดสรรเสริญ	hymn	๖ มี.ค. ๒๕๔๕
เพลงสวดสดุดี	psalm	๖ มี.ค. ๒๕๔๕
เพลงสั้น	ditty	๖ มี.ค. ๒๕๔๕
เพลงกล่อมหอ	epithalamion	๖ มี.ค. ๒๕๔๕
เพลงขับ	chanson	๖ มี.ค. ๒๕๔๕
เพลงขับวีรกรรม	chanson de gestes	๖ มี.ค. ๒๕๔๕
เพลงชาวบ้าน	folk song	๖ มี.ค. ๒๕๔๕
เพลงบลูส์, เพลงรันทด	blues	๖ มี.ค. ๒๕๔๕
เพลงพรรณนาสตาซิมอน	stasimon	๖ มี.ค. ๒๕๔๕
เพลงพื้นเมืองคาลิปโซ	calypso	๖ มี.ค. ๒๕๔๕
เพื่อนคู่ใจ	confidant	๖ มี.ค. ๒๕๔๕
มุมมอง	point of view; viewpoint	๖ มี.ค. ๒๕๔๕
ยุคเรืองปัญญา	Enlightenment, the; Enlightenment age	๖ มี.ค. ๒๕๔๕
ยุคเหตุผล	Age of reason	๖ มี.ค. ๒๕๔๕
ยุคเสื่อม	décadence	๖ มี.ค. ๒๕๔๕
ยุติธรรมแบบกวี	poetic justice	๖ มี.ค. ๒๕๔๕
ballad	ลำนำนิทาน	๖ มี.ค. ๒๕๔๕
ballad opera	อุปรากรลำนำนิทาน	๖ มี.ค. ๒๕๔๕
ballade	๑. ลำนำนิทาน๒. บทร้อยกรองบาลาด	๖ มี.ค. ๒๕๔๕
barcarole	เพลงเรือ	๖ มี.ค. ๒๕๔๕
bard	๑. กวีขับลำ๒. กวี	๖ มี.ค. ๒๕๔๕
baroque	วรรณกรรมบารอก	๖ มี.ค. ๒๕๔๕
bathos	การลดระดับ	๖ มี.ค. ๒๕๔๕
beast epic	มหากาพย์เรื่องสัตว์	๖ มี.ค. ๒๕๔๕
beat poets	กวีกลุ่มหน่ายสังคม, กวีกลุ่มบีต	๖ มี.ค. ๒๕๔๕
beginning rhyme	สัมผัสต้นบาท	๖ มี.ค. ๒๕๔๕
bienséances, les	ความสมสภาพ	๖ มี.ค. ๒๕๔๕
Black Mountain poets	กวีกลุ่มแบล็กเมาน์เทน	๖ มี.ค. ๒๕๔๕
black comedy	สุขนาฏกรรมมืด	๖ มี.ค. ๒๕๔๕
blank verse	กลอนเปล่า	๖ มี.ค. ๒๕๔๕
blason; blazon	บทชมโฉม	๖ มี.ค. ๒๕๔๕
blazon; blason	บทชมโฉม	๖ มี.ค. ๒๕๔๕
Bloomsbury group, the	กลุ่มบลูมส์เบอรี	๖ มี.ค. ๒๕๔๕
blue book	หนังสือปกน้ำเงิน	๖ มี.ค. ๒๕๔๕
blue-stocking	กลุ่มถุงน่องน้ำเงิน	๖ มี.ค. ๒๕๔๕
blues	เพลงบลูส์, เพลงรันทด	๖ มี.ค. ๒๕๔๕
boasting poem	บทกวีโอ้อวด	๖ มี.ค. ๒๕๔๕
bombast	สำนวนฟุ้งเฟื่อง	๖ มี.ค. ๒๕๔๕
bon mot, le	คำคม	๖ มี.ค. ๒๕๔๕
boulevard drama	ละครบูลวาร์ด	๖ มี.ค. ๒๕๔๕
bourgeois drama	ละครชนชั้นกลาง	๖ มี.ค. ๒๕๔๕
bourgeois literature	วรรณกรรมชนชั้นกลาง	๖ มี.ค. ๒๕๔๕
bourgeois tragedy	โศกนาฏกรรมชนชั้นกลาง	๖ มี.ค. ๒๕๔๕
bowdlerize	ตัดทอน	๖ มี.ค. ๒๕๔๕
braggadocio	จอมโว	๖ มี.ค. ๒๕๔๕
bucolic; pastoral	บทร้อยกรองท้องทุ่ง	๖ มี.ค. ๒๕๔๕
burlesque	เรื่องขบขันล้อเลียน	๖ มี.ค. ๒๕๔๕
Byzantine	ไบแซนไทน์	๖ มี.ค. ๒๕๔๕
วรรณวิภาค	anatomy	๖ มี.ค. ๒๕๔๕
วรรณกรรม; วรรณคดี; เอกสารข้อมูล	literature	๖ มี.ค. ๒๕๔๕
วรรณกรรมโรโกโก	rococo	๖ มี.ค. ๒๕๔๕
วรรณกรรมมักนิทิซดัต	magnitizdat	๖ มี.ค. ๒๕๔๕
วรรณกรรมเจตจำนง; พันธสัญญา	testament	๖ มี.ค. ๒๕๔๕
bylina	เพลงวีรกรรมบิลีนา	๖ มี.ค. ๒๕๔๕
วรรณกรรมมุขปาฐะ	oral literature	๖ มี.ค. ๒๕๔๕
วรรณกรรมมุขปาฐะ; ประเพณีมุขปาฐะ	oral tradition	๖ มี.ค. ๒๕๔๕
วรรณกรรมสารภาพ	confessional literature	๖ มี.ค. ๒๕๔๕
วรรณกรรมหลีกหนี	escape literature	๖ มี.ค. ๒๕๔๕
วรรณกรรมล้อ	parody	๖ มี.ค. ๒๕๔๕
วรรณกรรมล้อความเขลา	folly literature	๖ มี.ค. ๒๕๔๕
วรรณกรรมกามวิสัย	erotic literature	๖ มี.ค. ๒๕๔๕
วรรณกรรมคำสอน	didactic literature	๖ มี.ค. ๒๕๔๕
วรรณกรรมคล้ายคลึง	analogue	๖ มี.ค. ๒๕๔๕
วรรณกรรมจดหมาย	letters	๖ มี.ค. ๒๕๔๕
วรรณกรรมชาวบ้าน	folk literature	๖ มี.ค. ๒๕๔๕
วรรณกรรมชนชั้นกลาง	bourgeois literature	๖ มี.ค. ๒๕๔๕
วรรณกรรมซามิซดัต	samizdat	๖ มี.ค. ๒๕๔๕
วรรณกรรมทามิซดัต	tamizdat	๖ มี.ค. ๒๕๔๕
วรรณกรรมบารอก	baroque	๖ มี.ค. ๒๕๔๕
วรรณกรรมพยากรณ์	apocalyptic literature	๖ มี.ค. ๒๕๔๕
วรรณคดี; วรรณกรรม; เอกสารข้อมูล	literature	๖ มี.ค. ๒๕๔๕
วรรณคดีเปรียบเทียบ	comparative literature	๖ มี.ค. ๒๕๔๕
วรรณคดีวิจารณ์	literary criticism	๖ มี.ค. ๒๕๔๕
cacophony	เสียงกระด้าง	๖ มี.ค. ๒๕๔๕
caesura	จังหวะหยุด	๖ มี.ค. ๒๕๔๕
calypso	เพลงพื้นเมืองคาลิปโซ	๖ มี.ค. ๒๕๔๕
canon	ฉบับแท้	๖ มี.ค. ๒๕๔๕
canto	บรรพ, กัณฑ์	๖ มี.ค. ๒๕๔๕
caricature	ภาพล้อ	๖ มี.ค. ๒๕๔๕
carol; carole	เพลงเทศกาล	๖ มี.ค. ๒๕๔๕
carole; carol	เพลงเทศกาล	๖ มี.ค. ๒๕๔๕
Caroline period	สมัยแคโรไลน์	๖ มี.ค. ๒๕๔๕
carpe diem	ยึดปัจจุบัน, ทินธร	๖ มี.ค. ๒๕๔๕
carrousel	วาทะเวียนวง	๖ มี.ค. ๒๕๔๕
cartoon	การ์ตูน	๖ มี.ค. ๒๕๔๕
catalogue verse	นามาวลี	๖ มี.ค. ๒๕๔๕
catalexis	การตัดท้ายบาท	๖ มี.ค. ๒๕๔๕
catastrophe	ความหายนะ	๖ มี.ค. ๒๕๔๕
catharsis	โสธนะ	๖ มี.ค. ๒๕๔๕
Cavalier drama	ละครคาวาเลียร์	๖ มี.ค. ๒๕๔๕
Cavalier poets	กวีกลุ่มคาวาเลียร์	๖ มี.ค. ๒๕๔๕
cénacle, le	กลุ่มเลอเซนากล์	๖ มี.ค. ๒๕๔๕
cento	บทตัดต่อ	๖ มี.ค. ๒๕๔๕
chanson	เพลงขับ	๖ มี.ค. ๒๕๔๕
chanson de gestes	เพลงขับวีรกรรม	๖ มี.ค. ๒๕๔๕
chansonnier	รวมเพลงขับ	๖ มี.ค. ๒๕๔๕
character, the	บุคลิกวรรณนา	๖ มี.ค. ๒๕๔๕
chiasmus	โวหารย้อนคำ	๖ มี.ค. ๒๕๔๕
children’s book	หนังสือสำหรับเด็ก	๖ มี.ค. ๒๕๔๕
chorus	นักร้องหมู่	๖ มี.ค. ๒๕๔๕
chronicle	บันทึกเหตุการณ์	๖ มี.ค. ๒๕๔๕
chronicle play; history play	ละครอิงประวัติศาสตร์	๖ มี.ค. ๒๕๔๕
chronological primitivism	บรรพกาลนิยมเชิงประวัติศาสตร์	๖ มี.ค. ๒๕๔๕
Ciceronian style	ลีลาแบบซิเซโร	๖ มี.ค. ๒๕๔๕
circumlocution	สำนวนน้ำท่วมทุ่ง	๖ มี.ค. ๒๕๔๕
classic	๑. (น.) คลาสสิก๒. (ว.) ตามแบบแผน, คลาสสิก	๖ มี.ค. ๒๕๔๕
classical	ตามแบบแผน, คลาสสิก	๖ มี.ค. ๒๕๔๕
classicism	คตินิยมแบบแผน, คตินิยมคลาสสิก	๖ มี.ค. ๒๕๔๕
clerihew	บทร้อยกรองเคลริฮิว	๖ มี.ค. ๒๕๔๕
cliché	สำนวนจำเจ	๖ มี.ค. ๒๕๔๕
climax	จุดสุดยอด	๖ มี.ค. ๒๕๔๕
closed couplet	สัมผัสคู่ปิด	๖ มี.ค. ๒๕๔๕
closet drama	บทละครเพื่ออ่าน	๖ มี.ค. ๒๕๔๕
วารสาร; บันทึกประจำวัน	journal	๖ มี.ค. ๒๕๔๕
วีรสตรี; นางเอก	heroine	๖ มี.ค. ๒๕๔๕
วิภาษวิธี	dialectic	๖ มี.ค. ๒๕๔๕
วีรกรรมกำมะลอ	mock-heroic	๖ มี.ค. ๒๕๔๕
วีรบุรุษ; พระเอก	hero	๖ มี.ค. ๒๕๔๕
วิรุธลักษณ์	tragic flaw	๖ มี.ค. ๒๕๔๕
วิวิธทัศนา	revue	๖ มี.ค. ๒๕๔๕
cock and bull story	เรื่องกุ	๖ มี.ค. ๒๕๔๕
collage	การปะติดความ	๖ มี.ค. ๒๕๔๕
colloquy	สัมวาทะ	๖ มี.ค. ๒๕๔๕
colloquial; colloquial language	ภาษาปาก	๖ มี.ค. ๒๕๔๕
colloquial language; colloquial	ภาษาปาก	๖ มี.ค. ๒๕๔๕
comedy	สุขนาฏกรรม	๖ มี.ค. ๒๕๔๕
comedy of humours	สุขนาฏกรรมลักษณะนิสัย	๖ มี.ค. ๒๕๔๕
comedy of ideas	สุขนาฏกรรมข้อคิด	๖ มี.ค. ๒๕๔๕
comedy of intrigues	สุขนาฏกรรมกลอุบาย	๖ มี.ค. ๒๕๔๕
comedy of manners	สุขนาฏกรรมมรรยาทสังคม	๖ มี.ค. ๒๕๔๕
comedy of morals	สุขนาฏกรรมศีลธรรม	๖ มี.ค. ๒๕๔๕
comedy of situation	สุขนาฏกรรมสถานการณ์	๖ มี.ค. ๒๕๔๕
comic relief	บทตลกคลายเครียด	๖ มี.ค. ๒๕๔๕
commedia dell’arte	ละครกลอนสด	๖ มี.ค. ๒๕๔๕
commonplace book	สมุดข้อมูล	๖ มี.ค. ๒๕๔๕
Commonwealth period	สมัยคอมมอนเวลท์ (ค.ศ. ๑๖๔๙-๑๖๐๐)	๖ มี.ค. ๒๕๔๕
common measure; common meter	มาตราสามัญ	๖ มี.ค. ๒๕๔๕
common meter; common measure	มาตราสามัญ	๖ มี.ค. ๒๕๔๕
comparative literature	วรรณคดีเปรียบเทียบ	๖ มี.ค. ๒๕๔๕
complaint	กลอนรำพัน	๖ มี.ค. ๒๕๔๕
complex metaphor; telescoped metaphor	อุปลักษณ์ซับซ้อน	๖ มี.ค. ๒๕๔๕
complication	การผูกปม	๖ มี.ค. ๒๕๔๕
conceit	ความนึกเปรียบเทียบ	๖ มี.ค. ๒๕๔๕
concrete universal	สิ่งสากลรูปธรรม	๖ มี.ค. ๒๕๔๕
concrete verse	บทร้อยกรองรูปธรรม	๖ มี.ค. ๒๕๔๕
confessional literature	วรรณกรรมสารภาพ	๖ มี.ค. ๒๕๔๕
confessional novel	นวนิยายสารภาพ	๖ มี.ค. ๒๕๔๕
confessional poetry	กวีนิพนธ์สารภาพ	๖ มี.ค. ๒๕๔๕
confidant	เพื่อนคู่ใจ	๖ มี.ค. ๒๕๔๕
conflict	ความขัดแย้ง	๖ มี.ค. ๒๕๔๕
connotation	ความหมายโดยนัย	๖ มี.ค. ๒๕๔๕
consonance	การซ้ำเสียงพยัญชนะ	๖ มี.ค. ๒๕๔๕
consistency	๑. ความกลมกลืนกัน๒. ความคงเส้นคงวา	๖ มี.ค. ๒๕๔๕
conte	นิทาน	๖ มี.ค. ๒๕๔๕
conte dévot	นิทานศรัทธา	๖ มี.ค. ๒๕๔๕
contrast	การเปรียบต่าง	๖ มี.ค. ๒๕๔๕
convention	สัญนิยม	๖ มี.ค. ๒๕๔๕
conversation piece; conversation poem	บทกวีสนทนา	๖ มี.ค. ๒๕๔๕
conversation poem; conversation piece	บทกวีสนทนา	๖ มี.ค. ๒๕๔๕
correlative verse	บทร้อยกรองสหสัมพัทธ์	๖ มี.ค. ๒๕๔๕
Coup de Théâtre	เหตุการณ์พลิกผัน	๖ มี.ค. ๒๕๔๕
couplet	สัมผัสคู่	๖ มี.ค. ๒๕๔๕
courtesy book	หนังสือสอนมารยาท	๖ มี.ค. ๒๕๔๕
courtly love	รักเทิดทูน	๖ มี.ค. ๒๕๔๕
วิลักษณ์	grotesque	๖ มี.ค. ๒๕๔๕
วิทยานักบุญ	hagiology	๖ มี.ค. ๒๕๔๕
วิทยานิพนธ์; ข้อปัญหา	thesis	๖ มี.ค. ๒๕๔๕
วาทะเวียนวง	carrousel	๖ มี.ค. ๒๕๔๕
วาทะปลุกใจ	harangue	๖ มี.ค. ๒๕๔๕
วาทศาสตร์	rhetoric	๖ มี.ค. ๒๕๔๕
วาทศิลป์กระชับ	Atticism	๖ มี.ค. ๒๕๔๕
วาทนิพนธ์	dissertation	๖ มี.ค. ๒๕๔๕
วิธีปริทัศน์	panoramic method	๖ มี.ค. ๒๕๔๕
crambo	การทายคำสัมผัส	๖ มี.ค. ๒๕๔๕
crisis	จุดวิกฤต	๖ มี.ค. ๒๕๔๕
crossed rhyme; interlaced rhyme	สัมผัสกลางบาท	๖ มี.ค. ๒๕๔๕
cultural primitivism	บรรพกาลนิยมเชิงวัฒนธรรม	๖ มี.ค. ๒๕๔๕
cynicism	คติหยามโลก	๖ มี.ค. ๒๕๔๕
วจนิพนธ์	discourse	๖ มี.ค. ๒๕๔๕
dactyl; dactylic foot	คณะแด็กทิล	๖ มี.ค. ๒๕๔๕
dactylic foot; dactyl	คณะแด็กทิล	๖ มี.ค. ๒๕๔๕
dadaism	คติดาดา	๖ มี.ค. ๒๕๔๕
dead metaphor	อุปลักษณ์ไร้พลัง	๖ มี.ค. ๒๕๔๕
décadence	ยุคเสื่อม	๖ มี.ค. ๒๕๔๕
decorum	ความผสาน	๖ มี.ค. ๒๕๔๕
definition	การนิยาม	๖ มี.ค. ๒๕๔๕
denotation	ความหมายโดยตรง	๖ มี.ค. ๒๕๔๕
dénouement; falling action; resolution	การแก้ปม	๖ มี.ค. ๒๕๔๕
description	การพรรณนา	๖ มี.ค. ๒๕๔๕
desert island fiction	บันเทิงคดีเกาะร้าง	๖ มี.ค. ๒๕๔๕
detective story	เรื่องนักสืบ	๖ มี.ค. ๒๕๔๕
deus ex machina	เทวดามาโปรด	๖ มี.ค. ๒๕๔๕
dialectic	วิภาษวิธี	๖ มี.ค. ๒๕๔๕
dialogue	บทสนทนา	๖ มี.ค. ๒๕๔๕
dialect	ภาษาถิ่น	๖ มี.ค. ๒๕๔๕
diary	อนุทิน	๖ มี.ค. ๒๕๔๕
didactic literature	วรรณกรรมคำสอน	๖ มี.ค. ๒๕๔๕
digest	ฉบับย่อ	๖ มี.ค. ๒๕๔๕
digression	การออกนอกเรื่อง	๖ มี.ค. ๒๕๔๕
dime novel; penny dreadful	นวนิยายสิบสตางค์	๖ มี.ค. ๒๕๔๕
dimeter	มาตราสองคณะ	๖ มี.ค. ๒๕๔๕
diminishing metaphor	อุปลักษณ์ลดสภาพ	๖ มี.ค. ๒๕๔๕
dirge	เพลงโศก	๖ มี.ค. ๒๕๔๕
discourse	วจนิพนธ์	๖ มี.ค. ๒๕๔๕
discovery	การค้นพบ	๖ มี.ค. ๒๕๔๕
disinterestedness	ความเป็นกลาง	๖ มี.ค. ๒๕๔๕
dissertation	วาทนิพนธ์	๖ มี.ค. ๒๕๔๕
dissociation of sensibility	อนารมณ์	๖ มี.ค. ๒๕๔๕
dithyramb	เพลงเทพสดุดี	๖ มี.ค. ๒๕๔๕
ditty	เพลงสั้น	๖ มี.ค. ๒๕๔๕
doggerel	บทร้อยกรองด้อยศิลป์	๖ มี.ค. ๒๕๔๕
dogma	สิทธานต์	๖ มี.ค. ๒๕๔๕
documentary novel	นวนิยายอิงเอกสาร	๖ มี.ค. ๒๕๔๕
documentary theatre	ละครอิงเอกสาร	๖ มี.ค. ๒๕๔๕
domestic comedy	สุขนาฏกรรมครอบครัว	๖ มี.ค. ๒๕๔๕
domestic tragedy	โศกนาฏกรรมครอบครัว	๖ มี.ค. ๒๕๔๕
double rhyme	สัมผัสสองพยางค์	๖ มี.ค. ๒๕๔๕
drama	๑. บทละคร๒. ละคร, นาฏกรรม	๖ มี.ค. ๒๕๔๕
dramatic irony	การแฝงนัยเชิงละคร	๖ มี.ค. ๒๕๔๕
dramatic monologue	บทพูดเดี่ยวเชิงละคร	๖ มี.ค. ๒๕๔๕
dramatis personae	รายชื่อตัวละคร	๖ มี.ค. ๒๕๔๕
dramatization	การแปลงเป็นบทละคร	๖ มี.ค. ๒๕๔๕
drawing-room comedy	สุขนาฏกรรมห้องนั่งเล่น	๖ มี.ค. ๒๕๔๕
dream vision	ภาพในฝัน	๖ มี.ค. ๒๕๔๕
droll	จำอวด	๖ มี.ค. ๒๕๔๕
สมมุติภาวะ	apostrophe	๖ มี.ค. ๒๕๔๕
สร้อย	refrain	๖ มี.ค. ๒๕๔๕
สมัยเอลิซาเบท	Elizabethan period	๖ มี.ค. ๒๕๔๕
สมัยเอดเวิร์ด	Edwardian period	๖ มี.ค. ๒๕๔๕
สมัยแคโรไลน์	Caroline period	๖ มี.ค. ๒๕๔๕
สมัยวิกตอเรีย	Victorian period	๖ มี.ค. ๒๕๔๕
สมัยออกัสตัน	Augustan Age	๖ มี.ค. ๒๕๔๕
สมัยปฏิรูป	Reformation, the; Reformation period	๖ มี.ค. ๒๕๔๕
สมัยฟื้นฟูศิลปวิทยา	Renaissance, the; Renaissance period	๖ มี.ค. ๒๕๔๕
สมัยคอมมอนเวลท์ (ค.ศ. ๑๖๔๙-๑๖๐๐)	Commonwealth period	๖ มี.ค. ๒๕๔๕
สมัยคืนสู่ราชบัลลังก์	Restoration period	๖ มี.ค. ๒๕๔๕
สมัยจาโคเบียน	Jacobean age	๖ มี.ค. ๒๕๔๕
สมัยทิวเดอร์	Tudor period	๖ มี.ค. ๒๕๔๕
สแลง	slang	๖ มี.ค. ๒๕๔๕
สมญานาม	antonomasia	๖ มี.ค. ๒๕๔๕
สมุดข้อมูล	commonplace book	๖ มี.ค. ๒๕๔๕
eclouge	บทร้อยกรองชนบท	๖ มี.ค. ๒๕๔๕
Edwardian period	สมัยเอดเวิร์ด	๖ มี.ค. ๒๕๔๕
สหสัมพัทธ์ปรวิสัย	objective correlative	๖ มี.ค. ๒๕๔๕
สหลักษณ์	synaesthesia	๖ มี.ค. ๒๕๔๕
สํานักวิชา	academy	๖ มี.ค. ๒๕๔๕
หอจดหมายเหตุ; จดหมายเหตุ	archives	๖ มี.ค. ๒๕๔๕
elegiac stanza	บทกำสรด	๖ มี.ค. ๒๕๔๕
elegy	บทร้อยกรองกำสรด	๖ มี.ค. ๒๕๔๕
Elizabethan period	สมัยเอลิซาเบท	๖ มี.ค. ๒๕๔๕
ellipsis	การละความ	๖ มี.ค. ๒๕๔๕
emotive language	ภาษาเร้าอารมณ์	๖ มี.ค. ๒๕๔๕
emphasis	การเน้น	๖ มี.ค. ๒๕๔๕
สัมมาสำนึก	good sense	๖ มี.ค. ๒๕๔๕
สัมวาทะ	colloquy	๖ มี.ค. ๒๕๔๕
สัมผัส	rhyme	๖ มี.ค. ๒๕๔๕
สัมผัสสองพยางค์	double rhyme	๖ มี.ค. ๒๕๔๕
สัมผัสสามพยางค์	triple rhyme	๖ มี.ค. ๒๕๔๕
สัมผัสสลับ	alternate rhyme	๖ มี.ค. ๒๕๔๕
สัมผัสลวง	eye-rhyme	๖ มี.ค. ๒๕๔๕
สัมผัสไม่เน้น	feminine rhyme	๖ มี.ค. ๒๕๔๕
สัมผัสกลางบาท	crossed rhyme; interlaced rhyme	๖ มี.ค. ๒๕๔๕
สัมผัสคู่	couplet	๖ มี.ค. ๒๕๔๕
สัมผัสราชา, สัมผัสรอยัล	rhyme royal	๖ มี.ค. ๒๕๔๕
สัมผัสเดี่ยว	monorhyme	๖ มี.ค. ๒๕๔๕
สัมผัสเน้น	masculine rhyme	๖ มี.ค. ๒๕๔๕
สัมผัสในบาท	internal rhyme	๖ มี.ค. ๒๕๔๕
สัมผัสวิเคราะห์	analysed rhyme	๖ มี.ค. ๒๕๔๕
สัมผัสคู่มาตราไอแอมบ์ห้าคณะ	iambic pentameter couplet	๖ มี.ค. ๒๕๔๕
สัมผัสคู่เปิด	open couplet	๖ มี.ค. ๒๕๔๕
สัมผัสคู่วีรกรรม, สัมผัสคู่ฮิโรอิก	heroic couplet	๖ มี.ค. ๒๕๔๕
สัมผัสคู่สั้น	short couplet	๖ มี.ค. ๒๕๔๕
สัมผัสคู่ฮิโรอิก, สัมผัสคู่วีรกรรม	heroic couplet	๖ มี.ค. ๒๕๔๕
สัมผัสคู่ปิด	closed couplet	๖ มี.ค. ๒๕๔๕
สัมผัสซ้ำคำ	identical rhyme	๖ มี.ค. ๒๕๔๕
สัมผัสต้นบาท	beginning rhyme	๖ มี.ค. ๒๕๔๕
สัมผัสท้ายบาท	end rhyme; terminal rhyme	๖ มี.ค. ๒๕๔๕
สัมพัทธนิยม	relativism	๖ มี.ค. ๒๕๔๕
สัมพจนัย	synecdoche	๖ มี.ค. ๒๕๔๕
หัวเก่ากับหัวใหม่	ancients and moderns	๖ มี.ค. ๒๕๔๕
encomium	บทสรรเสริญ	๖ มี.ค. ๒๕๔๕
encyclopaedia; encyclopedia	สารานุกรม	๖ มี.ค. ๒๕๔๕
encyclopedia; encyclopaedia	สารานุกรม	๖ มี.ค. ๒๕๔๕
end rhyme; terminal rhyme	สัมผัสท้ายบาท	๖ มี.ค. ๒๕๔๕
end-stopped line	บาทจบความ	๖ มี.ค. ๒๕๔๕
Enlightenment age; Enlightenment, the	ยุคเรืองปัญญา	๖ มี.ค. ๒๕๔๕
Enlightenment, the; Enlightenment age	ยุคเรืองปัญญา	๖ มี.ค. ๒๕๔๕
สังเขปเรื่อง; บทอภิปราย	argument	๖ มี.ค. ๒๕๔๕
ศังสกานท์	ode	๖ มี.ค. ๒๕๔๕
ศังสกานท์แบบฮอเรซ	Horatian ode	๖ มี.ค. ๒๕๔๕
สัญลักษณ์และสัญลักษณ์นิยม	symbol and symbolism	๖ มี.ค. ๒๕๔๕
สัจนิยม	realism	๖ มี.ค. ๒๕๔๕
สัจนิยมแนวสังคมนิยม	socialist realism	๖ มี.ค. ๒๕๔๕
สัญนิยม	convention	๖ มี.ค. ๒๕๔๕
สัทกานท์, บทกวีนามธรรม	abstract poem	๖ มี.ค. ๒๕๔๕
ศัพท์กวี	poetic diction	๖ มี.ค. ๒๕๔๕
ศัพทานุกรม	lexicon	๖ มี.ค. ๒๕๔๕
สามเอกภาพ	three unities	๖ มี.ค. ๒๕๔๕
สาระและสื่อเปรียบ	tenor and vehicle	๖ มี.ค. ๒๕๔๕
สารานุกรม	encyclopaedia; encyclopedia	๖ มี.ค. ๒๕๔๕
สารคดี	non-fiction	๖ มี.ค. ๒๕๔๕
สี่หน้ายก	folio	๖ มี.ค. ๒๕๔๕
สีสันท้องถิ่น	local colour	๖ มี.ค. ๒๕๔๕
สิ่งสากลรูปธรรม	concrete universal	๖ มี.ค. ๒๕๔๕
ศาสตรนิพนธ์	treatise	๖ มี.ค. ๒๕๔๕
สิ้นศตวรรษ	fin de siècle	๖ มี.ค. ๒๕๔๕
ศิลปะเพื่อศิลปะ	art for art’s sake	๖ มี.ค. ๒๕๔๕
ศิลปศาสตร์เจ็ดประการ	Seven Liberal Arts	๖ มี.ค. ๒๕๔๕
สิทธานต์	dogma	๖ มี.ค. ๒๕๔๕
สำนวนจำเจ	cliché	๖ มี.ค. ๒๕๔๕
สำนวนน้ำท่วมทุ่ง	circumlocution	๖ มี.ค. ๒๕๔๕
สำนวนฟุ่มเฟือย	pleonasm	๖ มี.ค. ๒๕๔๕
สำนวนฟุ้งเฟื่อง	bombast	๖ มี.ค. ๒๕๔๕
สำนวน	idiom	๖ มี.ค. ๒๕๔๕
สำนวนอ้อมค้อม	periphrasis	๖ มี.ค. ๒๕๔๕
สำนวนอลังการ	euphuism	๖ มี.ค. ๒๕๔๕
epanalepsis	คำซ้ำคั่น	๖ มี.ค. ๒๕๔๕
epic	มหากาพย์	๖ มี.ค. ๒๕๔๕
epic cycle	ชุดมหากาพย์	๖ มี.ค. ๒๕๔๕
epic question	ปุจฉามหากาพย์	๖ มี.ค. ๒๕๔๕
epic simile	อุปมาแนวมหากาพย์	๖ มี.ค. ๒๕๔๕
epic theatre	ละครแนวมหากาพย์	๖ มี.ค. ๒๕๔๕
epigram	คำคม	๖ มี.ค. ๒๕๔๕
epigraph	๑. คำจารึก๒. บุพวาทะ	๖ มี.ค. ๒๕๔๕
epilogue	ปัจฉิมกถา, ปัจฉิมบท	๖ มี.ค. ๒๕๔๕
epitaph	จารึกหลุมฝังศพ	๖ มี.ค. ๒๕๔๕
epithalamion	เพลงกล่อมหอ	๖ มี.ค. ๒๕๔๕
episode	ตอน	๖ มี.ค. ๒๕๔๕
epistle	เพลงยาว, บทจดหมาย	๖ มี.ค. ๒๕๔๕
epistolary novel	นวนิยายจดหมาย	๖ มี.ค. ๒๕๔๕
epithet	ฉายา	๖ มี.ค. ๒๕๔๕
erotic literature	วรรณกรรมกามวิสัย	๖ มี.ค. ๒๕๔๕
escape literature	วรรณกรรมหลีกหนี	๖ มี.ค. ๒๕๔๕
essay	ความเรียง	๖ มี.ค. ๒๕๔๕
eulogy	บทยกย่อง	๖ มี.ค. ๒๕๔๕
euphemism	การเกลื่อนคำ	๖ มี.ค. ๒๕๔๕
euphony	เสียงรื่นหู	๖ มี.ค. ๒๕๔๕
euphuism	สำนวนอลังการ	๖ มี.ค. ๒๕๔๕
สูตรอูบิซุนต์	Ubi sunt formula	๖ มี.ค. ๒๕๔๕
excursus	บทเสริมเรื่อง	๖ มี.ค. ๒๕๔๕
exegesis	นัยวิเคราะห์	๖ มี.ค. ๒๕๔๕
exemplum	นิทานนิทัศน์	๖ มี.ค. ๒๕๔๕
existentialism	อัตถิภาวนิยม	๖ มี.ค. ๒๕๔๕
exposition	๑. อรรถาธิบาย๒. บทเปิดเรื่อง	๖ มี.ค. ๒๕๔๕
expressionism	คตินิยมสำแดงพลังอารมณ์, เอกซเพรสชันนิซึม	๖ มี.ค. ๒๕๔๕
eye-rhyme	สัมผัสลวง	๖ มี.ค. ๒๕๔๕
หลักฐานในเรื่อง	internal evidence	๖ มี.ค. ๒๕๔๕
สถานการณ์เข้าแบบ	stock situation	๖ มี.ค. ๒๕๔๕
หนังเชิด	shadow play	๖ มี.ค. ๒๕๔๕
หนังสือรายงานประจำปี	year book	๖ มี.ค. ๒๕๔๕
หนังสือสำหรับเด็ก	children’s book	๖ มี.ค. ๒๕๔๕
หนังสือรายปี	annals	๖ มี.ค. ๒๕๔๕
หนังสือสอนมารยาท	courtesy book	๖ มี.ค. ๒๕๔๕
หนังสือข่าวสาร	gazette	๖ มี.ค. ๒๕๔๕
หนังสือคู่มือ	handbook; manual	๖ มี.ค. ๒๕๔๕
หนังสือชวนหัว	jest book	๖ มี.ค. ๒๕๔๕
หนังสือปกน้ำเงิน	blue book	๖ มี.ค. ๒๕๔๕
หนังสือท่องเที่ยว	travel book	๖ มี.ค. ๒๕๔๕
หนังสือนำเที่ยว	guidebook	๖ มี.ค. ๒๕๔๕
สุภาษิต	proverb	๖ มี.ค. ๒๕๔๕
หุ่นกระบอกกรองกีญอล	grand guignol	๖ มี.ค. ๒๕๔๕
สุขนาฏกรรม	comedy	๖ มี.ค. ๒๕๔๕
สุขนาฏกรรมมรรยาทสังคม	comedy of manners	๖ มี.ค. ๒๕๔๕
สุขนาฏกรรมเร้าอารมณ์	sentimental comedy	๖ มี.ค. ๒๕๔๕
สุขนาฏกรรมระคนโศก	tragi-comedy	๖ มี.ค. ๒๕๔๕
สุขนาฏกรรมเสียดสี	satirical comedy	๖ มี.ค. ๒๕๔๕
สุขนาฏกรรมแนวใหม่	new comedy	๖ มี.ค. ๒๕๔๕
สุขนาฏกรรมแนวเก่า	old comedy	๖ มี.ค. ๒๕๔๕
สุขนาฏกรรมเพลง	musical comedy	๖ มี.ค. ๒๕๔๕
สุขนาฏกรรมมืด	black comedy	๖ มี.ค. ๒๕๔๕
สุขนาฏกรรมสมัยคืนสู่ราชบัลลังก์	Restoration comedy	๖ มี.ค. ๒๕๔๕
สุขนาฏกรรมห้องนั่งเล่น	drawing-room comedy	๖ มี.ค. ๒๕๔๕
สุขนาฏกรรมศีลธรรม	comedy of morals	๖ มี.ค. ๒๕๔๕
สุขนาฏกรรมสถานการณ์	comedy of situation	๖ มี.ค. ๒๕๔๕
สุขนาฏกรรมลักษณะนิสัย	comedy of humours	๖ มี.ค. ๒๕๔๕
สุขนาฏกรรมกลอุบาย	comedy of intrigues	๖ มี.ค. ๒๕๔๕
สุขนาฏกรรมข้อคิด	comedy of ideas	๖ มี.ค. ๒๕๔๕
สุขนาฏกรรมครอบครัว	domestic comedy	๖ มี.ค. ๒๕๔๕
สุขนาฏกรรมจินตนิยม	romantic comedy	๖ มี.ค. ๒๕๔๕
สุนทรียนิยม	aestheticism	๖ มี.ค. ๒๕๔๕
สุขนาฏกรรมชั้นสูง	high comedy	๖ มี.ค. ๒๕๔๕
สุขนาฏกรรมชั้นต่ำ	low comedy	๖ มี.ค. ๒๕๔๕
fable; apologue	นิทานอุทาหรณ์	๖ มี.ค. ๒๕๔๕
fabliau	นิทานฟาบลีโย [ฟา-บฺลี-โย]	๖ มี.ค. ๒๕๔๕
fabula	ละครฟาบูลา	๖ มี.ค. ๒๕๔๕
fairy tale	เทพนิยาย	๖ มี.ค. ๒๕๔๕
falling action; dénouement; resolution	การแก้ปม	๖ มี.ค. ๒๕๔๕
falling rhythm	จังหวะลง	๖ มี.ค. ๒๕๔๕
fancy	ความเพ้อฝัน	๖ มี.ค. ๒๕๔๕
fantasy	จินตนิมิต	๖ มี.ค. ๒๕๔๕
farce	ละครตลก	๖ มี.ค. ๒๕๔๕
fate drama	ละครชะตากรรม	๖ มี.ค. ๒๕๔๕
Faust theme	แก่นเรื่องแบบเฟาสต์	๖ มี.ค. ๒๕๔๕
feminine ending	ท้ายบาทไม่เน้น	๖ มี.ค. ๒๕๔๕
feminine rhyme	สัมผัสไม่เน้น	๖ มี.ค. ๒๕๔๕
fiction	บันเทิงคดี	๖ มี.ค. ๒๕๔๕
figurative language	ภาษาภาพพจน์	๖ มี.ค. ๒๕๔๕
figure of speech	ภาพพจน์	๖ มี.ค. ๒๕๔๕
fin de siècle	สิ้นศตวรรษ	๖ มี.ค. ๒๕๔๕
flashback	ภาพย้อนหลัง	๖ มี.ค. ๒๕๔๕
flat character	ตัวละครมิติเดียว	๖ มี.ค. ๒๕๔๕
folio	สี่หน้ายก	๖ มี.ค. ๒๕๔๕
folly literature	วรรณกรรมล้อความเขลา	๖ มี.ค. ๒๕๔๕
folk drama	ละครชาวบ้าน	๖ มี.ค. ๒๕๔๕
folk literature	วรรณกรรมชาวบ้าน	๖ มี.ค. ๒๕๔๕
folk song	เพลงชาวบ้าน	๖ มี.ค. ๒๕๔๕
folk tale; Märchen	นิทานชาวบ้าน	๖ มี.ค. ๒๕๔๕
foot; metrical foot	คณะ	๖ มี.ค. ๒๕๔๕
foreshadowing	การเกริ่นการณ์	๖ มี.ค. ๒๕๔๕
foreword	คำนิยม	๖ มี.ค. ๒๕๔๕
form	รูปแบบ	๖ มี.ค. ๒๕๔๕
formalism	รูปแบบนิยม	๖ มี.ค. ๒๕๔๕
four levels of meaning	ความหมายสี่ระดับ	๖ มี.ค. ๒๕๔๕
four meanings	ความหมายสี่อย่าง	๖ มี.ค. ๒๕๔๕
frame story	กรอบเรื่อง	๖ มี.ค. ๒๕๔๕
free association	นัยประหวัดอิสระ	๖ มี.ค. ๒๕๔๕
free verse	บทร้อยกรองอิสระ	๖ มี.ค. ๒๕๔๕
Freytag’s pyramid	พีระมิดของไฟรทาก	๖ มี.ค. ๒๕๔๕
Fugitives, the	กลุ่มผู้หลีกลี้	๖ มี.ค. ๒๕๔๕
futurism	อนาคตนิยม	๖ มี.ค. ๒๕๔๕
gatha	คาถา	๖ มี.ค. ๒๕๔๕
gazette	หนังสือข่าวสาร	๖ มี.ค. ๒๕๔๕
gazetteer	อักขรานุกรมภูมิศาสตร์	๖ มี.ค. ๒๕๔๕
genre	ประเภท(วรรณกรรม)	๖ มี.ค. ๒๕๔๕
Georgian poetry	กวีนิพนธ์จอร์เจียน	๖ มี.ค. ๒๕๔๕
georgic	บทร้อยกรองนาไร่	๖ มี.ค. ๒๕๔๕
gesta	ประชุมเรื่องผจญภัย	๖ มี.ค. ๒๕๔๕
Gestalt psychology	จิตวิทยาเกสตัลต์	๖ มี.ค. ๒๕๔๕
ghazal; ghazel	บทร้อยกรองคาซัล	๖ มี.ค. ๒๕๔๕
ghazel; ghazal	บทร้อยกรองคาซัล	๖ มี.ค. ๒๕๔๕
ghost writer	นักเขียนกำบัง, นักเขียนผี	๖ มี.ค. ๒๕๔๕
gleeman	นักขับลำกลีแมน	๖ มี.ค. ๒๕๔๕
glossary	อภิธาน	๖ มี.ค. ๒๕๔๕
gnomic verse	บทร้อยกรองภาษิต	๖ มี.ค. ๒๕๔๕
Goliards	กลุ่มโกเลีร์ยด	๖ มี.ค. ๒๕๔๕
good sense	สัมมาสำนึก	๖ มี.ค. ๒๕๔๕
Gothic novel	นวนิยายกอทิก	๖ มี.ค. ๒๕๔๕
grace	ความสง่างาม	๖ มี.ค. ๒๕๔๕
grand guignol	หุ่นกระบอกกรองกีญอล	๖ มี.ค. ๒๕๔๕
grand style	ลีลาภาคภูมิ	๖ มี.ค. ๒๕๔๕
graveyard poetry	กวีนิพนธ์สุสาน	๖ มี.ค. ๒๕๔๕
Greek tragedy	โศกนาฏกรรมกรีก	๖ มี.ค. ๒๕๔๕
grotesque	วิลักษณ์	๖ มี.ค. ๒๕๔๕
guidebook	หนังสือนำเที่ยว	๖ มี.ค. ๒๕๔๕
guslar	นักขับลำกูสลาร์	๖ มี.ค. ๒๕๔๕
hagiography	ชีวประวัตินักบุญ	๖ มี.ค. ๒๕๔๕
hagiology	วิทยานักบุญ	๖ มี.ค. ๒๕๔๕
haiku	บทกวีไฮกุ	๖ มี.ค. ๒๕๔๕
hamartia	การสำคัญผิด	๖ มี.ค. ๒๕๔๕
handbook; manual	หนังสือคู่มือ	๖ มี.ค. ๒๕๔๕
harangue	วาทะปลุกใจ	๖ มี.ค. ๒๕๔๕
Harlequin	ตัวละครแบบฮาร์เลควิน	๖ มี.ค. ๒๕๔๕
headless line; acephalous	บาทไร้หัว	๖ มี.ค. ๒๕๔๕
hendecasyllabic line	บาทสิบเอ็ดพยางค์	๖ มี.ค. ๒๕๔๕
heptameter	มาตราเจ็ดคณะ	๖ มี.ค. ๒๕๔๕
hero	๑. วีรบุรุษ๒. พระเอก	๖ มี.ค. ๒๕๔๕
heroic couplet	สัมผัสคู่วีรกรรม, สัมผัสคู่ฮิโรอิก	๖ มี.ค. ๒๕๔๕
heroic drama	นาฏกรรมวีรบุรุษ	๖ มี.ค. ๒๕๔๕
heroic line	บาทวีรกรรม, บาทฮิโรอิก	๖ มี.ค. ๒๕๔๕
heroic quatrain	บทสี่บาทวีรกรรม, บทสี่บาทฮิโรอิก	๖ มี.ค. ๒๕๔๕
heroic stanza	บทวีรกรรม, บทฮิโรอิก	๖ มี.ค. ๒๕๔๕
heroic verse	บทร้อยกรองวีรกรรม, บทร้อยกรองฮิโรอิก	๖ มี.ค. ๒๕๔๕
heroine	๑. วีรสตรี๒. นางเอก	๖ มี.ค. ๒๕๔๕
hexameter	มาตราหกคณะ	๖ มี.ค. ๒๕๔๕
high comedy	สุขนาฏกรรมชั้นสูง	๖ มี.ค. ๒๕๔๕
historical novel	นวนิยายอิงประวัติศาสตร์	๖ มี.ค. ๒๕๔๕
history play; chronicle play	ละครอิงประวัติศาสตร์	๖ มี.ค. ๒๕๔๕
Homeric epithet	ฉายาแบบโฮเมอร์	๖ มี.ค. ๒๕๔๕
Homeric simile	อุปมาแบบโฮเมอร์	๖ มี.ค. ๒๕๔๕
homograph	คำพ้องรูป	๖ มี.ค. ๒๕๔๕
homonym	คำพ้องรูปพ้องเสียง	๖ มี.ค. ๒๕๔๕
homophone	คำพ้องเสียง	๖ มี.ค. ๒๕๔๕
Horatian ode	ศังสกานท์แบบฮอเรซ	๖ มี.ค. ๒๕๔๕
hubris; hybris	อหังการ	๖ มี.ค. ๒๕๔๕
humanism	มนุษยนิยม	๖ มี.ค. ๒๕๔๕
humours	ธาตุเหลว	๖ มี.ค. ๒๕๔๕
hybrid	พันทาง	๖ มี.ค. ๒๕๔๕
hybris; hubris	อหังการ	๖ มี.ค. ๒๕๔๕
hymn	เพลงสวดสรรเสริญ	๖ มี.ค. ๒๕๔๕
hyperbole	อติพจน์	๖ มี.ค. ๒๕๔๕
hyphaeresis; syncope	การตัดกลางคำ	๖ มี.ค. ๒๕๔๕
อรรถาภิธาน	thesaurus	๖ มี.ค. ๒๕๔๕
อรรถาธิบาย; บทเปิดเรื่อง	exposition	๖ มี.ค. ๒๕๔๕
iamb; iambic foot	คณะไอแอมบ์	๖ มี.ค. ๒๕๔๕
iambic dimeter	มาตราไอแอมบ์สองคณะ	๖ มี.ค. ๒๕๔๕
iambic foot; iamb	คณะไอแอมบ์	๖ มี.ค. ๒๕๔๕
iambic hexameter	มาตราไอแอมบ์หกคณะ	๖ มี.ค. ๒๕๔๕
iambic monometer	มาตราไอแอมบ์คณะเดียว	๖ มี.ค. ๒๕๔๕
iambic octameter	มาตราไอแอมบ์แปดคณะ	๖ มี.ค. ๒๕๔๕
iambic pentameter	มาตราไอแอมบ์ห้าคณะ	๖ มี.ค. ๒๕๔๕
iambic pentameter couplet	สัมผัสคู่มาตราไอแอมบ์ห้าคณะ	๖ มี.ค. ๒๕๔๕
iambic tetrameter	มาตราไอแอมบ์สี่คณะ	๖ มี.ค. ๒๕๔๕
iambic trimeter	มาตราไอแอมบ์สามคณะ	๖ มี.ค. ๒๕๔๕
อภิธาน	glossary	๖ มี.ค. ๒๕๔๕
อเนกนัย	systrophe	๖ มี.ค. ๒๕๔๕
อวพจน์	meiosis	๖ มี.ค. ๒๕๔๕
identical rhyme	สัมผัสซ้ำคำ	๖ มี.ค. ๒๕๔๕
idealism	อุดมคตินิยม	๖ มี.ค. ๒๕๔๕
idiom	สำนวน	๖ มี.ค. ๒๕๔๕
idyl; idyll	ชนบทพรรณนา	๖ มี.ค. ๒๕๔๕
idyll; idyl	ชนบทพรรณนา	๖ มี.ค. ๒๕๔๕
อะนาครูซิส	anacrusis	๖ มี.ค. ๒๕๔๕
อสมบาท	anisometric	๖ มี.ค. ๒๕๔๕
อหังการ	hubris; hybris	๖ มี.ค. ๒๕๔๕
อสถานะ	anachorism	๖ มี.ค. ๒๕๔๕
image	๑. ภาพลักษณ์๒. จินตภาพ	๖ มี.ค. ๒๕๔๕
imagery	กระบวนจินตภาพ	๖ มี.ค. ๒๕๔๕
imagination	จินตนาการ	๖ มี.ค. ๒๕๔๕
Imagist	กวีกลุ่มจินตภาพ	๖ มี.ค. ๒๕๔๕
imitation	การเลียนแบบ	๖ มี.ค. ๒๕๔๕
impressionism	คตินิยมประทับใจ, อิมเพรสชันนิซึม	๖ มี.ค. ๒๕๔๕
in medias res	การเริ่มกลางเรื่อง	๖ มี.ค. ๒๕๔๕
inciting moment	จุดเร่งเร้า	๖ มี.ค. ๒๕๔๕
induction	เรื่องเหนี่ยวนำ	๖ มี.ค. ๒๕๔๕
industrial revolution	การปฏิวัติอุตสาหกรรม	๖ มี.ค. ๒๕๔๕
อัสสมาจารย์นิยม	scholasticism	๖ มี.ค. ๒๕๔๕
inspiration	ความบันดาลใจ	๖ มี.ค. ๒๕๔๕
intentional fallacy	ความผิดพลาดเหตุเจตนา	๖ มี.ค. ๒๕๔๕
interlude	ละครสลับฉาก, การแสดงสลับฉาก	๖ มี.ค. ๒๕๔๕
interior monologue	บทพูดเดี่ยวในใจ	๖ มี.ค. ๒๕๔๕
interlaced rhyme; crossed rhyme	สัมผัสกลางบาท	๖ มี.ค. ๒๕๔๕
intermezzi	ละครสลับฉากของอิตาลี	๖ มี.ค. ๒๕๔๕
internal evidence	หลักฐานในเรื่อง	๖ มี.ค. ๒๕๔๕
internal rhyme	สัมผัสในบาท	๖ มี.ค. ๒๕๔๕
introduction	บทนำ	๖ มี.ค. ๒๕๔๕
inversion	การสลับคำ	๖ มี.ค. ๒๕๔๕
invective	คำบริภาษ	๖ มี.ค. ๒๕๔๕
invocation	ประณามบท	๖ มี.ค. ๒๕๔๕
อักษรกล	acrostic	๖ มี.ค. ๒๕๔๕
อักขรานุกรมภูมิศาสตร์	gazetteer	๖ มี.ค. ๒๕๔๕
อัตชีวประวัติ	autobiography	๖ มี.ค. ๒๕๔๕
อัตวิสัย	subjectivity	๖ มี.ค. ๒๕๔๕
อัตถิภาวนิยม	existentialism	๖ มี.ค. ๒๕๔๕
อารมณ์ละเอียดอ่อน	sensibility	๖ มี.ค. ๒๕๔๕
อารัมภบท	prologue	๖ มี.ค. ๒๕๔๕
อาขยาน	akhyana	๖ มี.ค. ๒๕๔๕
irony	การแฝงนัย	๖ มี.ค. ๒๕๔๕
irony of fate	การแฝงนัยเชิงโชคล้อ	๖ มี.ค. ๒๕๔๕
องก์	act	๖ มี.ค. ๒๕๔๕
องก์ตามหาพระเยซู	quem quaeritis trope	๖ มี.ค. ๒๕๔๕
อติพจน์	hyperbole	๖ มี.ค. ๒๕๔๕
อนารมณ์	dissociation of sensibility	๖ มี.ค. ๒๕๔๕
อนาคตนิยม	futurism	๖ มี.ค. ๒๕๔๕
อนุเฉท, ย่อหน้า	paragraph	๖ มี.ค. ๒๕๔๕
อนุทิน	diary	๖ มี.ค. ๒๕๔๕
อุดมคตินิยม	idealism	๖ มี.ค. ๒๕๔๕
อุปรากร	opera	๖ มี.ค. ๒๕๔๕
อุปรากรลำนำนิทาน	ballad opera	๖ มี.ค. ๒๕๔๕
อุปมานิทัศน์	allegory	๖ มี.ค. ๒๕๔๕
อุปมา	simile	๖ มี.ค. ๒๕๔๕
อุปมาแนวมหากาพย์	epic simile	๖ มี.ค. ๒๕๔๕
อุปมาแบบโฮเมอร์	Homeric simile	๖ มี.ค. ๒๕๔๕
อุปลักษณ์	metaphor	๖ มี.ค. ๒๕๔๕
อุปลักษณ์ลดสภาพ	diminishing metaphor	๖ มี.ค. ๒๕๔๕
อุปลักษณ์ไร้พลัง	dead metaphor	๖ มี.ค. ๒๕๔๕
อุปลักษณ์ซับซ้อน	complex metaphor; telescoped metaphor	๖ มี.ค. ๒๕๔๕
อุปลักษณ์ประสม	mixed metaphor	๖ มี.ค. ๒๕๔๕
อุปนิเสธ	litotes	๖ มี.ค. ๒๕๔๕
Jacobean age	สมัยจาโคเบียน	๖ มี.ค. ๒๕๔๕
jargon	ภาษาเฉพาะวงการ	๖ มี.ค. ๒๕๔๕
jest book	หนังสือชวนหัว	๖ มี.ค. ๒๕๔๕
Jesuit drama	ละครเยซูอิต	๖ มี.ค. ๒๕๔๕
jingle	บทร้อยกรองจิงเกิล	๖ มี.ค. ๒๕๔๕
jongleur	นักแสดงสัญจร	๖ มี.ค. ๒๕๔๕
joruri	ละครหุ่นโจรุริ	๖ มี.ค. ๒๕๔๕
journal	๑. วารสาร๒. บันทึกประจำวัน	๖ มี.ค. ๒๕๔๕
journalism	การหนังสือพิมพ์	๖ มี.ค. ๒๕๔๕
junacke pesme	ลำนำจูนักเกียเพสเมีย	๖ มี.ค. ๒๕๔๕
kabuki	ละครคะบุกิ	๖ มี.ค. ๒๕๔๕
key novel; livre à clef	นวนิยายแฝงชีวิตจริง	๖ มี.ค. ๒๕๔๕
kitchen-sink drama	ละครก้นครัว	๖ มี.ค. ๒๕๔๕
Künstlerroman	นวนิยายชีวิตศิลปิน	๖ มี.ค. ๒๕๔๕
lai; lay	บทขับลำ	๖ มี.ค. ๒๕๔๕
lament	บทร้อยกรองพิลาป	๖ มี.ค. ๒๕๔๕
lampoon	ถ้อยถากถาง	๖ มี.ค. ๒๕๔๕
lay; lai	บทขับลำ	๖ มี.ค. ๒๕๔๕
legend	ตำนาน	๖ มี.ค. ๒๕๔๕
legitimate theatre	ละครถูกกฎหมาย	๖ มี.ค. ๒๕๔๕
leitmotif	แนวเรื่องนำ	๖ มี.ค. ๒๕๔๕
letters	วรรณกรรมจดหมาย	๖ มี.ค. ๒๕๔๕
lexicon	ศัพทานุกรม	๖ มี.ค. ๒๕๔๕
light verse	บทร้อยกรองเบาสมอง	๖ มี.ค. ๒๕๔๕
limerick	บทร้อยกรองลิเมอริก	๖ มี.ค. ๒๕๔๕
line	บาท	๖ มี.ค. ๒๕๔๕
literature	๑. วรรณกรรม๒. วรรณคดี๓. เอกสารข้อมูล	๖ มี.ค. ๒๕๔๕
literary criticism	วรรณคดีวิจารณ์	๖ มี.ค. ๒๕๔๕
litotes	อุปนิเสธ	๖ มี.ค. ๒๕๔๕
livre à clef; key novel	นวนิยายแฝงชีวิตจริง	๖ มี.ค. ๒๕๔๕
livre à clef; key novel	นวนิยายแฝงชีวิตจริง	๖ มี.ค. ๒๕๔๕
local colour	สีสันท้องถิ่น	๖ มี.ค. ๒๕๔๕
long measure; long meter	มาตรายาว	๖ มี.ค. ๒๕๔๕
long meter; long measure	มาตรายาว	๖ มี.ค. ๒๕๔๕
low comedy	สุขนาฏกรรมชั้นต่ำ	๖ มี.ค. ๒๕๔๕
lyric	คีตกานท์	๖ มี.ค. ๒๕๔๕
Machiavel	ตัวละครทุศีล, ตัวละครแบบมาเคียเวลลี	๖ มี.ค. ๒๕๔๕
machinery	กลการ	๖ มี.ค. ๒๕๔๕
madrigal	เพลงแมดริกัล	๖ มี.ค. ๒๕๔๕
magazine	นิตยสาร	๖ มี.ค. ๒๕๔๕
magnitizdat	วรรณกรรมมักนิทิซดัต	๖ มี.ค. ๒๕๔๕
magody	ละครใบ้ล้อ	๖ มี.ค. ๒๕๔๕
mal mariée, la	บทเพลงสมรสผิด	๖ มี.ค. ๒๕๔๕
malapropism	คำอวดภูมิ	๖ มี.ค. ๒๕๔๕
mannerism	จริตนิยม	๖ มี.ค. ๒๕๔๕
manifesto	คำประกาศเจตนา	๖ มี.ค. ๒๕๔๕
manual; handbook	หนังสือคู่มือ	๖ มี.ค. ๒๕๔๕
manuscript	๑. เอกสารตัวเขียน๒. ต้นฉบับ	๖ มี.ค. ๒๕๔๕
Marivaudage	โวหารแบบมารีโว	๖ มี.ค. ๒๕๔๕
Marxism	ลัทธิมากซ์	๖ มี.ค. ๒๕๔๕
masculine ending	ท้ายบาทเน้น	๖ มี.ค. ๒๕๔๕
masculine rhyme	สัมผัสเน้น	๖ มี.ค. ๒๕๔๕
masque	ละครหน้ากาก	๖ มี.ค. ๒๕๔๕
maxim	คติบท	๖ มี.ค. ๒๕๔๕
mechanic form	รูปแบบกลไก	๖ มี.ค. ๒๕๔๕
mechanism	กลไก	๖ มี.ค. ๒๕๔๕
medieval romance	นิยายวีรคติสมัยกลาง, นิยายโรมานซ์ สมัยกลาง	๖ มี.ค. ๒๕๔๕
medievalism	คตินิยมสมัยกลาง	๖ มี.ค. ๒๕๔๕
meditative poetry	กวีนิพนธ์แนวสมาธิ, กวีนิพนธ์รำพึงธรรม	๖ มี.ค. ๒๕๔๕
meiosis	อวพจน์	๖ มี.ค. ๒๕๔๕
melodrama	ละครประโลมโลก	๖ มี.ค. ๒๕๔๕
memoirs	บันทึกความทรงจำ	๖ มี.ค. ๒๕๔๕
Menippean satire	การเสียดสีแบบเมนิปพัส	๖ มี.ค. ๒๕๔๕
messenger	ผู้แจ้งข่าว	๖ มี.ค. ๒๕๔๕
metaphor	อุปลักษณ์	๖ มี.ค. ๒๕๔๕
Metaphysical poet	กวีแนวอภิปรัชญา	๖ มี.ค. ๒๕๔๕
metatheatre	ละครเข้ม	๖ มี.ค. ๒๕๔๕
meter; metre	มาตรา	๖ มี.ค. ๒๕๔๕
metonymy	นามนัย	๖ มี.ค. ๒๕๔๕
metre; meter	มาตรา	๖ มี.ค. ๒๕๔๕
metrical foot; foot	คณะ	๖ มี.ค. ๒๕๔๕
metrical romance	นิยายวีรคติร้อยกรอง, นิยายโรมานซ์ ร้อยกรอง	๖ มี.ค. ๒๕๔๕
Middle English	ภาษาอังกฤษกลาง	๖ มี.ค. ๒๕๔๕
Miles Gloriosus	ตัวละครแบบไมลส์กลอริโอซัส	๖ มี.ค. ๒๕๔๕
mime	ละครไมม์	๖ มี.ค. ๒๕๔๕
mimesis	การจำลอง	๖ มี.ค. ๒๕๔๕
minstrel	นักขับลำ	๖ มี.ค. ๒๕๔๕
miscellany	ปกิณกนิพนธ์	๖ มี.ค. ๒๕๔๕
miracle play	ละครปาฏิหาริย์	๖ มี.ค. ๒๕๔๕
mixed metaphor	อุปลักษณ์ประสม	๖ มี.ค. ๒๕๔๕
mock-epic	มหากาพย์กำมะลอ	๖ มี.ค. ๒๕๔๕
mock-heroic	วีรกรรมกำมะลอ	๖ มี.ค. ๒๕๔๕
Modern English	ภาษาอังกฤษใหม่	๖ มี.ค. ๒๕๔๕
moment of last suspense	ช่วงระทึกใจสุดท้าย	๖ มี.ค. ๒๕๔๕
Monogatari	เรื่องเล่าโมะโนะงะตะริ	๖ มี.ค. ๒๕๔๕
monograph	เอกสารเฉพาะเรื่อง	๖ มี.ค. ๒๕๔๕
monodrama	๑. บทละครแสดงเดี่ยว๒. ละครแสดงเดี่ยว	๖ มี.ค. ๒๕๔๕
monody	เพลงร้องเดี่ยวไว้อาลัย	๖ มี.ค. ๒๕๔๕
monologue	บทพูดเดี่ยว	๖ มี.ค. ๒๕๔๕
monometer	มาตราคณะเดียว	๖ มี.ค. ๒๕๔๕
monopolylogue	การแสดงเดี่ยว	๖ มี.ค. ๒๕๔๕
monorhyme	สัมผัสเดี่ยว	๖ มี.ค. ๒๕๔๕
moral	คติสอนใจ	๖ มี.ค. ๒๕๔๕
moral interlude	ละครสลับฉากสอนใจ	๖ มี.ค. ๒๕๔๕
morality play	ละครศีลธรรม	๖ มี.ค. ๒๕๔๕
mosaic verse	บทร้อยกรองประสม, บทร้อยกรองโมเสก	๖ มี.ค. ๒๕๔๕
mot juste, le	คำเหมาะสม	๖ มี.ค. ๒๕๔๕
mot propre, le	คำตรงความหมาย	๖ มี.ค. ๒๕๔๕
motif	แนวเรื่อง	๖ มี.ค. ๒๕๔๕
motto	คติพจน์	๖ มี.ค. ๒๕๔๕
movement	๑. การเคลื่อนไหว๒. ขบวนการ	๖ มี.ค. ๒๕๔๕
mumming play	ละครมัมมิง	๖ มี.ค. ๒๕๔๕
Muses	นพเทวีแห่งศิลปศาสตร์	๖ มี.ค. ๒๕๔๕
musical comedy	สุขนาฏกรรมเพลง	๖ มี.ค. ๒๕๔๕
mythology	๑. ประมวลเรื่องปรัมปรา๒. ปรัมปราวิทยา	๖ มี.ค. ๒๕๔๕
Märchen; folk tale	นิทานชาวบ้าน	๖ มี.ค. ๒๕๔๕
mystery cycle	ชุดละครรหัสธรรม	๖ มี.ค. ๒๕๔๕
mystery play	ละครรหัสธรรม	๖ มี.ค. ๒๕๔๕
myth	เรื่องปรัมปรา	๖ มี.ค. ๒๕๔๕
narodne pesme	ลำนำนารอดเนียเพสเมีย	๖ มี.ค. ๒๕๔๕
narration	การบรรยาย	๖ มี.ค. ๒๕๔๕
narrative	เรื่องเล่า	๖ มี.ค. ๒๕๔๕
narrative poem	บทกวีเรื่องเล่า	๖ มี.ค. ๒๕๔๕
narrator	ผู้เล่าเรื่อง	๖ มี.ค. ๒๕๔๕
naturalism	ธรรมชาตินิยม	๖ มี.ค. ๒๕๔๕
naturalistic drama	ละครแนวธรรมชาตินิยม	๖ มี.ค. ๒๕๔๕
natya	นาฏยะ	๖ มี.ค. ๒๕๔๕
nemesis	เทวทัณฑ์	๖ มี.ค. ๒๕๔๕
négritude	ความเป็นนิโกร	๖ มี.ค. ๒๕๔๕
neoclassicism	คตินิยมคืนสู่แบบแผนเดิม, คตินิยม คลาสสิกใหม่	๖ มี.ค. ๒๕๔๕
neologism	คำสร้างใหม่	๖ มี.ค. ๒๕๔๕
new comedy	สุขนาฏกรรมแนวใหม่	๖ มี.ค. ๒๕๔๕
new criticism	การวิจารณ์แนวใหม่	๖ มี.ค. ๒๕๔๕
new humanism	มนุษยนิยมแนวใหม่	๖ มี.ค. ๒๕๔๕
noble savage, the	คนเถื่อนใจธรรม	๖ มี.ค. ๒๕๔๕
No; Noh	ละครโน	๖ มี.ค. ๒๕๔๕
Noh; No	ละครโน	๖ มี.ค. ๒๕๔๕
nom de plume; pen name	นามปากกา	๖ มี.ค. ๒๕๔๕
non-fiction	สารคดี	๖ มี.ค. ๒๕๔๕
nouveau roman	นวนิยายแนวใหม่	๖ มี.ค. ๒๕๔๕
nouvelle vague	คลื่นลูกใหม่	๖ มี.ค. ๒๕๔๕
novel	นวนิยาย	๖ มี.ค. ๒๕๔๕
novel of the soil	นวนิยายลูกทุ่ง	๖ มี.ค. ๒๕๔๕
novelette	เรื่องสั้น [ฝรั่งเศส], นวนิยายขนาดสั้น [อังกฤษ]	๖ มี.ค. ๒๕๔๕
novella	นวนิยายขนาดสั้น [อิตาลี]	๖ มี.ค. ๒๕๔๕
novelty	ความแปลกใหม่	๖ มี.ค. ๒๕๔๕
nursery rhyme	บทร้อยกรองสำหรับเด็ก	๖ มี.ค. ๒๕๔๕
objective correlative	สหสัมพัทธ์ปรวิสัย	๖ มี.ค. ๒๕๔๕
objectivity	ปรวิสัย	๖ มี.ค. ๒๕๔๕
obligatory scene	ฉากจำเป็น	๖ มี.ค. ๒๕๔๕
obscurity	ความเคลือบคลุม	๖ มี.ค. ๒๕๔๕
occasional verse	บทร้อยกรองเฉพาะโอกาส	๖ มี.ค. ๒๕๔๕
octameter	มาตราแปดคณะ	๖ มี.ค. ๒๕๔๕
octave; octet	บทแปดบาท	๖ มี.ค. ๒๕๔๕
octet; octave	บทแปดบาท	๖ มี.ค. ๒๕๔๕
octosyllabic line	บาทแปดพยางค์	๖ มี.ค. ๒๕๔๕
ode	ศังสกานท์	๖ มี.ค. ๒๕๔๕
old comedy	สุขนาฏกรรมแนวเก่า	๖ มี.ค. ๒๕๔๕
Old English	ภาษาอังกฤษเก่า	๖ มี.ค. ๒๕๔๕
Old French and Provençal form	บทร้อยกรองแบบฝรั่งเศสเก่าและแบบ โปรวองซาล	๖ มี.ค. ๒๕๔๕
onomatopoeia	การเลียนเสียงธรรมชาติ	๖ มี.ค. ๒๕๔๕
ontology	กานทภาวะ	๖ มี.ค. ๒๕๔๕
open couplet	สัมผัสคู่เปิด	๖ มี.ค. ๒๕๔๕
opera	อุปรากร	๖ มี.ค. ๒๕๔๕
operretta	จุลอุปรากร	๖ มี.ค. ๒๕๔๕
oral literature	วรรณกรรมมุขปาฐะ	๖ มี.ค. ๒๕๔๕
oral tradition	๑. ประเพณีมุขปาฐะ๒. วรรณกรรมมุขปาฐะ	๖ มี.ค. ๒๕๔๕
organic form	รูปแบบอินทรียะ	๖ มี.ค. ๒๕๔๕
originality	ความเริ่มแรก	๖ มี.ค. ๒๕๔๕
Ossianism	คตินิยมออสเซียน	๖ มี.ค. ๒๕๔๕
ottava rima	บทแปดบาทสัมผัส, ออตตาวารีมา	๖ มี.ค. ๒๕๔๕
oxymoron	ปฏิพจน์	๖ มี.ค. ๒๕๔๕
pageant	ละครขบวนแห่	๖ มี.ค. ๒๕๔๕
paeon; paeonic foot	คณะพีออน	๖ มี.ค. ๒๕๔๕
paeonic foot; paeon	คณะพีออน	๖ มี.ค. ๒๕๔๕
pamphlet	จุลสาร	๖ มี.ค. ๒๕๔๕
panegyric	บทสดุดี	๖ มี.ค. ๒๕๔๕
pantaloon	ตัวตลกแพนทาลูน	๖ มี.ค. ๒๕๔๕
panoramic method	วิธีปริทัศน์	๖ มี.ค. ๒๕๔๕
pantomime	ละครแพนโทไมม์	๖ มี.ค. ๒๕๔๕
pantun	บทร้อยกรองปันตน	๖ มี.ค. ๒๕๔๕
parable	นิทานคติสอนใจ	๖ มี.ค. ๒๕๔๕
paradox	ปฏิทรรศน์	๖ มี.ค. ๒๕๔๕
paragraph	อนุเฉท, ย่อหน้า	๖ มี.ค. ๒๕๔๕
paraphrase	การถอดความ	๖ มี.ค. ๒๕๔๕
parenthesis	ความแทรก	๖ มี.ค. ๒๕๔๕
Parnassians	กลุ่มปาร์นาเซียง	๖ มี.ค. ๒๕๔๕
parody	วรรณกรรมล้อ	๖ มี.ค. ๒๕๔๕
passion play	ละครมหาทรมาน	๖ มี.ค. ๒๕๔๕
pastoral; bucolic	บทร้อยกรองท้องทุ่ง	๖ มี.ค. ๒๕๔๕
pastoral; bucolic	บทร้อยกรองท้องทุ่ง	๖ มี.ค. ๒๕๔๕
pathetic fallacy	ความผิดพลาดเหตุอารมณ์	๖ มี.ค. ๒๕๔๕
pathos	ภาวะเวทนา	๖ มี.ค. ๒๕๔๕
patois	ภาษาชนบท	๖ มี.ค. ๒๕๔๕
patronage	การอุปถัมภ์	๖ มี.ค. ๒๕๔๕
pattern	แบบรูป	๖ มี.ค. ๒๕๔๕
pattern poetry	กวีนิพนธ์แบบรูป	๖ มี.ค. ๒๕๔๕
pause	ช่วงหยุด	๖ มี.ค. ๒๕๔๕
pen name; nom de plume	นามปากกา	๖ มี.ค. ๒๕๔๕
pen name; nom de plume	นามปากกา	๖ มี.ค. ๒๕๔๕
penny dreadful; dime novel	นวนิยายสิบสตางค์	๖ มี.ค. ๒๕๔๕
pensée	ข้อคิด	๖ มี.ค. ๒๕๔๕
pentameter	มาตราห้าคณะ	๖ มี.ค. ๒๕๔๕
periphrasis	สำนวนอ้อมค้อม	๖ มี.ค. ๒๕๔๕
persona	ตัวบรรยายเรื่อง	๖ มี.ค. ๒๕๔๕
personification	บุคลาธิษฐาน, บุคคลวัต	๖ มี.ค. ๒๕๔๕
Petrarchan sonnet	บทร้อยกรองซอนเนตแบบเพทราร์ก	๖ มี.ค. ๒๕๔๕
Petrarchism	คตินิยมแบบเพทราร์ก	๖ มี.ค. ๒๕๔๕
Philistine	พวกฟิลิสไทน์	๖ มี.ค. ๒๕๔๕
picaresque novel	นวนิยายชีวิตเสเพล	๖ มี.ค. ๒๕๔๕
plagiarism	โจรกรรมทางวรรณกรรม	๖ มี.ค. ๒๕๔๕
Platonism	คตินิยมแบบเพลโต	๖ มี.ค. ๒๕๔๕
play	๑. บทละคร๒. ละคร	๖ มี.ค. ๒๕๔๕
Pléiade, la	กลุ่มลาเปลอียาด	๖ มี.ค. ๒๕๔๕
pleonasm	สำนวนฟุ่มเฟือย	๖ มี.ค. ๒๕๔๕
plot	โครงเรื่อง	๖ มี.ค. ๒๕๔๕
poem	บทกวี, โคลง	๖ มี.ค. ๒๕๔๕
poesie; poesy; poetry	กวีนิพนธ์	๖ มี.ค. ๒๕๔๕
poesy; poesie; poetry	กวีนิพนธ์	๖ มี.ค. ๒๕๔๕
poet	กวี	๖ มี.ค. ๒๕๔๕
poet laureate	รัตนกวี	๖ มี.ค. ๒๕๔๕
poetic diction	ศัพท์กวี	๖ มี.ค. ๒๕๔๕
poetic justice	ยุติธรรมแบบกวี	๖ มี.ค. ๒๕๔๕
poetic license	เอกสิทธิ์กวี	๖ มี.ค. ๒๕๔๕
poetic prose	ร้อยแก้วแนวร้อยกรอง	๖ มี.ค. ๒๕๔๕
poetry; poesie; poesy	กวีนิพนธ์	๖ มี.ค. ๒๕๔๕
point of view; viewpoint	มุมมอง	๖ มี.ค. ๒๕๔๕
polemic	บทโจมตี	๖ มี.ค. ๒๕๔๕
pornography	เรื่องเร้ากามารมณ์	๖ มี.ค. ๒๕๔๕
potboiler	งานเขียนเพื่อเงิน	๖ มี.ค. ๒๕๔๕
pre-Raphaelites, the	กลุ่มนิยมแบบก่อนราฟาเอล	๖ มี.ค. ๒๕๔๕
preciosity	การแสร้งสรรค์	๖ มี.ค. ๒๕๔๕
précis, le	บทย่อ	๖ มี.ค. ๒๕๔๕
preface	คำนำ	๖ มี.ค. ๒๕๔๕
primitivism	บรรพกาลนิยม	๖ มี.ค. ๒๕๔๕
problem novel; thesis novel	นวนิยายปัญหา	๖ มี.ค. ๒๕๔๕
problem play; thesis play	ละครปัญหา	๖ มี.ค. ๒๕๔๕
prologue	อารัมภบท	๖ มี.ค. ๒๕๔๕
propaganda novel	นวนิยายโฆษณาชวนเชื่อ	๖ มี.ค. ๒๕๔๕
propriety	ความเหมาะสม	๖ มี.ค. ๒๕๔๕
prose	ร้อยแก้ว	๖ มี.ค. ๒๕๔๕
prose poem	บทกวีร้อยแก้ว	๖ มี.ค. ๒๕๔๕
prosody	ฉันทลักษณ์	๖ มี.ค. ๒๕๔๕
protagonist	ตัวเอก	๖ มี.ค. ๒๕๔๕
protatic character	ตัวเกริ่นเรื่อง	๖ มี.ค. ๒๕๔๕
prothalamion	บทร้อยกรองฉลองวิวาห์	๖ มี.ค. ๒๕๔๕
proverbe dramatique	ละครสุภาษิต	๖ มี.ค. ๒๕๔๕
proverb	สุภาษิต	๖ มี.ค. ๒๕๔๕
psalm	เพลงสวดสดุดี	๖ มี.ค. ๒๕๔๕
pseudonym	นามแฝง	๖ มี.ค. ๒๕๔๕
psychological novel	นวนิยายจิตวิทยา	๖ มี.ค. ๒๕๔๕
pun	การเล่นคำ	๖ มี.ค. ๒๕๔๕
pure poetry	กวีนิพนธ์บริสุทธิ์	๖ มี.ค. ๒๕๔๕
quadrivium	จตุรศิลปศาสตร์	๖ มี.ค. ๒๕๔๕
quartet	๑. ชุดสี่เรื่อง๒. บทสี่บาท	๖ มี.ค. ๒๕๔๕
quarto	แปดหน้ายก	๖ มี.ค. ๒๕๔๕
quatrain	บทสี่บาท	๖ มี.ค. ๒๕๔๕
quem quaeritis trope	องก์ตามหาพระเยซู	๖ มี.ค. ๒๕๔๕
quintain; quintet	บทห้าบาท	๖ มี.ค. ๒๕๔๕
quintet; quintain	บทห้าบาท	๖ มี.ค. ๒๕๔๕
quidproquo	ความเข้าใจผิด	๖ มี.ค. ๒๕๔๕
quotation titles	ชื่อเรื่องจากอัญพจน์	๖ มี.ค. ๒๕๔๕
rasa	รสวรรณคดี	๖ มี.ค. ๒๕๔๕
rationalism	เหตุผลนิยม	๖ มี.ค. ๒๕๔๕
realism	สัจนิยม	๖ มี.ค. ๒๕๔๕
recoil	กรรมสนอง	๖ มี.ค. ๒๕๔๕
Reform Bill of 1832	ร่างพระราชบัญญัติการปฏิรูป ค.ศ. ๑๘๓๒	๖ มี.ค. ๒๕๔๕
Reformation period; Reformation, the	สมัยปฏิรูป	๖ มี.ค. ๒๕๔๕
Reformation, the; Reformation period	สมัยปฏิรูป	๖ มี.ค. ๒๕๔๕
refrain	สร้อย	๖ มี.ค. ๒๕๔๕
regional novel	นวนิยายภูมิภาค	๖ มี.ค. ๒๕๔๕
relativism	สัมพัทธนิยม	๖ มี.ค. ๒๕๔๕
Renaissance period; Renaissance, the	สมัยฟื้นฟูศิลปวิทยา	๖ มี.ค. ๒๕๔๕
Renaissance, the; Renaissance period	สมัยฟื้นฟูศิลปวิทยา	๖ มี.ค. ๒๕๔๕
repartee	คำโต้กลับ	๖ มี.ค. ๒๕๔๕
repetition	การกล่าวซ้ำ	๖ มี.ค. ๒๕๔๕
resolution; dénouement; falling action	การแก้ปม	๖ มี.ค. ๒๕๔๕
Restoration period	สมัยคืนสู่ราชบัลลังก์	๖ มี.ค. ๒๕๔๕
Restoration comedy	สุขนาฏกรรมสมัยคืนสู่ราชบัลลังก์	๖ มี.ค. ๒๕๔๕
revenge tragedy	โศกนาฏกรรมล้างแค้น	๖ มี.ค. ๒๕๔๕
reversal	ชะตาผกผัน	๖ มี.ค. ๒๕๔๕
review	บทปริทัศน์	๖ มี.ค. ๒๕๔๕
revue	วิวิธทัศนา	๖ มี.ค. ๒๕๔๕
rhapsody	บทกระทบอารมณ์, บทแรปโซดี	๖ มี.ค. ๒๕๔๕
rhetoric	วาทศาสตร์	๖ มี.ค. ๒๕๔๕
rhetorical figure	ภาพพจน์วาทศิลป์	๖ มี.ค. ๒๕๔๕
rhetorical question	คำถามเชิงวาทศิลป์	๖ มี.ค. ๒๕๔๕
rhyme	สัมผัส	๖ มี.ค. ๒๕๔๕
rhyme royal	สัมผัสราชา, สัมผัสรอยัล	๖ มี.ค. ๒๕๔๕
rhyme scheme	แผนสัมผัส	๖ มี.ค. ๒๕๔๕
rhythm	จังหวะ	๖ มี.ค. ๒๕๔๕
riddle	คำทาย	๖ มี.ค. ๒๕๔๕
rising action; anabasis	การขมวดปม	๖ มี.ค. ๒๕๔๕
rising rhythm	จังหวะขึ้น	๖ มี.ค. ๒๕๔๕
rococo	วรรณกรรมโรโกโก	๖ มี.ค. ๒๕๔๕
roman-fleuve	นวนิยายชุด	๖ มี.ค. ๒๕๔๕
romance	นิยายวีรคติ, นิยายโรมานซ์	๖ มี.ค. ๒๕๔๕
romantic comedy	สุขนาฏกรรมจินตนิยม	๖ มี.ค. ๒๕๔๕
romantic irony	การแฝงนัยเชิงจินตนิยม	๖ มี.ค. ๒๕๔๕
romantic revival	การฟื้นฟูจินตนิยม	๖ มี.ค. ๒๕๔๕
romanticism	จินตนิยม	๖ มี.ค. ๒๕๔๕
rondeau	บทร้อยกรองรงโด	๖ มี.ค. ๒๕๔๕
round character	ตัวละครหลายมิติ	๖ มี.ค. ๒๕๔๕
run-on line	บาทไม่จบความ	๖ มี.ค. ๒๕๔๕
sacred books	คัมภีร์ศักดิ์สิทธิ์	๖ มี.ค. ๒๕๔๕
saga	นิยายซากา	๖ มี.ค. ๒๕๔๕
saga novel	นวนิยายซากา	๖ มี.ค. ๒๕๔๕
salon	เสวนาสโมสร, ซาลง	๖ มี.ค. ๒๕๔๕
samizdat	วรรณกรรมซามิซดัต	๖ มี.ค. ๒๕๔๕
sarcasm	คำประชดเหน็บแนม	๖ มี.ค. ๒๕๔๕
satire	การเสียดสี	๖ มี.ค. ๒๕๔๕
satirical comedy	สุขนาฏกรรมเสียดสี	๖ มี.ค. ๒๕๔๕
satyr play	ละครปิดท้ายคลายเครียด, ละครตลกแซเทอร์	๖ มี.ค. ๒๕๔๕
scald; skald	นักขับลำสกอลด์	๖ มี.ค. ๒๕๔๕
scansion	ฉันทลักษณ์พินิจ	๖ มี.ค. ๒๕๔๕
scene	ฉาก	๖ มี.ค. ๒๕๔๕
science fiction	บันเทิงคดีแนววิทยาศาสตร์	๖ มี.ค. ๒๕๔๕
scholasticism	อัสสมาจารย์นิยม	๖ มี.ค. ๒๕๔๕
scop	นักขับลำสก็อป	๖ มี.ค. ๒๕๔๕
Senecan tragedy	โศกนาฏกรรมแบบเซเนกา	๖ มี.ค. ๒๕๔๕
sensibility	อารมณ์ละเอียดอ่อน	๖ มี.ค. ๒๕๔๕
sentimentality	การเร้าอารมณ์	๖ มี.ค. ๒๕๔๕
sentimental comedy	สุขนาฏกรรมเร้าอารมณ์	๖ มี.ค. ๒๕๔๕
sentimental novel	นวนิยายเร้าอารมณ์	๖ มี.ค. ๒๕๔๕
septet	บทเจ็ดบาท	๖ มี.ค. ๒๕๔๕
serenade	เพลงเกี้ยวยามค่ำ	๖ มี.ค. ๒๕๔๕
sermon	บทเทศน์	๖ มี.ค. ๒๕๔๕
serpentine verse	บทร้อยกรองเซอร์เพนไทน์	๖ มี.ค. ๒๕๔๕
setting	ฉากท้องเรื่อง	๖ มี.ค. ๒๕๔๕
sestet	บทหกบาท	๖ มี.ค. ๒๕๔๕
Seven Liberal Arts	ศิลปศาสตร์เจ็ดประการ	๖ มี.ค. ๒๕๔๕
shadow play	หนังเชิด	๖ มี.ค. ๒๕๔๕
Shakespearian sonnet	บทร้อยกรองซอนเนตแบบเชกสเปียร์	๖ มี.ค. ๒๕๔๕
short couplet	สัมผัสคู่สั้น	๖ มี.ค. ๒๕๔๕
short measure; short meter	มาตราสั้น	๖ มี.ค. ๒๕๔๕
short meter; short measure	มาตราสั้น	๖ มี.ค. ๒๕๔๕
short novel	นวนิยายสั้น	๖ มี.ค. ๒๕๔๕
short story	เรื่องสั้น	๖ มี.ค. ๒๕๔๕
sic	ตามต้นฉบับ	๖ มี.ค. ๒๕๔๕
simile	อุปมา	๖ มี.ค. ๒๕๔๕
simplified edition	ฉบับง่าย	๖ มี.ค. ๒๕๔๕
sitcom	ซิตคอม	๖ มี.ค. ๒๕๔๕
situation comedy	ละครหรรษา	๖ มี.ค. ๒๕๔๕
skald; scald	นักขับลำสกอลด์	๖ มี.ค. ๒๕๔๕
sketch	เรื่องย่อย	๖ มี.ค. ๒๕๔๕
skit	ละครย่อย	๖ มี.ค. ๒๕๔๕
slang	สแลง	๖ มี.ค. ๒๕๔๕
slapstick	ละครตลกโปกฮา	๖ มี.ค. ๒๕๔๕
slice of life	เสี้ยวชีวิต	๖ มี.ค. ๒๕๔๕
slogan	คำขวัญ	๖ มี.ค. ๒๕๔๕
sloka	โศลก	๖ มี.ค. ๒๕๔๕
Socratic irony	การแฝงนัยแบบโสคราตีส	๖ มี.ค. ๒๕๔๕
socialist realism	สัจนิยมแนวสังคมนิยม	๖ มี.ค. ๒๕๔๕
solioquy	บทรำพึง	๖ มี.ค. ๒๕๔๕
song	๑. เพลงร้อง, เพลง๒. บทร้อยกรอง	๖ มี.ค. ๒๕๔๕
sonnet	บทร้อยกรองซอนเนต	๖ มี.ค. ๒๕๔๕
sonnet cycle	ชุดบทร้อยกรองซอนเนต	๖ มี.ค. ๒๕๔๕
Spenserian sonnet	บทร้อยกรองซอนเนตแบบสเปนเซอร์	๖ มี.ค. ๒๕๔๕
Spenserian stanza	บทแบบสเปนเซอร์	๖ มี.ค. ๒๕๔๕
spondaic foot; spondee	คณะสปอนดี	๖ มี.ค. ๒๕๔๕
spondee; spondaic foot	คณะสปอนดี	๖ มี.ค. ๒๕๔๕
spy story	เรื่องจารกรรม	๖ มี.ค. ๒๕๔๕
stage directions	บทกำกับเวที	๖ มี.ค. ๒๕๔๕
starina	เพลงวีรกรรมสตารินา	๖ มี.ค. ๒๕๔๕
stanza	บท	๖ มี.ค. ๒๕๔๕
stasimon	เพลงพรรณนาสตาซิมอน	๖ มี.ค. ๒๕๔๕
stock character	ตัวละครเข้าแบบ	๖ มี.ค. ๒๕๔๕
stock response	การตอบสนองเข้าแบบ	๖ มี.ค. ๒๕๔๕
stock situation	สถานการณ์เข้าแบบ	๖ มี.ค. ๒๕๔๕
story within a story	เรื่องซ้อนเรื่อง	๖ มี.ค. ๒๕๔๕
strategy	กลยุทธ์	๖ มี.ค. ๒๕๔๕
stream of consciousness	กระแสสำนึก	๖ มี.ค. ๒๕๔๕
stress; accent	๑. พยางค์เน้น๒. การเน้นพยางค์	๖ มี.ค. ๒๕๔๕
strophe	บทสโตรฟี	๖ มี.ค. ๒๕๔๕
structure	โครงสร้าง	๖ มี.ค. ๒๕๔๕
Sturm und Drang (storm and stress)	ขบวนการพายุและแรงอารมณ์	๖ มี.ค. ๒๕๔๕
style	ลีลา	๖ มี.ค. ๒๕๔๕
sub-plot	โครงเรื่องรอง	๖ มี.ค. ๒๕๔๕
subjectivity	อัตวิสัย	๖ มี.ค. ๒๕๔๕
sublime	ภาวะเลอเลิศ	๖ มี.ค. ๒๕๔๕
suggestion	การแนะนัย	๖ มี.ค. ๒๕๔๕
summary; synopsis	เรื่องย่อ	๖ มี.ค. ๒๕๔๕
supernatural story	เรื่องเหนือธรรมชาติ	๖ มี.ค. ๒๕๔๕
surprise ending	การจบแบบผิดคาด	๖ มี.ค. ๒๕๔๕
surrealism	คติเหนือจริง	๖ มี.ค. ๒๕๔๕
suspense	ความระทึกใจ	๖ มี.ค. ๒๕๔๕
symbol and symbolism	สัญลักษณ์และสัญลักษณ์นิยม	๖ มี.ค. ๒๕๔๕
symposium	ประชุมเอกสารัตถ์	๖ มี.ค. ๒๕๔๕
synaesthesia	สหลักษณ์	๖ มี.ค. ๒๕๔๕
syncope; hyphaeresis	การตัดกลางคำ	๖ มี.ค. ๒๕๔๕
synecdoche	สัมพจนัย	๖ มี.ค. ๒๕๔๕
synonym	ไวพจน์	๖ มี.ค. ๒๕๔๕
synopsis; summary	เรื่องย่อ	๖ มี.ค. ๒๕๔๕
systrophe	อเนกนัย	๖ มี.ค. ๒๕๔๕
tableau	ฉากภาพนิ่ง	๖ มี.ค. ๒๕๔๕
tall tale	นิทานเหลือเชื่อ	๖ มี.ค. ๒๕๔๕
tamizdat	วรรณกรรมทามิซดัต	๖ มี.ค. ๒๕๔๕
tale	นิทาน	๖ มี.ค. ๒๕๔๕
tapinosis	ภาพพจน์ลดค่า	๖ มี.ค. ๒๕๔๕
tanka	บทกวีทังกะ	๖ มี.ค. ๒๕๔๕
taste	รสนิยม	๖ มี.ค. ๒๕๔๕
technique	กลวิธี	๖ มี.ค. ๒๕๔๕
telescoped metaphor; complex metaphor	อุปลักษณ์ซับซ้อน	๖ มี.ค. ๒๕๔๕
tenor and vehicle	สาระและสื่อเปรียบ	๖ มี.ค. ๒๕๔๕
tercet	บทสามบาท	๖ มี.ค. ๒๕๔๕
terminal rhyme; end rhyme	สัมผัสท้ายบาท	๖ มี.ค. ๒๕๔๕
terza rima	บทสามบาทสัมผัส, เทอร์ซารีมา	๖ มี.ค. ๒๕๔๕
testament	๑. พันธสัญญา๒. วรรณกรรมเจตจำนง	๖ มี.ค. ๒๕๔๕
tetralogy	ชุดสี่เรื่อง	๖ มี.ค. ๒๕๔๕
tetrameter	มาตราสี่คณะ	๖ มี.ค. ๒๕๔๕
textual criticism	การวิจารณ์ตัวบท	๖ มี.ค. ๒๕๔๕
texture	เนื้องาน	๖ มี.ค. ๒๕๔๕
theatricalism	นาฏยนิยม	๖ มี.ค. ๒๕๔๕
theatre	๑. ละคร๒. โรงละคร	๖ มี.ค. ๒๕๔๕
theatre of cruelty	ละครโหด	๖ มี.ค. ๒๕๔๕
theatre of silence	ละครเงียบ	๖ มี.ค. ๒๕๔๕
theatre of the absurd	ละครแปลกวิสัย, ละครแอบเซิร์ด	๖ มี.ค. ๒๕๔๕
theatre-in-the-round	ละครล้อมวง	๖ มี.ค. ๒๕๔๕
theme	แก่นเรื่อง	๖ มี.ค. ๒๕๔๕
theogony	เทวกำเนิด	๖ มี.ค. ๒๕๔๕
thesaurus	อรรถาภิธาน	๖ มี.ค. ๒๕๔๕
thesis	๑. ข้อปัญหา๒. วิทยานิพนธ์	๖ มี.ค. ๒๕๔๕
thesis novel; problem novel	นวนิยายปัญหา	๖ มี.ค. ๒๕๔๕
thesis play; problem play	ละครปัญหา	๖ มี.ค. ๒๕๔๕
three unities	สามเอกภาพ	๖ มี.ค. ๒๕๔๕
thriller	เรื่องตื่นเต้น	๖ มี.ค. ๒๕๔๕
time novel	นวนิยายกาลเวลา	๖ มี.ค. ๒๕๔๕
tone; tone colour	น้ำเสียง	๖ มี.ค. ๒๕๔๕
tone colour; tone	น้ำเสียง	๖ มี.ค. ๒๕๔๕
tongue twister	บทบิดลิ้น	๖ มี.ค. ๒๕๔๕
topographical poetry	กวีนิพนธ์ภูมิลักษณ์	๖ มี.ค. ๒๕๔๕
touchstone	เกณฑ์กำหนดค่า	๖ มี.ค. ๒๕๔๕
tour de force	พลังฝีมือ	๖ มี.ค. ๒๕๔๕
tragedy of blood	โศกนาฏกรรมนองเลือด	๖ มี.ค. ๒๕๔๕
tragi-comedy	สุขนาฏกรรมระคนโศก	๖ มี.ค. ๒๕๔๕
tragic flaw	วิรุธลักษณ์	๖ มี.ค. ๒๕๔๕
tradition	แบบแผนประเพณี	๖ มี.ค. ๒๕๔๕
tragedy	โศกนาฏกรรม	๖ มี.ค. ๒๕๔๕
transcendentalism	คตินิยมเหนือเหตุผล	๖ มี.ค. ๒๕๔๕
translation	การแปล	๖ มี.ค. ๒๕๔๕
travel book	หนังสือท่องเที่ยว	๖ มี.ค. ๒๕๔๕
treatise	ศาสตรนิพนธ์	๖ มี.ค. ๒๕๔๕
trilogy	ชุดสามเรื่อง	๖ มี.ค. ๒๕๔๕
triolet	บทร้อยกรองตรีโอเล	๖ มี.ค. ๒๕๔๕
trimeter	มาตราสามคณะ	๖ มี.ค. ๒๕๔๕
triple rhyme	สัมผัสสามพยางค์	๖ มี.ค. ๒๕๔๕
trope	๑. ภาพพจน์เปรียบเทียบ๒. การแสดงในพิธีมิสซา	๖ มี.ค. ๒๕๔๕
trivium	ไตรศิลปศาสตร์	๖ มี.ค. ๒๕๔๕
trochaic foot; trochee	คณะโทรคี	๖ มี.ค. ๒๕๔๕
trochee; trochaic foot	คณะโทรคี	๖ มี.ค. ๒๕๔๕
trouvére	นักขับลำตรูแวร์	๖ มี.ค. ๒๕๔๕
troubadour	นักขับลำตรูบาดูร์	๖ มี.ค. ๒๕๔๕
Tudor period	สมัยทิวเดอร์	๖ มี.ค. ๒๕๔๕
Ubi sunt formula	สูตรอูบิซุนต์	๖ มี.ค. ๒๕๔๕
unabridged edition	ฉบับไม่ตัดย่อ	๖ มี.ค. ๒๕๔๕
unaccented syllable; unstressed syllable	พยางค์ไม่เน้น	๖ มี.ค. ๒๕๔๕
unity	เอกภาพ	๖ มี.ค. ๒๕๔๕
universality	ความเป็นสากล	๖ มี.ค. ๒๕๔๕
university wits	กลุ่มนักเขียนมหาวิทยาลัย	๖ มี.ค. ๒๕๔๕
unstressed syllable; unaccented syllable	พยางค์ไม่เน้น	๖ มี.ค. ๒๕๔๕
usage	ขนบภาษา	๖ มี.ค. ๒๕๔๕
Utopia	ยูโทเปีย	๖ มี.ค. ๒๕๔๕
variorum edition	ฉบับมีนัยวิเคราะห์	๖ มี.ค. ๒๕๔๕
vaudeville	การแสดงโวเดอวีล	๖ มี.ค. ๒๕๔๕
verbal irony	การแฝงนัยด้วยถ้อยคำ	๖ มี.ค. ๒๕๔๕
verisimilitude	ความละม้ายจริง	๖ มี.ค. ๒๕๔๕
vers de société	บทร้อยกรองวงสังคม	๖ มี.ค. ๒๕๔๕
verse	บทร้อยกรอง	๖ มี.ค. ๒๕๔๕
Victorian period	สมัยวิกตอเรีย	๖ มี.ค. ๒๕๔๕
viewpoint; point of view	มุมมอง	๖ มี.ค. ๒๕๔๕
vignette	บรรณพิลาส	๖ มี.ค. ๒๕๔๕
villain	ตัวโกง	๖ มี.ค. ๒๕๔๕
villanelle	บทร้อยกรองวิลลาแนล	๖ มี.ค. ๒๕๔๕
voice	เสียงแฝง	๖ มี.ค. ๒๕๔๕
watchword	คำเตือนใจ	๖ มี.ค. ๒๕๔๕
weak ending	ท้ายบาทเบา	๖ มี.ค. ๒๕๔๕
well-made novel	นวนิยายครบสูตร	๖ มี.ค. ๒๕๔๕
well-made play	บทละครครบสูตร	๖ มี.ค. ๒๕๔๕
Weltanchauung; world view	โลกทัศน์	๖ มี.ค. ๒๕๔๕
wit	ปฏิภาณ	๖ มี.ค. ๒๕๔๕
world view; Weltanchauung	โลกทัศน์	๖ มี.ค. ๒๕๔๕
wrenched accent	พยางค์เน้นสลับที่	๖ มี.ค. ๒๕๔๕
yarn	เรื่องเหลือเชื่อ	๖ มี.ค. ๒๕๔๕
year book	หนังสือรายงานประจำปี	๖ มี.ค. ๒๕๔๕
zenske pesme	ลำนำเซนสเกียเพสเมีย	๖ มี.ค. ๒๕๔๕
zeugma	โวหารเล่นคำหลากความ	๖ มี.ค. ๒๕๔๕
ละคร, นาฏกรรม; บทละคร	drama	๖ มี.ค. ๒๕๔๕
ละคร; บทละคร	play	๖ มี.ค. ๒๕๔๕
ละคร; โรงละคร	theatre	๖ มี.ค. ๒๕๔๕
ละครเยซูอิต	Jesuit drama	๖ มี.ค. ๒๕๔๕
ละครย่อย	skit	๖ มี.ค. ๒๕๔๕
ละครรหัสธรรม	mystery play	๖ มี.ค. ๒๕๔๕
ละครมหาทรมาน	passion play	๖ มี.ค. ๒๕๔๕
ละครโหด	theatre of cruelty	๖ มี.ค. ๒๕๔๕
ละครแสดงเดี่ยว; บทละครแสดงเดี่ยว	monodrama	๖ มี.ค. ๒๕๔๕
ละครแอบเซิร์ด, ละครแปลกวิสัย	theatre of the absurd	๖ มี.ค. ๒๕๔๕
ละครมัมมิง	mumming play	๖ มี.ค. ๒๕๔๕
ละครเข้ม	metatheatre	๖ มี.ค. ๒๕๔๕
ละครเงียบ	theatre of silence	๖ มี.ค. ๒๕๔๕
ละครโน	No; Noh	๖ มี.ค. ๒๕๔๕
ละครแนวมหากาพย์	epic theatre	๖ มี.ค. ๒๕๔๕
ละครแนวธรรมชาตินิยม	naturalistic drama	๖ มี.ค. ๒๕๔๕
ละครใบ้ล้อ	magody	๖ มี.ค. ๒๕๔๕
ละครแปลกวิสัย, ละครแอบเซิร์ด	theatre of the absurd	๖ มี.ค. ๒๕๔๕
ละครแพนโทไมม์	pantomime	๖ มี.ค. ๒๕๔๕
ละครหรรษา	situation comedy	๖ มี.ค. ๒๕๔๕
ละครศีลธรรม	morality play	๖ มี.ค. ๒๕๔๕
ละครสลับฉาก, การแสดงสลับฉาก	interlude	๖ มี.ค. ๒๕๔๕
ละครสลับฉากสอนใจ	moral interlude	๖ มี.ค. ๒๕๔๕
ละครสลับฉากของอิตาลี	intermezzi	๖ มี.ค. ๒๕๔๕
ละครหน้ากาก	masque	๖ มี.ค. ๒๕๔๕
ละครสุภาษิต	proverbe dramatique	๖ มี.ค. ๒๕๔๕
ละครหุ่นโจรุริ	joruri	๖ มี.ค. ๒๕๔๕
ละครอิงเอกสาร	documentary theatre	๖ มี.ค. ๒๕๔๕
ละครอิงประวัติศาสตร์	chronicle play; history play	๖ มี.ค. ๒๕๔๕
ละครล้อมวง	theatre-in-the-round	๖ มี.ค. ๒๕๔๕
ละครไมม์	mime	๖ มี.ค. ๒๕๔๕
ละครก้นครัว	kitchen-sink drama	๖ มี.ค. ๒๕๔๕
ละครกลอนสด	commedia dell’arte	๖ มี.ค. ๒๕๔๕
ละครขบวนแห่	pageant	๖ มี.ค. ๒๕๔๕
ละครคะบุกิ	kabuki	๖ มี.ค. ๒๕๔๕
ละครคาวาเลียร์	Cavalier drama	๖ มี.ค. ๒๕๔๕
ละครชะตากรรม	fate drama	๖ มี.ค. ๒๕๔๕
ละครชาวบ้าน	folk drama	๖ มี.ค. ๒๕๔๕
ละครชนชั้นกลาง	bourgeois drama	๖ มี.ค. ๒๕๔๕
ละครตลก	farce	๖ มี.ค. ๒๕๔๕
ละครตลกแซเทอร์, ละครปิดท้ายคลายเครียด	satyr play	๖ มี.ค. ๒๕๔๕
ละครตลกโปกฮา	slapstick	๖ มี.ค. ๒๕๔๕
ละครถูกกฎหมาย	legitimate theatre	๖ มี.ค. ๒๕๔๕
ละครบูลวาร์ด	boulevard drama	๖ มี.ค. ๒๕๔๕
ละครประโลมโลก	melodrama	๖ มี.ค. ๒๕๔๕
ละครปัญหา	problem play; thesis play	๖ มี.ค. ๒๕๔๕
ละครปัญหา	thesis play; problem play	๖ มี.ค. ๒๕๔๕
ละครปัญญาชน	academic drama	๖ มี.ค. ๒๕๔๕
ละครปาฏิหาริย์	miracle play	๖ มี.ค. ๒๕๔๕
ละครปิดท้ายคลายเครียด, ละครตลกแซเทอร์	satyr play	๖ มี.ค. ๒๕๔๕
ละครปฏิลักษณ์	anti-play	๖ มี.ค. ๒๕๔๕
ละครฟาบูลา	fabula	๖ มี.ค. ๒๕๔๕
ลัทธิมากซ์	Marxism	๖ มี.ค. ๒๕๔๕
ลีลา	style	๖ มี.ค. ๒๕๔๕
ลีลาภาคภูมิ	grand style	๖ มี.ค. ๒๕๔๕
ลีลาแบบซิเซโร	Ciceronian style	๖ มี.ค. ๒๕๔๕
ลำนำเซนสเกียเพสเมีย	zenske pesme	๖ มี.ค. ๒๕๔๕
ลำนำจูนักเกียเพสเมีย	junacke pesme	๖ มี.ค. ๒๕๔๕
ลำนำนารอดเนียเพสเมีย	narodne pesme	๖ มี.ค. ๒๕๔๕
ลำนำนิทาน	ballad; ballade	๖ มี.ค. ๒๕๔๕
ไวพจน์	synonym	๖ มี.ค. ๒๕๔๕
ไตรศิลปศาสตร์	trivium	๖ มี.ค. ๒๕๔๕
ไบแซนไทน์	Byzantine	๖ มี.ค. ๒๕๔๕
กรรมสนอง	recoil	๖ มี.ค. ๒๕๔๕
กระแสสำนึก	stream of consciousness	๖ มี.ค. ๒๕๔๕
กระบวนจินตภาพ	imagery	๖ มี.ค. ๒๕๔๕
กรอบเรื่อง	frame story	๖ มี.ค. ๒๕๔๕
กวีนิพนธ์แนวสมาธิ, กวีนิพนธ์รำพึงธรรม	meditative poetry	๖ มี.ค. ๒๕๔๕
กวีนิพนธ์แบบรูป	pattern poetry	๖ มี.ค. ๒๕๔๕
กวีนิพนธ์สารภาพ	confessional poetry	๖ มี.ค. ๒๕๔๕
กวีนิพนธ์สุสาน	graveyard poetry	๖ มี.ค. ๒๕๔๕
กวีนิพนธ์จอร์เจียน	Georgian poetry	๖ มี.ค. ๒๕๔๕
กวีนิพนธ์บริสุทธิ์	pure poetry	๖ มี.ค. ๒๕๔๕
กวี	poet	๖ มี.ค. ๒๕๔๕
กวี; กวีขับลำ	bard	๖ มี.ค. ๒๕๔๕
กวีแนวอภิปรัชญา	Metaphysical poet	๖ มี.ค. ๒๕๔๕
กวีกลุ่มแบล็กเมาน์เทน	Black Mountain poets	๖ มี.ค. ๒๕๔๕
กวีกลุ่มหน่ายสังคม, กวีกลุ่มบีต	beat poets	๖ มี.ค. ๒๕๔๕
กวีกลุ่มคาวาเลียร์	Cavalier poets	๖ มี.ค. ๒๕๔๕
กวีกลุ่มจินตภาพ	Imagist	๖ มี.ค. ๒๕๔๕
กวีขับลำ; กวี	bard	๖ มี.ค. ๒๕๔๕
กวีนิพนธ์	poesie; poesy; poetry	๖ มี.ค. ๒๕๔๕
กวีนิพนธ์รำพึงธรรม; กวีนิพนธ์แนวสมาธิ	meditative poetry	๖ มี.ค. ๒๕๔๕
กวีนิพนธ์ภูมิลักษณ์	topographical poetry	๖ มี.ค. ๒๕๔๕
การเร้าอารมณ์	sentimentality	๖ มี.ค. ๒๕๔๕
การเริ่มกลางเรื่อง	in medias res	๖ มี.ค. ๒๕๔๕
การแสร้งแย้ง	anthypophora	๖ มี.ค. ๒๕๔๕
การแสร้งสรรค์	preciosity	๖ มี.ค. ๒๕๔๕
การย้อนรำลึก	anamnesis	๖ มี.ค. ๒๕๔๕
การเสียดสี	satire	๖ มี.ค. ๒๕๔๕
การเสียดสีแบบเมนิปพัส	Menippean satire	๖ มี.ค. ๒๕๔๕
การแสดงสลับฉาก, ละครสลับฉาก	interlude	๖ มี.ค. ๒๕๔๕
การแสดงโวเดอวีล	vaudeville	๖ มี.ค. ๒๕๔๕
การแสดงเดี่ยว	monopolylogue	๖ มี.ค. ๒๕๔๕
การแสดงในพิธีมิสซา; ภาพพจน์เปรียบเทียบ	trope	๖ มี.ค. ๒๕๔๕
การเล่นคำ	pun	๖ มี.ค. ๒๕๔๕
การเลียนเสียงธรรมชาติ	onomatopoeia	๖ มี.ค. ๒๕๔๕
การเลียนแบบ	imitation	๖ มี.ค. ๒๕๔๕
การเกริ่นการณ์	foreshadowing	๖ มี.ค. ๒๕๔๕
การแก้ปม	dénouement; falling action; resolution	๖ มี.ค. ๒๕๔๕
การเกลื่อนคำ	euphemism	๖ มี.ค. ๒๕๔๕
การเขียนโดยอัตโนมัติ	automatic writing	๖ มี.ค. ๒๕๔๕
การเคลื่อนไหว; ขบวนการ	movement	๖ มี.ค. ๒๕๔๕
การโต้แย้ง	argumentation	๖ มี.ค. ๒๕๔๕
การแนะนัย	suggestion	๖ มี.ค. ๒๕๔๕
การเน้น	emphasis	๖ มี.ค. ๒๕๔๕
การเน้นซ้ำคำ	anaphora	๖ มี.ค. ๒๕๔๕
การเน้นพยางค์; พยางค์เน้น	accent; stress	๖ มี.ค. ๒๕๔๕
การเปรียบต่าง	contrast	๖ มี.ค. ๒๕๔๕
การแปล	translation	๖ มี.ค. ๒๕๔๕
การแปลงเป็นบทละคร	dramatization	๖ มี.ค. ๒๕๔๕
การแฝงนัย	irony	๖ มี.ค. ๒๕๔๕
การแฝงนัยเชิงโชคล้อ	irony of fate	๖ มี.ค. ๒๕๔๕
การแฝงนัยเชิงละคร	dramatic irony	๖ มี.ค. ๒๕๔๕
การแฝงนัยเชิงจินตนิยม	romantic irony	๖ มี.ค. ๒๕๔๕
การแฝงนัยแบบโสคราตีส	Socratic irony	๖ มี.ค. ๒๕๔๕
การแฝงนัยด้วยถ้อยคำ	verbal irony	๖ มี.ค. ๒๕๔๕
การวิเคราะห์	analysis	๖ มี.ค. ๒๕๔๕
การวิจารณ์แนวใหม่	new criticism	๖ มี.ค. ๒๕๔๕
การวิจารณ์ตัวบท	textual criticism	๖ มี.ค. ๒๕๔๕
การสัมผัสอักษร	alliteration	๖ มี.ค. ๒๕๔๕
การสำคัญผิด	hamartia	๖ มี.ค. ๒๕๔๕
การสลับคำ	inversion	๖ มี.ค. ๒๕๔๕
การหนังสือพิมพ์	journalism	๖ มี.ค. ๒๕๔๕
การอ้างถึง	allusion	๖ มี.ค. ๒๕๔๕
การออกนอกเรื่อง	digression	๖ มี.ค. ๒๕๔๕
การ์ตูน	cartoon	๖ มี.ค. ๒๕๔๕
การอุปถัมภ์	patronage	๖ มี.ค. ๒๕๔๕
การละความ	ellipsis	๖ มี.ค. ๒๕๔๕
การลดระดับ	bathos	๖ มี.ค. ๒๕๔๕
การลดความรุนแรง	amblysia	๖ มี.ค. ๒๕๔๕
การไม่เน้นพยางค์	atony	๖ มี.ค. ๒๕๔๕
การกระทบสระ	assonance	๖ มี.ค. ๒๕๔๕
การกร่อนต้นคำ	aphesis	๖ มี.ค. ๒๕๔๕
การกล่าวซ้ำ	repetition	๖ มี.ค. ๒๕๔๕
การขยายความ	amplification	๖ มี.ค. ๒๕๔๕
การขมวดปม	anabasis; rising action	๖ มี.ค. ๒๕๔๕
การค้นพบ	discovery	๖ มี.ค. ๒๕๔๕
การจำลอง	mimesis	๖ มี.ค. ๒๕๔๕
การจบแบบผิดคาด	surprise ending	๖ มี.ค. ๒๕๔๕
การซ้ำเสียงพยัญชนะ	consonance	๖ มี.ค. ๒๕๔๕
การดัดแปลง	adaptation	๖ มี.ค. ๒๕๔๕
การดำเนินเรื่อง	action	๖ มี.ค. ๒๕๔๕
การตอบสนองเข้าแบบ	stock response	๖ มี.ค. ๒๕๔๕
การตัดกลางคำ	hyphaeresis; syncope	๖ มี.ค. ๒๕๔๕
การตัดต้นคำ	aphaeresis	๖ มี.ค. ๒๕๔๕
การตัดท้ายคำ	apocope	๖ มี.ค. ๒๕๔๕
การตัดท้ายบาท	catalexis	๖ มี.ค. ๒๕๔๕
การถอดความ	paraphrase	๖ มี.ค. ๒๕๔๕
การทวนคำ	anadiplosis	๖ มี.ค. ๒๕๔๕
การทายคำสัมผัส	crambo	๖ มี.ค. ๒๕๔๕
การนิยาม	definition	๖ มี.ค. ๒๕๔๕
การบรรยาย	narration	๖ มี.ค. ๒๕๔๕
การปะติดความ	collage	๖ มี.ค. ๒๕๔๕
การปฏิวัติอุตสาหกรรม	industrial revolution	๖ มี.ค. ๒๕๔๕
การผิดกาละ	anachronism	๖ มี.ค. ๒๕๔๕
การผูกปม	complication	๖ มี.ค. ๒๕๔๕
การพรรณนา	description	๖ มี.ค. ๒๕๔๕
การพูดป้อง	aside	๖ มี.ค. ๒๕๔๕
การฟื้นฟูจินตนิยม	romantic revival	๖ มี.ค. ๒๕๔๕
กาลานุกรม	almanac	๖ มี.ค. ๒๕๔๕
กานทภาวะ	ontology	๖ มี.ค. ๒๕๔๕
กลยุทธ์	strategy	๖ มี.ค. ๒๕๔๕
กลวิธี	technique	๖ มี.ค. ๒๕๔๕
กลอนรำพัน	complaint	๖ มี.ค. ๒๕๔๕
กลอนเปล่า	blank verse	๖ มี.ค. ๒๕๔๕
กลไก	mechanism	๖ มี.ค. ๒๕๔๕
กลการ	machinery	๖ มี.ค. ๒๕๔๕
กลุ่มเลอเซนากล์	cénacle, le	๖ มี.ค. ๒๕๔๕
กลุ่มโกเลีร์ยด	Goliards	๖ มี.ค. ๒๕๔๕
กลุ่มเกษตรนิยม	agrarians	๖ มี.ค. ๒๕๔๕
กลุ่มหนุ่มเจ้าโทสะ	angry young man	๖ มี.ค. ๒๕๔๕
กลุ่มล้ำยุค	avant-garde	๖ มี.ค. ๒๕๔๕
กลุ่มลาเปลอียาด	Pléiade, la	๖ มี.ค. ๒๕๔๕
กลุ่มถุงน่องน้ำเงิน	blue-stocking	๖ มี.ค. ๒๕๔๕
กลุ่มนักเขียนมหาวิทยาลัย	university wits	๖ มี.ค. ๒๕๔๕
กลุ่มนิยมแบบก่อนราฟาเอล	pre-Raphaelites, the	๖ มี.ค. ๒๕๔๕
กลุ่มบลูมส์เบอรี	Bloomsbury group, the	๖ มี.ค. ๒๕๔๕
กลุ่มปาร์นาเซียง	Parnassians	๖ มี.ค. ๒๕๔๕
กลุ่มผู้หลีกลี้	Fugitives, the	๖ มี.ค. ๒๕๔๕
ข้อคิด	pensée	๖ มี.ค. ๒๕๔๕
ข้อปัญหา; วิทยานิพนธ์	thesis	๖ มี.ค. ๒๕๔๕
ขนบภาษา	usage	๖ มี.ค. ๒๕๔๕
ขบวนการ; การเคลื่อนไหว	movement	๖ มี.ค. ๒๕๔๕
ขบวนการพายุและแรงอารมณ์	Sturm und Drang (storm and stress)	๖ มี.ค. ๒๕๔๕
ความเรียง	essay	๖ มี.ค. ๒๕๔๕
ความเริ่มแรก	originality	๖ มี.ค. ๒๕๔๕
ความระทึกใจ	suspense	๖ มี.ค. ๒๕๔๕
ความเหมาะสม	propriety	๖ มี.ค. ๒๕๔๕
ความเห็นประกอบ	annotation	๖ มี.ค. ๒๕๔๕
ความเข้าใจผิด	quidproquo	๖ มี.ค. ๒๕๔๕
ความเคลือบคลุม	obscurity	๖ มี.ค. ๒๕๔๕
ความแทรก	parenthesis	๖ มี.ค. ๒๕๔๕
ความเป็นสากล	universality	๖ มี.ค. ๒๕๔๕
ความเป็นกลาง	disinterestedness	๖ มี.ค. ๒๕๔๕
ความเป็นกลางทางสุนทรียภาพ	aesthetic distance	๖ มี.ค. ๒๕๔๕
ความเป็นนิโกร	négritude	๖ มี.ค. ๒๕๔๕
ความแปลกใหม่	novelty	๖ มี.ค. ๒๕๔๕
ความเพ้อฝัน	fancy	๖ มี.ค. ๒๕๔๕
ความสมสภาพ	bienséances, les	๖ มี.ค. ๒๕๔๕
ความหมายโดยตรง	denotation	๖ มี.ค. ๒๕๔๕
ความหมายโดยนัย	connotation	๖ มี.ค. ๒๕๔๕
ความหมายสี่ระดับ	four levels of meaning	๖ มี.ค. ๒๕๔๕
ความหมายสี่อย่าง	four meanings	๖ มี.ค. ๒๕๔๕
ความหายนะ	catastrophe	๖ มี.ค. ๒๕๔๕
ความสง่างาม	grace	๖ มี.ค. ๒๕๔๕
ความละม้ายจริง	verisimilitude	๖ มี.ค. ๒๕๔๕
ความไม่สืบเนื่อง	anacoluthon	๖ มี.ค. ๒๕๔๕
ความไม่ผสาน	affectation	๖ มี.ค. ๒๕๔๕
ความกำกวม	ambiguity	๖ มี.ค. ๒๕๔๕
ความกลมกลืนกัน; ความคงเส้นคงวา	consistency	๖ มี.ค. ๒๕๔๕
ความขัดแย้ง	conflict	๖ มี.ค. ๒๕๔๕
ความคงเส้นคงวา; ความกลมกลืนกัน	consistency	๖ มี.ค. ๒๕๔๕
ความนึกเปรียบเทียบ	conceit	๖ มี.ค. ๒๕๔๕
ความบันดาลใจ	inspiration	๖ มี.ค. ๒๕๔๕
ความผสาน	decorum	๖ มี.ค. ๒๕๔๕
ความผิดพลาดเหตุเจตนา	intentional fallacy	๖ มี.ค. ๒๕๔๕
ความผิดพลาดเหตุอารมณ์	pathetic fallacy	๖ มี.ค. ๒๕๔๕
ความผิดพลาดเหตุกระทบใจ	affective fallacy	๖ มี.ค. ๒๕๔๕
คัมภีร์ศักดิ์สิทธิ์	sacred books	๖ มี.ค. ๒๕๔๕
คำเหมาะสม	mot juste, le	๖ มี.ค. ๒๕๔๕
คำย้อนอักษร	ananym	๖ มี.ค. ๒๕๔๕
คำเตือนใจ	watchword	๖ มี.ค. ๒๕๔๕
คำโบราณ	archaism	๖ มี.ค. ๒๕๔๕
คำโต้กลับ	repartee	๖ มี.ค. ๒๕๔๕
คำสร้างใหม่	neologism	๖ มี.ค. ๒๕๔๕
คำสลับอักษร	anagram	๖ มี.ค. ๒๕๔๕
คำอวดภูมิ	malapropism	๖ มี.ค. ๒๕๔๕
คำขวัญ	slogan	๖ มี.ค. ๒๕๔๕
คำคม	bon mot, le; epigram	๖ มี.ค. ๒๕๔๕
คำจารึก; บุพวาทะ	epigraph	๖ มี.ค. ๒๕๔๕
คำซ้ำคั่น	epanalepsis	๖ มี.ค. ๒๕๔๕
คำตรงกันข้าม	antonym	๖ มี.ค. ๒๕๔๕
คำตรงความหมาย	mot propre, le	๖ มี.ค. ๒๕๔๕
คีตกานท์	lyric	๖ มี.ค. ๒๕๔๕
คาถา	gatha	๖ มี.ค. ๒๕๔๕
คำถามเชิงวาทศิลป์	rhetorical question	๖ มี.ค. ๒๕๔๕
คำทาย	riddle	๖ มี.ค. ๒๕๔๕
คำนำ	preface	๖ มี.ค. ๒๕๔๕
คำนิยม	foreword	๖ มี.ค. ๒๕๔๕
คำบริภาษ	invective	๖ มี.ค. ๒๕๔๕
คำประกาศเจตนา	manifesto	๖ มี.ค. ๒๕๔๕
คำประชดเหน็บแนม	sarcasm	๖ มี.ค. ๒๕๔๕
คำปราศรัย	address	๖ มี.ค. ๒๕๔๕
คำพ้องเสียง	homophone	๖ มี.ค. ๒๕๔๕
คำพ้องรูป	homograph	๖ มี.ค. ๒๕๔๕
คำพ้องรูปพ้องเสียง	homonym	๖ มี.ค. ๒๕๔๕
คำพังเพย	aphorism	๖ มี.ค. ๒๕๔๕
คลาสสิก, ตามแบบแผน	classical	๖ มี.ค. ๒๕๔๕
คลาสสิก; ตามแบบแผน, คลาสสิก	classic	๖ มี.ค. ๒๕๔๕
คลื่นลูกใหม่	nouvelle vague	๖ มี.ค. ๒๕๔๕
คณะ	foot; metrical foot	๖ มี.ค. ๒๕๔๕
คณะแอมฟิแบรก	amphibrach	๖ มี.ค. ๒๕๔๕
คณะแอนาเพสต์	anapest; anapaest; anapestic foot; anapaestic foot	๖ มี.ค. ๒๕๔๕
คณะแด็กทิล	dactyl; dactylic foot	๖ มี.ค. ๒๕๔๕
คณะโทรคี	trochee; trochaic foot	๖ มี.ค. ๒๕๔๕
คณะไอแอมบ์	iamb; iambic foot	๖ มี.ค. ๒๕๔๕
คณะสปอนดี	spondee; spondaic foot	๖ มี.ค. ๒๕๔๕
คณะพีออน	paeon; paeonic foot	๖ มี.ค. ๒๕๔๕
คติเหนือจริง	surrealism	๖ มี.ค. ๒๕๔๕
คติหยามโลก	cynicism	๖ มี.ค. ๒๕๔๕
คติสอนใจ	moral	๖ มี.ค. ๒๕๔๕
คติดาดา	dadaism	๖ มี.ค. ๒๕๔๕
คตินิยมเหนือเหตุผล	transcendentalism	๖ มี.ค. ๒๕๔๕
คตินิยมแบบแผน, คตินิยมคลาสสิก	classicism	๖ มี.ค. ๒๕๔๕
คตินิยมแบบเพลโต	Platonism	๖ มี.ค. ๒๕๔๕
คตินิยมแบบเพทราร์ก	Petrarchism	๖ มี.ค. ๒๕๔๕
คตินิยมสมัยกลาง	medievalism	๖ มี.ค. ๒๕๔๕
คตินิยมสำแดงพลังอารมณ์, เอกซเพรสชันนิซึม	expressionism	๖ มี.ค. ๒๕๔๕
คตินิยมออสเซียน	Ossianism	๖ มี.ค. ๒๕๔๕
คตินิยมคืนสู่แบบแผนเดิม, คตินิยมคลาสสิกใหม่	neoclassicism	๖ มี.ค. ๒๕๔๕
คตินิยมประทับใจ, อิมเพรสชันนิซึม	impressionism	๖ มี.ค. ๒๕๔๕
คติบท	maxim	๖ มี.ค. ๒๕๔๕
คติพจน์	motto	๖ มี.ค. ๒๕๔๕
คนเถื่อนใจธรรม	noble savage, the	๖ มี.ค. ๒๕๔๕
งานเขียนเพื่อเงิน	potboiler	๖ มี.ค. ๒๕๔๕
จริตนิยม	mannerism	๖ มี.ค. ๒๕๔๕
จอมโว	braggadocio	๖ มี.ค. ๒๕๔๕
จังหวะหยุด	caesura	๖ มี.ค. ๒๕๔๕
จังหวะลง	falling rhythm	๖ มี.ค. ๒๕๔๕
จังหวะขึ้น	rising rhythm	๖ มี.ค. ๒๕๔๕
จังหวะ	rhythm	๖ มี.ค. ๒๕๔๕
จารึกหลุมฝังศพ	epitaph	๖ มี.ค. ๒๕๔๕
จำอวด	droll	๖ มี.ค. ๒๕๔๕
จิตวิทยาเกสตัลต์	Gestalt psychology	๖ มี.ค. ๒๕๔๕
จินตภาพ; ภาพลักษณ์	image	๖ มี.ค. ๒๕๔๕
จินตนิยม	romanticism	๖ มี.ค. ๒๕๔๕
จินตนิมิต	fantasy	๖ มี.ค. ๒๕๔๕
จินตนาการ	imagination	๖ มี.ค. ๒๕๔๕
จดหมายเหตุ; หอจดหมายเหตุ	archives	๖ มี.ค. ๒๕๔๕
จตุรศิลปศาสตร์	quadrivium	๖ มี.ค. ๒๕๔๕
จุลสาร	pamphlet	๖ มี.ค. ๒๕๔๕
จุลอุปรากร	operretta	๖ มี.ค. ๒๕๔๕
จุดเร่งเร้า	inciting moment	๖ มี.ค. ๒๕๔๕
จุดวิกฤต	crisis	๖ มี.ค. ๒๕๔๕
จุดสุดยอด	climax	๖ มี.ค. ๒๕๔๕
ฉันทลักษณ์	prosody	๖ มี.ค. ๒๕๔๕
ฉันทลักษณ์พินิจ	scansion	๖ มี.ค. ๒๕๔๕
ฉายา	epithet	๖ มี.ค. ๒๕๔๕
ฉายาแบบโฮเมอร์	Homeric epithet	๖ มี.ค. ๒๕๔๕
ฉาก	scene	๖ มี.ค. ๒๕๔๕
ฉากภาพนิ่ง	tableau	๖ มี.ค. ๒๕๔๕
ฉากจำเป็น	obligatory scene	๖ มี.ค. ๒๕๔๕
ฉากท้องเรื่อง	setting	๖ มี.ค. ๒๕๔๕
ฉบับย่อ	digest	๖ มี.ค. ๒๕๔๕
ฉบับมีนัยวิเคราะห์	variorum edition	๖ มี.ค. ๒๕๔๕
ฉบับเคลือบแคลง	apocrypha	๖ มี.ค. ๒๕๔๕
ฉบับแท้	canon	๖ มี.ค. ๒๕๔๕
ฉบับไม่ตัดย่อ	unabridged edition	๖ มี.ค. ๒๕๔๕
ฉบับง่าย	simplified edition	๖ มี.ค. ๒๕๔๕
ฉบับตัดย่อ	abridged edition	๖ มี.ค. ๒๕๔๕
ชะตาผกผัน	reversal	๖ มี.ค. ๒๕๔๕
ช่วงหยุด	pause	๖ มี.ค. ๒๕๔๕
ช่วงระทึกใจสุดท้าย	moment of last suspense	๖ มี.ค. ๒๕๔๕
ชีวประวัตินักบุญ	hagiography	๖ มี.ค. ๒๕๔๕
ชนบทพรรณนา	idyl; idyll	๖ มี.ค. ๒๕๔๕
ชื่อเรื่องจากอัญพจน์	quotation titles	๖ มี.ค. ๒๕๔๕
ชุดมหากาพย์	epic cycle	๖ มี.ค. ๒๕๔๕
ชุดสามเรื่อง	trilogy	๖ มี.ค. ๒๕๔๕
ชุดสี่เรื่อง	tetralogy	๖ มี.ค. ๒๕๔๕
ชุดสี่เรื่อง; บทสี่บาท	quartet	๖ มี.ค. ๒๕๔๕
ชุดละครรหัสธรรม	mystery cycle	๖ มี.ค. ๒๕๔๕
ชุดบทร้อยกรองซอนเนต	sonnet cycle	๖ มี.ค. ๒๕๔๕
ซาลง, เสวนาสโมสร	salon	๖ มี.ค. ๒๕๔๕
ซิตคอม	sitcom	๖ มี.ค. ๒๕๔๕
ต้นแบบดั้งเดิม	archetype	๖ มี.ค. ๒๕๔๕
ต้นฉบับ; เอกสารตัวเขียน	manuscript	๖ มี.ค. ๒๕๔๕
ตอน	episode	๖ มี.ค. ๒๕๔๕
ตัวเอก	protagonist	๖ มี.ค. ๒๕๔๕
ตัวเอกปฏิลักษณ์	anti-hero	๖ มี.ค. ๒๕๔๕
ตัวเกริ่นเรื่อง	protatic character	๖ มี.ค. ๒๕๔๕
ตัวโกง	villain	๖ มี.ค. ๒๕๔๕
ตัวละครมิติเดียว	flat character	๖ มี.ค. ๒๕๔๕
ตัวละครเข้าแบบ	stock character	๖ มี.ค. ๒๕๔๕
ตัวละครแบบฮาร์เลควิน	Harlequin	๖ มี.ค. ๒๕๔๕
ตัวละครแบบไมลส์กลอริโอซัส	Miles Gloriosus	๖ มี.ค. ๒๕๔๕
ตัวละครหลายมิติ	round character	๖ มี.ค. ๒๕๔๕
ตัวละครทุศีล, ตัวละครแบบมาเคียเวลลี	Machiavel	๖ มี.ค. ๒๕๔๕
ตัวตลกแพนทาลูน	pantaloon	๖ มี.ค. ๒๕๔๕
ตัวบรรยายเรื่อง	persona	๖ มี.ค. ๒๕๔๕
ตัดทอน	bowdlerize	๖ มี.ค. ๒๕๔๕
ตามแบบแผน, คลาสสิก	classical	๖ มี.ค. ๒๕๔๕
ตามแบบแผน, คลาสสิก; คลาสสิก	classic	๖ มี.ค. ๒๕๔๕
ตามต้นฉบับ	sic	๖ มี.ค. ๒๕๔๕
ตำนาน	legend	๖ มี.ค. ๒๕๔๕
ถ้อยถากถาง	lampoon	๖ มี.ค. ๒๕๔๕
ท้ายบาทเน้น	masculine ending	๖ มี.ค. ๒๕๔๕
ท้ายบาทเบา	weak ending	๖ มี.ค. ๒๕๔๕
ท้ายบาทไม่เน้น	feminine ending	๖ มี.ค. ๒๕๔๕
ธรรมชาตินิยม	naturalism	๖ มี.ค. ๒๕๔๕
ธาตุเหลว	humours	๖ มี.ค. ๒๕๔๕
นวนิยาย	novel	๖ มี.ค. ๒๕๔๕
นวนิยายเร้าอารมณ์	sentimental novel	๖ มี.ค. ๒๕๔๕
นวนิยายภูมิภาค	regional novel	๖ มี.ค. ๒๕๔๕
นวนิยายโฆษณาชวนเชื่อ	propaganda novel	๖ มี.ค. ๒๕๔๕
นวนิยายแนวใหม่	nouveau roman	๖ มี.ค. ๒๕๔๕
นวนิยายแฝงชีวิตจริง	key novel; livre à clef	๖ มี.ค. ๒๕๔๕
นวนิยายสั้น	short novel	๖ มี.ค. ๒๕๔๕
นวนิยายสารภาพ	confessional novel	๖ มี.ค. ๒๕๔๕
นวนิยายสิบสตางค์	dime novel; penny dreadful	๖ มี.ค. ๒๕๔๕
นวนิยายอิงเอกสาร	documentary novel	๖ มี.ค. ๒๕๔๕
นวนิยายอิงประวัติศาสตร์	historical novel	๖ มี.ค. ๒๕๔๕
นวนิยายลูกทุ่ง	novel of the soil	๖ มี.ค. ๒๕๔๕
นวนิยายกอทิก	Gothic novel	๖ มี.ค. ๒๕๔๕
นวนิยายกาลเวลา	time novel	๖ มี.ค. ๒๕๔๕
นวนิยายขนาดสั้น [อิตาลี]	novella	๖ มี.ค. ๒๕๔๕
นวนิยายขนาดสั้น [อังกฤษ]; เรื่องสั้น [ฝรั่งเศส]	novelette	๖ มี.ค. ๒๕๔๕
นวนิยายครบสูตร	well-made novel	๖ มี.ค. ๒๕๔๕
น้ำเสียง	tone; tone colour	๖ มี.ค. ๒๕๔๕
นวนิยายจิตวิทยา	psychological novel	๖ มี.ค. ๒๕๔๕
นวนิยายจดหมาย	epistolary novel	๖ มี.ค. ๒๕๔๕
นวนิยายชีวิตเสเพล	picaresque novel	๖ มี.ค. ๒๕๔๕
นวนิยายชีวิตศิลปิน	Künstlerroman	๖ มี.ค. ๒๕๔๕
นวนิยายชุด	roman-fleuve	๖ มี.ค. ๒๕๔๕
นวนิยายซากา	saga novel	๖ มี.ค. ๒๕๔๕
นวนิยายปัญหา	problem novel; thesis novel	๖ มี.ค. ๒๕๔๕
นวนิยายปฏิลักษณ์	anti-novel	๖ มี.ค. ๒๕๔๕
นอกกฎ	asyntactic	๖ มี.ค. ๒๕๔๕
นัยวิเคราะห์	exegesis	๖ มี.ค. ๒๕๔๕
นัยประหวัด	association	๖ มี.ค. ๒๕๔๕
นัยประหวัดอิสระ	free association	๖ มี.ค. ๒๕๔๕
นักร้องหมู่	chorus	๖ มี.ค. ๒๕๔๕
นักแสดงสัญจร	jongleur	๖ มี.ค. ๒๕๔๕
นักเขียนกำบัง, นักเขียนผี	ghost writer	๖ มี.ค. ๒๕๔๕
นักขับลำตรูบาดูร์	troubadour	๖ มี.ค. ๒๕๔๕
นักขับลำ	minstrel	๖ มี.ค. ๒๕๔๕
นักขับลำสก็อป	scop	๖ มี.ค. ๒๕๔๕
นักขับลำสกอลด์	scald; skald	๖ มี.ค. ๒๕๔๕
นักขับลำกูสลาร์	guslar	๖ มี.ค. ๒๕๔๕
นักขับลำกลีแมน	gleeman	๖ มี.ค. ๒๕๔๕
นักขับลำตรูแวร์	trouvére	๖ มี.ค. ๒๕๔๕
นามแฝง	pseudonym	๖ มี.ค. ๒๕๔๕
นามยืม	allonym	๖ มี.ค. ๒๕๔๕
นิยายวีรคติ, นิยายโรมานซ์	romance	๖ มี.ค. ๒๕๔๕
นิยายวีรคติร้อยกรอง, นิยายโรมานซ์ร้อยกรอง	metrical romance	๖ มี.ค. ๒๕๔๕
นิยายวีรคติสมัยกลาง, นิยายโรมานซ์สมัยกลาง	medieval romance	๖ มี.ค. ๒๕๔๕
นิยายซากา	saga	๖ มี.ค. ๒๕๔๕
นามาวลี	catalogue verse	๖ มี.ค. ๒๕๔๕
นามลักษณ์	aptronym	๖ มี.ค. ๒๕๔๕
นามนัย	metonymy	๖ มี.ค. ๒๕๔๕
นิรนาม	anonymous	๖ มี.ค. ๒๕๔๕
นามธรรม; บทคัดย่อ	abstract	๖ มี.ค. ๒๕๔๕
นามปากกา	nom de plume; pen name	๖ มี.ค. ๒๕๔๕
นางเอก; วีรสตรี	heroine	๖ มี.ค. ๒๕๔๕
นาฏยะ	natya	๖ มี.ค. ๒๕๔๕
นาฏยนิยม	theatricalism	๖ มี.ค. ๒๕๔๕
นาฏกรรม, ละคร	drama	๖ มี.ค. ๒๕๔๕
นาฏกรรมวีรบุรุษ	heroic drama	๖ มี.ค. ๒๕๔๕
นิตยสาร	magazine	๖ มี.ค. ๒๕๔๕
นิทาน	conte; tale	๖ มี.ค. ๒๕๔๕
นิทานเหลือเชื่อ	tall tale	๖ มี.ค. ๒๕๔๕
นิทานศรัทธา	conte dévot	๖ มี.ค. ๒๕๔๕
นิทานอุทาหรณ์	apologue; fable	๖ มี.ค. ๒๕๔๕
นิทานคติสอนใจ	parable	๖ มี.ค. ๒๕๔๕
นิทานชาวบ้าน	folk tale; Märchen	๖ มี.ค. ๒๕๔๕
นิทานนิทัศน์	exemplum	๖ มี.ค. ๒๕๔๕
นิทานฟาบลีโย [ฟา-บฺลีโย]	fabliau	๖ มี.ค. ๒๕๔๕
บรรยากาศแห่งจิต	atmosphere of the mind	๖ มี.ค. ๒๕๔๕
นพเทวีแห่งศิลปศาสตร์	Muses	๖ มี.ค. ๒๕๔๕
บรรยากาศ	atmosphere	๖ มี.ค. ๒๕๔๕
บรรณพิลาส	vignette	๖ มี.ค. ๒๕๔๕
บรรพ, กัณฑ์	canto	๖ มี.ค. ๒๕๔๕
บรรพกาลนิยม	primitivism	๖ มี.ค. ๒๕๔๕
บรรพกาลนิยมเชิงวัฒนธรรม	cultural primitivism	๖ มี.ค. ๒๕๔๕
บรรพกาลนิยมเชิงประวัติศาสตร์	chronological primitivism	๖ มี.ค. ๒๕๔๕
บันทึกเหตุการณ์	chronicle	๖ มี.ค. ๒๕๔๕
บันเทิงคดี	fiction	๖ มี.ค. ๒๕๔๕
บันเทิงคดีเกาะร้าง	desert island fiction	๖ มี.ค. ๒๕๔๕
บันเทิงคดีแนววิทยาศาสตร์	science fiction	๖ มี.ค. ๒๕๔๕
บันทึกความทรงจำ	memoirs	๖ มี.ค. ๒๕๔๕
บันทึกประจำวัน; วารสาร	journal	๖ มี.ค. ๒๕๔๕
บาทไร้หัว	acephalous; headless line	๖ มี.ค. ๒๕๔๕
บาทไม่จบความ	run-on line	๖ มี.ค. ๒๕๔๕
บาทจบความ	end-stopped line	๖ มี.ค. ๒๕๔๕
บาท	line	๖ มี.ค. ๒๕๔๕
บาทแปดพยางค์	octosyllabic line	๖ มี.ค. ๒๕๔๕
บาทวีรกรรม, บาทฮิโรอิก	heroic line	๖ มี.ค. ๒๕๔๕
บาทสิบเอ็ดพยางค์	hendecasyllabic line	๖ มี.ค. ๒๕๔๕
บท	stanza	๖ มี.ค. ๒๕๔๕
บทเสริมเรื่อง	excursus	๖ มี.ค. ๒๕๔๕
บทย่อ	précis, le	๖ มี.ค. ๒๕๔๕
บทร้อยกรอง	verse	๖ มี.ค. ๒๕๔๕
บทร้อยกรอง; เพลงร้อง, เพลง	song	๖ มี.ค. ๒๕๔๕
บทร้อยกรองโมเสก; บทร้อยกรองประสม	mosaic verse	๖ มี.ค. ๒๕๔๕
บทร้อยกรองภาษิต	gnomic verse	๖ มี.ค. ๒๕๔๕
บทร้อยกรองรูปธรรม	concrete verse	๖ มี.ค. ๒๕๔๕
บทร้อยกรองเคลริฮิว	clerihew	๖ มี.ค. ๒๕๔๕
บทร้อยกรองรงโด	rondeau	๖ มี.ค. ๒๕๔๕
บทร้อยกรองเฉพาะโอกาส	occasional verse	๖ มี.ค. ๒๕๔๕
บทร้อยกรองเซอร์เพนไทน์	serpentine verse	๖ มี.ค. ๒๕๔๕
บทร้อยกรองเบาสมอง	light verse	๖ มี.ค. ๒๕๔๕
บทร้อยกรองแบบฝรั่งเศสเก่าและแบบโปรวองซาล	Old French and Provençal form	๖ มี.ค. ๒๕๔๕
บทร้อยกรองวีรกรรม, บทร้อยกรองฮิโรอิก	heroic verse	๖ มี.ค. ๒๕๔๕
บทร้อยกรองวิลลาแนล	villanelle	๖ มี.ค. ๒๕๔๕
บทร้อยกรองวงสังคม	vers de société	๖ มี.ค. ๒๕๔๕
บทร้อยกรองฉลองวิวาห์	prothalamion	๖ มี.ค. ๒๕๔๕
บทร้อยกรองชนบท	eclouge	๖ มี.ค. ๒๕๔๕
บทร้อยกรองซอนเนต	sonnet	๖ มี.ค. ๒๕๔๕
บทร้อยกรองซอนเนตแบบเชกสเปียร์	Shakespearian sonnet	๖ มี.ค. ๒๕๔๕
บทร้อยกรองซอนเนตแบบเพทราร์ก	Petrarchan sonnet	๖ มี.ค. ๒๕๔๕
บทร้อยกรองซอนเนตแบบสเปนเซอร์	Spenserian sonnet	๖ มี.ค. ๒๕๔๕
บทร้อยกรองด้อยศิลป์	doggerel	๖ มี.ค. ๒๕๔๕
บทร้อยกรองตรีโอเล	triolet	๖ มี.ค. ๒๕๔๕
บทร้อยกรองท้องทุ่ง	bucolic; pastoral	๖ มี.ค. ๒๕๔๕
บทร้อยกรองนาไร่	georgic	๖ มี.ค. ๒๕๔๕
บทร้อยกรองสหสัมพัทธ์	correlative verse	๖ มี.ค. ๒๕๔๕
บทร้อยกรองสัมผัสอักษร	alliterative verse	๖ มี.ค. ๒๕๔๕
บทร้อยกรองสำหรับเด็ก	nursery rhyme	๖ มี.ค. ๒๕๔๕
บทร้อยกรองอะเล็กซันดรีน	alexandrine	๖ มี.ค. ๒๕๔๕
บทร้อยกรองฮิโรอิก, บทร้อยกรองวีรกรรม	heroic verse	๖ มี.ค. ๒๕๔๕
บทร้อยกรองอิสระ	free verse	๖ มี.ค. ๒๕๔๕
บทร้อยกรองลิเมอริก	limerick	๖ มี.ค. ๒๕๔๕
บทร้อยกรองกำสรด	elegy	๖ มี.ค. ๒๕๔๕
บทร้อยกรองคาซัล	ghazal; ghazel	๖ มี.ค. ๒๕๔๕
บทร้อยกรองจิงเกิล	jingle	๖ มี.ค. ๒๕๔๕
บทร้อยกรองบาลาด	ballade	๖ มี.ค. ๒๕๔๕
บทร้อยกรองประสม, บทร้อยกรองโมเสก	mosaic verse	๖ มี.ค. ๒๕๔๕
บทร้อยกรองปันตน	pantun	๖ มี.ค. ๒๕๔๕
บทร้อยกรองพิลาป	lament	๖ มี.ค. ๒๕๔๕
บทรำพึง	solioquy	๖ มี.ค. ๒๕๔๕
บทยกย่อง	eulogy	๖ มี.ค. ๒๕๔๕
บทโจมตี	polemic	๖ มี.ค. ๒๕๔๕
บทเจ็ดบาท	septet	๖ มี.ค. ๒๕๔๕
บทแถลง	apology; apologia	๖ มี.ค. ๒๕๔๕
บทเทศน์	sermon	๖ มี.ค. ๒๕๔๕
บทแบบสเปนเซอร์	Spenserian stanza	๖ มี.ค. ๒๕๔๕
บทเปิดเรื่อง; อรรถาธิบาย	exposition	๖ มี.ค. ๒๕๔๕
บทแปดบาท	octave; octet	๖ มี.ค. ๒๕๔๕
บทแปดบาทสัมผัส, ออตตาวารีมา	ottava rima	๖ มี.ค. ๒๕๔๕
บทเพิ่มเติม	addendum	๖ มี.ค. ๒๕๔๕
บทเพลงสมรสผิด	mal mariée, la	๖ มี.ค. ๒๕๔๕
บทวีรกรรม, บทฮิโรอิก	heroic stanza	๖ มี.ค. ๒๕๔๕
บทสรรเสริญ	encomium	๖ มี.ค. ๒๕๔๕
บทสโตรฟี	strophe	๖ มี.ค. ๒๕๔๕
บทห้าบาท	quintain; quintet	๖ มี.ค. ๒๕๔๕
บทสามบาท	tercet	๖ มี.ค. ๒๕๔๕
บทสามบาทสัมผัส, เทอร์ซารีมา	terza rima	๖ มี.ค. ๒๕๔๕
บทสี่บาท	quatrain	๖ มี.ค. ๒๕๔๕
บทกวีรูปแท่นบูชา	altar poem	๖ มี.ค. ๒๕๔๕
บทกวีสนทนา	conversation piece; conversation poem	๖ มี.ค. ๒๕๔๕
บทกวีไฮกุ	haiku	๖ มี.ค. ๒๕๔๕
บทกวีทังกะ	tanka	๖ มี.ค. ๒๕๔๕
บทกวีนามธรรม, สัทกานท์	abstract poem	๖ มี.ค. ๒๕๔๕
บทกำสรด	elegiac stanza	๖ มี.ค. ๒๕๔๕
บทกำกับเวที	stage directions	๖ มี.ค. ๒๕๔๕
บทสี่บาท; ชุดสี่เรื่อง	quartet	๖ มี.ค. ๒๕๔๕
บทสี่บาทวีรกรรม, บทสี่บาทฮิโรอิก	heroic quatrain	๖ มี.ค. ๒๕๔๕
บทหกบาท	sestet	๖ มี.ค. ๒๕๔๕
บทสดุดี	panegyric	๖ มี.ค. ๒๕๔๕
บทสนทนา	dialogue	๖ มี.ค. ๒๕๔๕
บทอภิปราย; สังเขปเรื่อง	argument	๖ มี.ค. ๒๕๔๕
บทอภิปรายแบบอ้าง	argumentum ad	๖ มี.ค. ๒๕๔๕
บทฮิโรอิก, บทวีรกรรม	heroic stanza	๖ มี.ค. ๒๕๔๕
บทฮิโรอิก, บาทวีรกรรม	heroic line	๖ มี.ค. ๒๕๔๕
บทละคร; ละคร	play	๖ มี.ค. ๒๕๔๕
บทละคร; ละคร, นาฏกรรม	drama	๖ มี.ค. ๒๕๔๕
บทละครแสดงเดี่ยว; ละครแสดงเดี่ยว	monodrama	๖ มี.ค. ๒๕๔๕
บทละครเพื่ออ่าน	closet drama	๖ มี.ค. ๒๕๔๕
บทละครครบสูตร	well-made play	๖ มี.ค. ๒๕๔๕
บทล้อไร้สาระ	amphigory	๖ มี.ค. ๒๕๔๕
บทกระทบอารมณ์, บทแรปโซดี	rhapsody	๖ มี.ค. ๒๕๔๕
บทกวี, โคลง	poem	๖ มี.ค. ๒๕๔๕
บทกวีเรื่องเล่า	narrative poem	๖ มี.ค. ๒๕๔๕
บทกวีร้อยแก้ว	prose poem	๖ มี.ค. ๒๕๔๕
บทกวีโอ้อวด	boasting poem	๖ มี.ค. ๒๕๔๕
บทขับลำ	lai; lay	๖ มี.ค. ๒๕๔๕
บทความ	article	๖ มี.ค. ๒๕๔๕
บทคัดย่อ; นามธรรม	abstract	๖ มี.ค. ๒๕๔๕
บทจดหมาย, เพลงยาว	epistle	๖ มี.ค. ๒๕๔๕
บทชมโฉม	blason; blazon	๖ มี.ค. ๒๕๔๕
บทตัดต่อ	cento	๖ มี.ค. ๒๕๔๕
บทตลกคลายเครียด	comic relief	๖ มี.ค. ๒๕๔๕
บทนำ	introduction	๖ มี.ค. ๒๕๔๕
บทบิดลิ้น	tongue twister	๖ มี.ค. ๒๕๔๕
บทปริทัศน์	review	๖ มี.ค. ๒๕๔๕
บทพูดเดี่ยว	monologue	๖ มี.ค. ๒๕๔๕
บทพูดเดี่ยวเชิงละคร	dramatic monologue	๖ มี.ค. ๒๕๔๕
บทพูดเดี่ยวในใจ	interior monologue	๖ มี.ค. ๒๕๔๕
บุคลิกวรรณนา	character, the	๖ มี.ค. ๒๕๔๕
บุคลาธิษฐาน, บุคคลวัต	personification	๖ มี.ค. ๒๕๔๕
บุพวาทะ; คำจารึก	epigraph	๖ มี.ค. ๒๕๔๕
ปรวิสัย	objectivity	๖ มี.ค. ๒๕๔๕
ประเภท(วรรณกรรม)	genre	๖ มี.ค. ๒๕๔๕
ประเภท(วรรณกรรม)	genre	๖ มี.ค. ๒๕๔๕
ประมวลเรื่องปรัมปรา; ปรัมปราวิทยา	mythology	๖ มี.ค. ๒๕๔๕
ประเพณีมุขปาฐะ; วรรณกรรมมุขปาฐะ	oral tradition	๖ มี.ค. ๒๕๔๕
ประชุมเรื่องผจญภัย	gesta	๖ มี.ค. ๒๕๔๕
ประชุมเอกสารัตถ์	symposium	๖ มี.ค. ๒๕๔๕
ประชุมบทนิพนธ์	anthology	๖ มี.ค. ๒๕๔๕
ประณามบท	invocation	๖ มี.ค. ๒๕๔๕
ปัจฉิมกถา, ปัจฉิมบท	epilogue	๖ มี.ค. ๒๕๔๕
ปกิณกคดี	analects	๖ มี.ค. ๒๕๔๕
ปกิณกนิพนธ์	miscellany	๖ มี.ค. ๒๕๔๕
ปฏิภาณ	wit	๖ มี.ค. ๒๕๔๕
ปฏิวลี	antiphrasis	๖ มี.ค. ๒๕๔๕
ปฏิทรรศน์	paradox	๖ มี.ค. ๒๕๔๕
ปฏิบท	anticlimax	๖ มี.ค. ๒๕๔๕
ปฏิปักษ์	antagonist	๖ มี.ค. ๒๕๔๕
ปฏิพจน์	oxymoron	๖ มี.ค. ๒๕๔๕
ปุจฉามหากาพย์	epic question	๖ มี.ค. ๒๕๔๕
ผู้เล่าเรื่อง	narrator	๖ มี.ค. ๒๕๔๕
ผู้แจ้งข่าว	messenger	๖ มี.ค. ๒๕๔๕
พระเอก; วีรบุรุษ	hero	๖ มี.ค. ๒๕๔๕
พยางค์เน้น; การเน้นพยางค์	accent; stress	๖ มี.ค. ๒๕๔๕
พยางค์เน้นสลับที่	wrenched accent	๖ มี.ค. ๒๕๔๕
พยางค์ไม่เน้น	unaccented syllable; unstressed syllable	๖ มี.ค. ๒๕๔๕
พวกฟิลิสไทน์	Philistine	๖ มี.ค. ๒๕๔๕
พันทาง	hybrid	๖ มี.ค. ๒๕๔๕
พันธสัญญา; วรรณกรรมเจตจำนง	testament	๖ มี.ค. ๒๕๔๕
พีระมิดของไฟรทาก	Freytag’s pyramid	๖ มี.ค. ๒๕๔๕
พลังฝีมือ	tour de force	๖ มี.ค. ๒๕๔๕
