a deux crayon	ภาพถ่านแท่งทวิรงค์	๑๑ มี.ค. ๒๕๔๕
ใยแก้ว	fiberglass	๑๑ มี.ค. ๒๕๔๕
โรโกโก	rococo	๑๑ มี.ค. ๒๕๔๕
แม่แบบ, กระสวน	pattern	๑๑ มี.ค. ๒๕๔๕
แม่บท	motif	๑๑ มี.ค. ๒๕๔๕
แม่พิมพ์ยกเลิก	cancelled plate	๑๑ มี.ค. ๒๕๔๕
แม่พิมพ์หลัก	key block	๑๑ มี.ค. ๒๕๔๕
แม่พิมพ์ไม้ตัดตามขวาง	end-grain block	๑๑ มี.ค. ๒๕๔๕
แม่พิมพ์ชิ้น	piece mould	๑๑ มี.ค. ๒๕๔๕
แม่พิมพ์ทุบ	waste mould	๑๑ มี.ค. ๒๕๔๕
แม่พิมพ์ผ้าไหม	silk screen	๑๑ มี.ค. ๒๕๔๕
โรงทอพรมโบเว	Beauvais	๑๑ มี.ค. ๒๕๔๕
รมณียภาวะ	amenity	๑๑ มี.ค. ๒๕๔๕
มโนทัศนศิลป์	conceptual art	๑๑ มี.ค. ๒๕๔๕
เรืองรอง	luminous	๑๑ มี.ค. ๒๕๔๕
abacus	แป้นหัวเสา	๑๑ มี.ค. ๒๕๔๕
abbozzo	๑. ภาพร่าง<br/>๒. รูปโกลน	๑๑ มี.ค. ๒๕๔๕
ABC art	ศิลปะเบื้องต้น	๑๑ มี.ค. ๒๕๔๕
absorbent ground	พื้นซับสี	๑๑ มี.ค. ๒๕๔๕
abstract illusionism	คติลวงตานามธรรม	๑๑ มี.ค. ๒๕๔๕
abstract image painting	จิตรกรรมจินตภาพนามธรรม	๑๑ มี.ค. ๒๕๔๕
"<font class=""europe"">Abstraction-Création</font>"	อับสตรักซียง-เกรอาซียง	๑๑ มี.ค. ๒๕๔๕
abstract art	ศิลปะนามธรรม	๑๑ มี.ค. ๒๕๔๕
abstract expressionism	ลัทธิสำแดงพลังอารมณ์แนวนามธรรม	๑๑ มี.ค. ๒๕๔๕
academy figure	รูปคนตามหลักวิชา	๑๑ มี.ค. ๒๕๔๕
academy of art	สำนักศิลปะ	๑๑ มี.ค. ๒๕๔๕
academic art	ศิลปะตามหลักวิชา	๑๑ มี.ค. ๒๕๔๕
academicism	คตินิยมวิชาการ	๑๑ มี.ค. ๒๕๔๕
acanthus	ลายใบอะแคนทัส	๑๑ มี.ค. ๒๕๔๕
accent	การเน้นให้เด่น	๑๑ มี.ค. ๒๕๔๕
accidental colour	สีอุบัติการณ์	๑๑ มี.ค. ๒๕๔๕
accidental light	แสงอุบัติการณ์	๑๑ มี.ค. ๒๕๔๕
accordion door	บานเฟี้ยม	๑๑ มี.ค. ๒๕๔๕
acid resist	สารกันกรด	๑๑ มี.ค. ๒๕๔๕
acid bath	อ่างแช่กรด	๑๑ มี.ค. ๒๕๔๕
achromatic colour	สีอรงค์	๑๑ มี.ค. ๒๕๔๕
acoustic board	แผ่นซับเสียง	๑๑ มี.ค. ๒๕๔๕
acropolis	อัครปุระ	๑๑ มี.ค. ๒๕๔๕
acroteria; acroterion	เครื่องประดับมุมจั่ว	๑๑ มี.ค. ๒๕๔๕
acroterion; acroteria	เครื่องประดับมุมจั่ว	๑๑ มี.ค. ๒๕๔๕
acrylic canvas	ผ้าใบอะคริลิก	๑๑ มี.ค. ๒๕๔๕
action painting	กัมมันตจิตรกรรม	๑๑ มี.ค. ๒๕๔๕
ระเบียงฉันนบถ	cloister	๑๑ มี.ค. ๒๕๔๕
Adoration of the Magi	ภาพนักปราชญ์สักการะ	๑๑ มี.ค. ๒๕๔๕
Adoration of the Shepherds	ภาพคนเลี้ยงแกะสักการะ	๑๑ มี.ค. ๒๕๔๕
adornment	การประดับ	๑๑ มี.ค. ๒๕๔๕
adobe	๑. อิฐดิบ<br/>๒. อาคารอิฐดิบ	๑๑ มี.ค. ๒๕๔๕
advancing colour	สีใกล้	๑๑ มี.ค. ๒๕๔๕
ระดับสี	key	๑๑ มี.ค. ๒๕๔๕
ระดับอ่อนสี	tint	๑๑ มี.ค. ๒๕๔๕
ระดับคล้ำสี	shade	๑๑ มี.ค. ๒๕๔๕
ระบบมันเซลล์	Munsell system	๑๑ มี.ค. ๒๕๔๕
ร่วมสมัย	contemporary	๑๑ มี.ค. ๒๕๔๕
aedicula	ซุ้มบูชา	๑๑ มี.ค. ๒๕๔๕
เส้นแกน	axis	๑๑ มี.ค. ๒๕๔๕
เส้นกั้นสี	cloison	๑๑ มี.ค. ๒๕๔๕
เสา	column	๑๑ มี.ค. ๒๕๔๕
เสาแนบ	engaged column	๑๑ มี.ค. ๒๕๔๕
เสาอิง	pilaster	๑๑ มี.ค. ๒๕๔๕
ม้านั่งยาว	bench	๑๑ มี.ค. ๒๕๔๕
ม้านั่งเดี่ยว	stool	๑๑ มี.ค. ๒๕๔๕
เสานาวิกชัย	rostral column	๑๑ มี.ค. ๒๕๔๕
ม้านวมยาว	divan	๑๑ มี.ค. ๒๕๔๕
aerial perspective	ทัศนมิติเชิงอากาศ	๑๑ มี.ค. ๒๕๔๕
aesthetic	สุนทรีย์	๑๑ มี.ค. ๒๕๔๕
aesthetics	สุนทรียศาสตร์	๑๑ มี.ค. ๒๕๔๕
แสงอุบัติการณ์	accidental light	๑๑ มี.ค. ๒๕๔๕
African art	ศิลปะแอฟริกา	๑๑ มี.ค. ๒๕๔๕
after	ตามแบบอย่าง	๑๑ มี.ค. ๒๕๔๕
agalmatolite	หินตุ๊กตาจีน	๑๑ มี.ค. ๒๕๔๕
aghkandware	อาก์คันด์แวร์	๑๑ มี.ค. ๒๕๔๕
รอยกดร้อน	hot pressed (H.P.)	๑๑ มี.ค. ๒๕๔๕
รอยขูดขีดเขียน	graffiti	๑๑ มี.ค. ๒๕๔๕
รอยคร่ำ	patina	๑๑ มี.ค. ๒๕๔๕
รอยกรดกัด	biting	๑๑ มี.ค. ๒๕๔๕
รอยกรดกัดเปรอะ	foul biting	๑๑ มี.ค. ๒๕๔๕
รอยกรดกัดทะลุ	open bite	๑๑ มี.ค. ๒๕๔๕
รอยด้าน	bloom	๑๑ มี.ค. ๒๕๔๕
รอยพิมพ์	impression	๑๑ มี.ค. ๒๕๔๕
รอยพู่กันปัด	dragging stroke	๑๑ มี.ค. ๒๕๔๕
แอ่งกรดกัด	"<font class=""europe"">crevé</font>"	๑๑ มี.ค. ๒๕๔๕
air brush	พู่กันลม	๑๑ มี.ค. ๒๕๔๕
aisle	ช่องทางเดิน	๑๑ มี.ค. ๒๕๔๕
เอกรงค์	monochrome	๑๑ มี.ค. ๒๕๔๕
เอกรงค์เหลือง	cirage	๑๑ มี.ค. ๒๕๔๕
เอกรงค์เทา	grisaille	๑๑ มี.ค. ๒๕๔๕
เอกรงค์น้อยระดับ	camaieu	๑๑ มี.ค. ๒๕๔๕
โอจี	ogee(OG)	๑๑ มี.ค. ๒๕๔๕
เอชพี	H.P. (hot pressed)	๑๑ มี.ค. ๒๕๔๕
รอด, ตง, รา	joist	๑๑ มี.ค. ๒๕๔๕
แอตแลนทีส	atlantes	๑๑ มี.ค. ๒๕๔๕
Ajanta Cave painting	จิตรกรรมถ้ำอชันตา	๑๑ มี.ค. ๒๕๔๕
alabaster	หินอะลาบาสเตอร์	๑๑ มี.ค. ๒๕๔๕
alabastron	ขวดอะลาบาสตรอน	๑๑ มี.ค. ๒๕๔๕
alkaline glaze	การเคลือบด่าง	๑๑ มี.ค. ๒๕๔๕
all-over painting	จิตรกรรมเต็มผืน	๑๑ มี.ค. ๒๕๔๕
alla prima; au premier coup; direct painting	การระบายสีโดยตรง	๑๑ มี.ค. ๒๕๔๕
allegory	อุปมานิทัศน์	๑๑ มี.ค. ๒๕๔๕
alloy	โลหะเจือ	๑๑ มี.ค. ๒๕๔๕
Altamira Cave painting	จิตรกรรมถ้ำอัลตามีรา	๑๑ มี.ค. ๒๕๔๕
altar	แท่นบูชา	๑๑ มี.ค. ๒๕๔๕
altarpiece	ฉากประดับแท่นบูชา	๑๑ มี.ค. ๒๕๔๕
alto-rilievo; deep-relief; high relief	รูปนูนสูง	๑๑ มี.ค. ๒๕๔๕
aluminium paint	สีอะลูมิเนียม	๑๑ มี.ค. ๒๕๔๕
Amarna art	ศิลปะอะมาร์นา	๑๑ มี.ค. ๒๕๔๕
American abstract artists	กลุ่มศิลปินอเมริกันแนวนามธรรม	๑๑ มี.ค. ๒๕๔๕
American Gothic	กอทิกแบบอเมริกัน	๑๑ มี.ค. ๒๕๔๕
American scene painting	จิตรกรรมชีวิตอเมริกัน	๑๑ มี.ค. ๒๕๔๕
amenity	รมณียภาวะ	๑๑ มี.ค. ๒๕๔๕
amorino	เปมเทพ [เป-มะ-เทบ], อะมอริโน	๑๑ มี.ค. ๒๕๔๕
amphitheatre	ทวิอัฒจันทร์	๑๑ มี.ค. ๒๕๔๕
anaglyph	ลายนูน	๑๑ มี.ค. ๒๕๔๕
analytical cubism	บาศกนิยมแบบวิเคราะห์	๑๑ มี.ค. ๒๕๔๕
anamorphosis	ภาพเพี้ยน	๑๑ มี.ค. ๒๕๔๕
anastatic printing	กลวิธีพิมพ์กัดกรดส่วนนูน	๑๑ มี.ค. ๒๕๔๕
anatomy	กายวิภาคศาสตร์	๑๑ มี.ค. ๒๕๔๕
ancient	โบราณ	๑๑ มี.ค. ๒๕๔๕
รั้วพุทธสถาน	Buddhist railing	๑๑ มี.ค. ๒๕๔๕
รัศมี	aureole	๑๑ มี.ค. ๒๕๔๕
angel	ทูตสวรรค์, เทวทูต, นางฟ้า	๑๑ มี.ค. ๒๕๔๕
animal interlace	ลายสัตว์กระหวัด	๑๑ มี.ค. ๒๕๔๕
animal style	กระบวนแบบรูปสัตว์	๑๑ มี.ค. ๒๕๔๕
animism	วิญญาณนิยม	๑๑ มี.ค. ๒๕๔๕
ankh	อังก์	๑๑ มี.ค. ๒๕๔๕
Annunciation	ภาพการแจ้งข่าวการปฏิสนธิ	๑๑ มี.ค. ๒๕๔๕
anodized aluminium	อะลูมิเนียมชุบผิว	๑๑ มี.ค. ๒๕๔๕
anteroom	ห้องพักรอ	๑๑ มี.ค. ๒๕๔๕
anti-form	ปฏิลักษณ์	๑๑ มี.ค. ๒๕๔๕
anti-art	ปฏิศิลป์	๑๑ มี.ค. ๒๕๔๕
antic work	งานพิลึก	๑๑ มี.ค. ๒๕๔๕
antimony	พลวง	๑๑ มี.ค. ๒๕๔๕
antique	โบราณวัตถุ	๑๑ มี.ค. ๒๕๔๕
มัณฑนศิลป์	decorative art	๑๑ มี.ค. ๒๕๔๕
มัดหมี่	ikat	๑๑ มี.ค. ๒๕๔๕
มัดหมี่สองทาง	double ikat	๑๑ มี.ค. ๒๕๔๕
มัดหมี่ด้ายยืน	warp ikat	๑๑ มี.ค. ๒๕๔๕
มัดหมี่ด้ายพุ่ง	weft ikat	๑๑ มี.ค. ๒๕๔๕
รา, ตง, รอด	joist	๑๑ มี.ค. ๒๕๔๕
ภายลายปรุ	cartoon	๑๑ มี.ค. ๒๕๔๕
ภาวะอัตโนมัติ	automatism	๑๑ มี.ค. ๒๕๔๕
ยางแอสฟัลต์	asphalt	๑๑ มี.ค. ๒๕๔๕
รางแขวนภาพ	picture rail	๑๑ มี.ค. ๒๕๔๕
มิติกระดาษ	paper-dimension	๑๑ มี.ค. ๒๕๔๕
ภาพร่าง	abbozzo	๑๑ มี.ค. ๒๕๔๕
ภาพรอยพิมพ์	empreinte	๑๑ มี.ค. ๒๕๔๕
ภาพมองแหงน	sotto in su	๑๑ มี.ค. ๒๕๔๕
ภาพแม่พระ	Madonna	๑๑ มี.ค. ๒๕๔๕
ภาพเงาทึบ	silhouette	๑๑ มี.ค. ๒๕๔๕
ภาพมณฑล	mandala	๑๑ มี.ค. ๒๕๔๕
ภาพโบเดกอน	"<font class=""europe"">bodegón</font>"	๑๑ มี.ค. ๒๕๔๕
ภาพเพี้ยน	anamorphosis	๑๑ มี.ค. ๒๕๔๕
ภาพรื่นรมย์หรูหรา	"<font class=""europe"">Fête galante</font>"	๑๑ มี.ค. ๒๕๔๕
ภาพวาดเส้น	drawing	๑๑ มี.ค. ๒๕๔๕
ภาพวาดเส้นไล้น้ำ	wash drawing	๑๑ มี.ค. ๒๕๔๕
ภาพสังสันทน์	conversation piece	๑๑ มี.ค. ๒๕๔๕
ภาพสีม่านหมอก	sfumato	๑๑ มี.ค. ๒๕๔๕
ภาพหลอกตา	trompe l’oeil	๑๑ มี.ค. ๒๕๔๕
ภาพสลัดสี	blot drawing	๑๑ มี.ค. ๒๕๔๕
ภาพหุ่นนิ่ง	still life	๑๑ มี.ค. ๒๕๔๕
ภาพอาหารเช้า	breakfast piece	๑๑ มี.ค. ๒๕๔๕
ภาพล้อ	caricature	๑๑ มี.ค. ๒๕๔๕
ภาพการแจ้งข่าวการปฏิสนธิ	Annunciation	๑๑ มี.ค. ๒๕๔๕
ภาพการรบ	battle-piece	๑๑ มี.ค. ๒๕๔๕
ภาพถ่านแท่งทวิรงค์	a deux crayon	๑๑ มี.ค. ๒๕๔๕
ภาพทิวทัศน์เมือง	townscape	๑๑ มี.ค. ๒๕๔๕
ภาพทิวทัศน์ทะเล	seascape	๑๑ มี.ค. ๒๕๔๕
ภาพทิวทัศน์บก	landscape	๑๑ มี.ค. ๒๕๔๕
ภาพทาบสี	decal; decalcomania	๑๑ มี.ค. ๒๕๔๕
ภาพนักปราชญ์สักการะ	Adoration of the Magi	๑๑ มี.ค. ๒๕๔๕
ภาพนางในฮาเร็ม	odalisque	๑๑ มี.ค. ๒๕๔๕
ภาพคนเลี้ยงแกะสักการะ	Adoration of the Shepherds	๑๑ มี.ค. ๒๕๔๕
ภาพชีวิตประจำวัน	genre painting	๑๑ มี.ค. ๒๕๔๕
ภาพประดับตู้	cabinet picture	๑๑ มี.ค. ๒๕๔๕
ภาพปริทัศน์	panorama	๑๑ มี.ค. ๒๕๔๕
ภาพปะกระดาษ	"<font class=""europe"">papier collé</font>"	๑๑ มี.ค. ๒๕๔๕
ภาพปะติด	collage	๑๑ มี.ค. ๒๕๔๕
ภาพปูนแห้ง	secco	๑๑ มี.ค. ๒๕๔๕
ภาพปูนเปียก	fresco	๑๑ มี.ค. ๒๕๔๕
ภาพผนังขูด	graffito; sgraffito	๑๑ มี.ค. ๒๕๔๕
ภาพผนังขูด	sgraffito; graffito	๑๑ มี.ค. ๒๕๔๕
ภาพพิมพ์เอกเลขน์	monographic	๑๑ มี.ค. ๒๕๔๕
ภาพพิมพ์มัชฌิมรงค์	mezzotint	๑๑ มี.ค. ๒๕๔๕
ภาพพิมพ์มัชฌิมรงค์อย่างสีน้ำ	aquatint mezzotint	๑๑ มี.ค. ๒๕๔๕
ภาพพิมพ์ยางแกะ	linocut	๑๑ มี.ค. ๒๕๔๕
ภาพพิมพ์โลหะ	metal graphic	๑๑ มี.ค. ๒๕๔๕
ภาพพิมพ์แกะลายเส้น	line engraving	๑๑ มี.ค. ๒๕๔๕
ภาพพิมพ์แกะลายปรุ	stipple engraving	๑๑ มี.ค. ๒๕๔๕
ภาพพิมพ์แกะไม้	woodcut	๑๑ มี.ค. ๒๕๔๕
ภาพพิมพ์แกะไม้ค่าต่างแสง	chiaroscuro woodcut	๑๑ มี.ค. ๒๕๔๕
ภาพพิมพ์แบบเขียนถ่าน	crayon engraving; crayon manner	๑๑ มี.ค. ๒๕๔๕
ภาพพิมพ์แบบเบะนิเอะ	beni-e	๑๑ มี.ค. ๒๕๔๕
ภาพพิมพ์แผ่นเดียว	monoprint; monotype	๑๑ มี.ค. ๒๕๔๕
ภาพพิมพ์สี	colour print	๑๑ มี.ค. ๒๕๔๕
ภาพพิมพ์สีลายฉลุ	pochoir	๑๑ มี.ค. ๒๕๔๕
ภาพพิมพ์อย่างสีน้ำ	aquatint	๑๑ มี.ค. ๒๕๔๕
ภาพพิมพ์ลายแกะ	engraving	๑๑ มี.ค. ๒๕๔๕
ภาพพิมพ์ลายแกะไม้	wood engraving	๑๑ มี.ค. ๒๕๔๕
ภาพพิมพ์ลายจุด	"<font class=""europe"">manière criblée</font>; dotted manner"	๑๑ มี.ค. ๒๕๔๕
ภาพพิมพ์กัดกรด	etching	๑๑ มี.ค. ๒๕๔๕
ภาพพิมพ์กัดกรดพื้นนิ่ม	soft-ground etching	๑๑ มี.ค. ๒๕๔๕
ภาพพิมพ์กดกระดาษ	paste print	๑๑ มี.ค. ๒๕๔๕
ภาพพิมพ์จารเข็ม	drypoint	๑๑ มี.ค. ๒๕๔๕
ภาพพิมพ์ต้นแบบ	original print	๑๑ มี.ค. ๒๕๔๕
ภาพพิมพ์ถ่ายกระจก	"<font class=""europe"">cliché-verre</font>; glass print"	๑๑ มี.ค. ๒๕๔๕
ภาพพิมพ์ผ้าไหม	silk screen	๑๑ มี.ค. ๒๕๔๕
ภาพพิสูจน์แม่พิมพ์	counter proof	๑๑ มี.ค. ๒๕๔๕
ภาพพิสูจน์ของศิลปิน	artist’s proof	๑๑ มี.ค. ๒๕๔๕
apartment; flat	ห้องชุด	๑๑ มี.ค. ๒๕๔๕
applied art	ศิลปะประยุกต์	๑๑ มี.ค. ๒๕๔๕
"<font class=""europe"">appliqué</font>"	งานผ้าปะติด	๑๑ มี.ค. ๒๕๔๕
aquatint	๑. กลวิธีพิมพ์อย่างสีน้ำ<br/>๒. ภาพพิมพ์อย่างสีน้ำ	๑๑ มี.ค. ๒๕๔๕
aquatint mezzotint	๑. กลวิธีพิมพ์มัชฌิมรงค์อย่างสีน้ำ<br/>๒. ภาพพิมพ์มัชฌิมรงค์อย่างสีน้ำ	๑๑ มี.ค. ๒๕๔๕
aqueduct	ลำรางส่งน้ำ	๑๑ มี.ค. ๒๕๔๕
apse	มุขโค้งด้านสกัด	๑๑ มี.ค. ๒๕๔๕
arabesque	ลายอะราเบสก์	๑๑ มี.ค. ๒๕๔๕
arcade	ฉันนบถ	๑๑ มี.ค. ๒๕๔๕
arch	ช่องโค้ง	๑๑ มี.ค. ๒๕๔๕
architectonic	สถาปัตยลักษณ์	๑๑ มี.ค. ๒๕๔๕
architecture	สถาปัตยกรรม	๑๑ มี.ค. ๒๕๔๕
architrave	๑. หน้ากระดานทับหลัง<br/>๒. บัวปิดแนววงกบ	๑๑ มี.ค. ๒๕๔๕
archaic	๑. ใกล้คลาสสิก<br/>๒. โบราณ	๑๑ มี.ค. ๒๕๔๕
Archaic period	สมัยอาร์เคอิก	๑๑ มี.ค. ๒๕๔๕
archaistic	เชิงโบราณ	๑๑ มี.ค. ๒๕๔๕
armature	โครงหุ่นปั้น	๑๑ มี.ค. ๒๕๔๕
armchair	เก้าอี้เท้าแขน	๑๑ มี.ค. ๒๕๔๕
arm palette	จานสีพาดแขน	๑๑ มี.ค. ๒๕๔๕
Armory Show	อาร์เมอรีโชว์	๑๑ มี.ค. ๒๕๔๕
art for art’s sake	ศิลปะเพื่อศิลปะ	๑๑ มี.ค. ๒๕๔๕
art informel	ศิลปะนอกแบบ	๑๑ มี.ค. ๒๕๔๕
art mobilier; furnishing art	สังหาริมศิลป์	๑๑ มี.ค. ๒๕๔๕
art nouveau; Jugendstil; modern style; modernista; noodle style; stile liberti	นวศิลป์	๑๑ มี.ค. ๒๕๔๕
arte povera; impoverished art	ศิลปะสมถะ	๑๑ มี.ค. ๒๕๔๕
artefact; artifact	สิ่งประดิษฐ์	๑๑ มี.ค. ๒๕๔๕
art	ศิลปะ	๑๑ มี.ค. ๒๕๔๕
art and craft	ศิลปหัตถกรรม	๑๑ มี.ค. ๒๕๔๕
Art and Craft Movement	ขบวนการศิลปหัตถกรรม	๑๑ มี.ค. ๒๕๔๕
art appreciation	ศิลปวิจักษณ์	๑๑ มี.ค. ๒๕๔๕
art brut	ศิลปะดิบ	๑๑ มี.ค. ๒๕๔๕
art criticism	ศิลปวิจารณ์	๑๑ มี.ค. ๒๕๔๕
art dealing	การค้างานศิลปะ	๑๑ มี.ค. ๒๕๔๕
art deco	อลังการศิลป์	๑๑ มี.ค. ๒๕๔๕
artifact; artefact	สิ่งประดิษฐ์	๑๑ มี.ค. ๒๕๔๕
artisan	ช่างศิลป์	๑๑ มี.ค. ๒๕๔๕
artist	ศิลปิน	๑๑ มี.ค. ๒๕๔๕
asbestos cement board	แผ่นใยหิน	๑๑ มี.ค. ๒๕๔๕
Artist’s Congress	สภาศิลปิน	๑๑ มี.ค. ๒๕๔๕
artist’s proof	ภาพพิสูจน์ของศิลปิน	๑๑ มี.ค. ๒๕๔๕
artistic anatomy	กายวิภาคทางศิลปะ	๑๑ มี.ค. ๒๕๔๕
artwork	งานศิลป์, อาร์ตเวิร์ก	๑๑ มี.ค. ๒๕๔๕
ash glaze	การเคลือบขี้เถ้า	๑๑ มี.ค. ๒๕๔๕
Ashcan school	สกุลศิลปะแอชแคน	๑๑ มี.ค. ๒๕๔๕
assemblage	การผสมผเส	๑๑ มี.ค. ๒๕๔๕
asphalt	ยางแอสฟัลต์	๑๑ มี.ค. ๒๕๔๕
associationism	สังยุกตนิยม	๑๑ มี.ค. ๒๕๔๕
asymmetry	อสมมาตร	๑๑ มี.ค. ๒๕๔๕
atelier	ห้องปฏิบัติงานศิลปะ	๑๑ มี.ค. ๒๕๔๕
atelier libre	ห้องปฏิบัติงานศิลปะเสรี	๑๑ มี.ค. ๒๕๔๕
atlantes	แอตแลนทีส	๑๑ มี.ค. ๒๕๔๕
atmospheric perspective	ทัศนมิติเชิงบรรยากาศ	๑๑ มี.ค. ๒๕๔๕
atrium	ลานกลางอาคาร	๑๑ มี.ค. ๒๕๔๕
attribute	คุณลักษณะ	๑๑ มี.ค. ๒๕๔๕
au premier coup; alla prima; direct painting	การระบายสีโดยตรง	๑๑ มี.ค. ๒๕๔๕
attribution	สิ่งบ่งชี้	๑๑ มี.ค. ๒๕๔๕
ภูมิศิลป์	earth art	๑๑ มี.ค. ๒๕๔๕
ภูมิลักษณ์, ลักษณะภูมิประเทศ	topography	๑๑ มี.ค. ๒๕๔๕
ภูมิทัศน์	landscape	๑๑ มี.ค. ๒๕๔๕
aureole	รัศมี	๑๑ มี.ค. ๒๕๔๕
Australian Aboriginal art	ศิลปะชนดั้งเดิมออสเตรเลีย	๑๑ มี.ค. ๒๕๔๕
auricular style	กระบวนแบบใบหู	๑๑ มี.ค. ๒๕๔๕
autodestructive art	ศิลปะสลายตัว	๑๑ มี.ค. ๒๕๔๕
autograph	อัตเลขน์	๑๑ มี.ค. ๒๕๔๕
automatism	ภาวะอัตโนมัติ	๑๑ มี.ค. ๒๕๔๕
รูปเว้า	cavo-rilievo; hollow relief; incised relief; intaglio rilevato	๑๑ มี.ค. ๒๕๔๕
รูปเว้า	hollow relief; cavo-rilievo; incised relief; intaglio rilevato	๑๑ มี.ค. ๒๕๔๕
รูปเห็นรอบตัว	free-standing	๑๑ มี.ค. ๒๕๔๕
รูปโกลน	abbozzo	๑๑ มี.ค. ๒๕๔๕
รูปเคารพ	icon	๑๑ มี.ค. ๒๕๔๕
รูปแบบ	form	๑๑ มี.ค. ๒๕๔๕
รูปลำตัว	torso	๑๑ มี.ค. ๒๕๔๕
รูปคนตามหลักวิชา	academy figure	๑๑ มี.ค. ๒๕๔๕
รูปตริภังค์	contrapposto; contraposto	๑๑ มี.ค. ๒๕๔๕
รูปคนเหมือน	portrait	๑๑ มี.ค. ๒๕๔๕
รูปตั้ง	elevation	๑๑ มี.ค. ๒๕๔๕
รูปตัด	section	๑๑ มี.ค. ๒๕๔๕
รูปตัดตามยาว	longitudinal section	๑๑ มี.ค. ๒๕๔๕
รูปตัดตามขวาง	cross section	๑๑ มี.ค. ๒๕๔๕
รูปตามอำเภอใจ	capriccio	๑๑ มี.ค. ๒๕๔๕
รูปถ่ายแบบ	copy	๑๑ มี.ค. ๒๕๔๕
รูปนูนปานกลาง	demi relief; mezzo-rilievo; middle relief	๑๑ มี.ค. ๒๕๔๕
รูปปีเอตา	"<font class=""europe"">pietà</font>"	๑๑ มี.ค. ๒๕๔๕
รูปนูน	relief	๑๑ มี.ค. ๒๕๔๕
รูปนูนสีต่างพื้น	cameo	๑๑ มี.ค. ๒๕๔๕
รูปนูนสูง	alto-rilievo; deep-relief; high relief	๑๑ มี.ค. ๒๕๔๕
รูปนูนต่ำ	bas-relief; bosso-rilievo; low relief	๑๑ มี.ค. ๒๕๔๕
รูปนูนบาง	crushed relief; rilievo-schiacciato; rilievo-stiacciato	๑๑ มี.ค. ๒๕๔๕
รูปถอดแบบ	replica	๑๑ มี.ค. ๒๕๔๕
รูปทรง	form	๑๑ มี.ค. ๒๕๔๕
รูปทรงหลังเบี้ย	cabochon	๑๑ มี.ค. ๒๕๔๕
รูปทรงอิสระ	free form	๑๑ มี.ค. ๒๕๔๕
รูปทรงไม้กางเขน	cruciform	๑๑ มี.ค. ๒๕๔๕
avant-garde	กลุ่มล้ำยุค	๑๑ มี.ค. ๒๕๔๕
aventurine glaze	การเคลือบเกล็ดประกาย	๑๑ มี.ค. ๒๕๔๕
axis	เส้นแกน	๑๑ มี.ค. ๒๕๔๕
โลหะเจือ	alloy	๑๑ มี.ค. ๒๕๔๕
แลกเกอร์	lacquer	๑๑ มี.ค. ๒๕๔๕
เลขนศิลป์	graphic art	๑๑ มี.ค. ๒๕๔๕
เกรียงเขียนภาพ	painting knife	๑๑ มี.ค. ๒๕๔๕
เกรียงผสมสี	palette knife	๑๑ มี.ค. ๒๕๔๕
มกร	makara	๑๑ มี.ค. ๒๕๔๕
แก้วเคลือบแก้วสี	flashed glass	๑๑ มี.ค. ๒๕๔๕
แก้วกรุแก้วสี	cased glass	๑๑ มี.ค. ๒๕๔๕
เก้าอี้	chair	๑๑ มี.ค. ๒๕๔๕
เก้าอี้ยาว	settee	๑๑ มี.ค. ๒๕๔๕
เก้าอี้ยาวพนักสูง	settle	๑๑ มี.ค. ๒๕๔๕
เก้าอี้เท้าแขน	armchair	๑๑ มี.ค. ๒๕๔๕
เก้าอี้นวมยาว	sofa	๑๑ มี.ค. ๒๕๔๕
เกสตัลต์	Gestalt	๑๑ มี.ค. ๒๕๔๕
เกียรติมุข	kirtimukha	๑๑ มี.ค. ๒๕๔๕
ใกล้คลาสสิก	archaic	๑๑ มี.ค. ๒๕๔๕
เข็มจาร	drypoint	๑๑ มี.ค. ๒๕๔๕
เข็มจารปลายตัด	"<font class=""europe"">échoppe</font>"	๑๑ มี.ค. ๒๕๔๕
โคมระย้า	chandelier	๑๑ มี.ค. ๒๕๔๕
แคริอาทิด	caryatid	๑๑ มี.ค. ๒๕๔๕
โคเร	kore	๑๑ มี.ค. ๒๕๔๕
โครงหุ่นปั้น	armature	๑๑ มี.ค. ๒๕๔๕
เครื่องยอด	finial	๑๑ มี.ค. ๒๕๔๕
เครื่องเรือนแบบชิปเพนเดล	Chippendale	๑๑ มี.ค. ๒๕๔๕
เครื่องเรือนทรงกระพุ้ง	"<font class=""europe"">bombé</font>"	๑๑ มี.ค. ๒๕๔๕
เครื่องยึด	binder	๑๑ มี.ค. ๒๕๔๕
เครื่องเขิน	lacquerware	๑๑ มี.ค. ๒๕๔๕
เครื่องมือถู	burnisher	๑๑ มี.ค. ๒๕๔๕
เครื่องเพชรพลอย	jewelry	๑๑ มี.ค. ๒๕๔๕
เครื่องวาดเขียนย่อขยาย	pantograph	๑๑ มี.ค. ๒๕๔๕
เครื่องสังคโลก	celadon	๑๑ มี.ค. ๒๕๔๕
เครื่องอัด	copying press	๑๑ มี.ค. ๒๕๔๕
เครื่องลายคราม	blue-and-white ware	๑๑ มี.ค. ๒๕๔๕
เครื่องกระเบื้องกระดูก	bone china	๑๑ มี.ค. ๒๕๔๕
เครื่องฉายภาพทึบแสง	opaque projector	๑๑ มี.ค. ๒๕๔๕
เครื่องดินเผา	earthenware	๑๑ มี.ค. ๒๕๔๕
เครื่องดินเผาสีหม้อใหม่	terracotta	๑๑ มี.ค. ๒๕๔๕
เครื่องดินเผาดิบ	biscuitware	๑๑ มี.ค. ๒๕๔๕
เครื่องถม	nielloware	๑๑ มี.ค. ๒๕๔๕
เครื่องถ้วยมาอิโอลิกา	maiolica	๑๑ มี.ค. ๒๕๔๕
เครื่องถ้วยเดลฟต์	delftware	๑๑ มี.ค. ๒๕๔๕
เครื่องถ้วยเดลฟต์แบบอังกฤษ	English delftware	๑๑ มี.ค. ๒๕๔๕
เครื่องถ้วยเปลือกไข่	porcelain	๑๑ มี.ค. ๒๕๔๕
เครื่องถ้วยหิน	stoneware	๑๑ มี.ค. ๒๕๔๕
เครื่องถ้วยหินดำ	basaltes	๑๑ มี.ค. ๒๕๔๕
เครื่องถ้วยกระเบื้อง	china; chinaware	๑๑ มี.ค. ๒๕๔๕
เครื่องถ้วยกระเบื้องขาว	blanc de chine; china white	๑๑ มี.ค. ๒๕๔๕
เครื่องถ้วยปาลีซี	Palissy ware	๑๑ มี.ค. ๒๕๔๕
เครื่องถ้วยฟายองซ์	faience	๑๑ มี.ค. ๒๕๔๕
เครื่องประดับมุมจั่ว	acroteria; acroterion	๑๑ มี.ค. ๒๕๔๕
เครื่องปั้นเผา	ceramic	๑๑ มี.ค. ๒๕๔๕
เครื่องพิมพ์กัดกรด	etching press	๑๑ มี.ค. ๒๕๔๕
เคาน์เตอร์	counter	๑๑ มี.ค. ๒๕๔๕
เคซีน	casein	๑๑ มี.ค. ๒๕๔๕
เงินถัก, ทองถัก	filigree	๑๑ มี.ค. ๒๕๔๕
รงคะ, ความสดของสี	chroma	๑๑ มี.ค. ๒๕๔๕
รงคดุริยางค์	synchromism; synchronism	๑๑ มี.ค. ๒๕๔๕
เจสโซ	gesso	๑๑ มี.ค. ๒๕๔๕
เจดีย์	pagoda	๑๑ มี.ค. ๒๕๔๕
เฉลียงลอย	balcony	๑๑ มี.ค. ๒๕๔๕
เชรับ, ดรุณเทพ	cherub	๑๑ มี.ค. ๒๕๔๕
เชิงอนุสาวรีย์	monumental	๑๑ มี.ค. ๒๕๔๕
เชิงโบราณ	archaistic	๑๑ มี.ค. ๒๕๔๕
เชิงฝีแปรง	painterly	๑๑ มี.ค. ๒๕๔๕
เชื้อผงอิฐ	grog	๑๑ มี.ค. ๒๕๔๕
โดมแบบจีออเดสิก	geodesic dome	๑๑ มี.ค. ๒๕๔๕
เดสตีเจล	De Stijl	๑๑ มี.ค. ๒๕๔๕
โต๊ะเขียนหนังสือส่วนตัว	secretary	๑๑ มี.ค. ๒๕๔๕
โต๊ะเครื่องแป้ง	dressing table	๑๑ มี.ค. ๒๕๔๕
โต๊ะน้ำชา	tea table	๑๑ มี.ค. ๒๕๔๕
เตาเผา	kiln	๑๑ มี.ค. ๒๕๔๕
โถงแบบท้องพระโรง	megaron	๑๑ มี.ค. ๒๕๔๕
โถงทางเข้า	vestibule	๑๑ มี.ค. ๒๕๔๕
เทวทูต, ทูตสวรรค์, นางฟ้า	angel	๑๑ มี.ค. ๒๕๔๕
แท่นบูชา	altar	๑๑ มี.ค. ๒๕๔๕
แนวนิยมภาพสว่างในความมืด	tenebrism	๑๑ มี.ค. ๒๕๔๕
เนื้อสี	body	๑๑ มี.ค. ๒๕๔๕
เนื้อหา	content	๑๑ มี.ค. ๒๕๔๕
เนื้อดิน	body; clay body	๑๑ มี.ค. ๒๕๔๕
โบราณวัตถุ	antique	๑๑ มี.ค. ๒๕๔๕
โบราณ	ancient; archaic	๑๑ มี.ค. ๒๕๔๕
โบซาร์	Beaux-Arts	๑๑ มี.ค. ๒๕๔๕
แบบร่าง	sketch	๑๑ มี.ค. ๒๕๔๕
แบบร่างขนาดเล็ก	thumbnail sketch	๑๑ มี.ค. ๒๕๔๕
แบบอาณานิคมจอร์เจียน	colonial Georgian	๑๑ มี.ค. ๒๕๔๕
แบบลาย	pattern	๑๑ มี.ค. ๒๕๔๕
แบบเชิงฝีแปรง	malerisch	๑๑ มี.ค. ๒๕๔๕
แบบจีน	chinoiserie	๑๑ มี.ค. ๒๕๔๕
แบบตัวรูปดำ	black-figure	๑๑ มี.ค. ๒๕๔๕
แบบบีเดอร์ไมเออร์	Biedermeier	๑๑ มี.ค. ๒๕๔๕
เปมเทพ [เป-มะ-เทบ], อะมอริโน	amorino	๑๑ มี.ค. ๒๕๔๕
เปมเทพ, พุตโต	putto	๑๑ มี.ค. ๒๕๔๕
แปรงบุโรชิ	buroshi	๑๑ มี.ค. ๒๕๔๕
แป้นหัวเสา	abacus	๑๑ มี.ค. ๒๕๔๕
แป้นถู	baren	๑๑ มี.ค. ๒๕๔๕
แผ่นใยหิน	asbestos cement board	๑๑ มี.ค. ๒๕๔๕
แผ่นซับเสียง	acoustic board	๑๑ มี.ค. ๒๕๔๕
แผงยึดพื้นโต๊ะ	bench hook	๑๑ มี.ค. ๒๕๔๕
แผงประกบผนัง	dado	๑๑ มี.ค. ๒๕๔๕
แผงไม้ประดับฝา	boiserie	๑๑ มี.ค. ๒๕๔๕
แผนผังบริเวณ	layout plan	๑๑ มี.ค. ๒๕๔๕
โพธิบัลลังก์, วัชรอาสน์	diamond throne	๑๑ มี.ค. ๒๕๔๕
แฟ้มภาพผลงาน	portfolio	๑๑ มี.ค. ๒๕๔๕
แฟนซี	fancy	๑๑ มี.ค. ๒๕๔๕
มุขโค้งด้านสกัด	apse	๑๑ มี.ค. ๒๕๔๕
มุขหน้าต่างเหลี่ยม	bay window	๑๑ มี.ค. ๒๕๔๕
มุขหน้าต่างโค้ง	bow window	๑๑ มี.ค. ๒๕๔๕
background	ฉากหลัง	๑๑ มี.ค. ๒๕๔๕
balance	ดุลยภาพ	๑๑ มี.ค. ๒๕๔๕
balcony	เฉลียงลอย	๑๑ มี.ค. ๒๕๔๕
baluster	ลูกกรงทรงคนโท	๑๑ มี.ค. ๒๕๔๕
balustrade	ตับลูกกรง	๑๑ มี.ค. ๒๕๔๕
bambocciata	จิตรกรรมคนยากไร้	๑๑ มี.ค. ๒๕๔๕
banqueting hall	ห้องจัดพิธีเลี้ยง	๑๑ มี.ค. ๒๕๔๕
Barbizon school	สกุลศิลปะบาร์บิซง	๑๑ มี.ค. ๒๕๔๕
barbotine	การแต่งลายนูนดินเหลว	๑๑ มี.ค. ๒๕๔๕
bare concrete	คอนกรีตเปลือย	๑๑ มี.ค. ๒๕๔๕
baren	แป้นถู	๑๑ มี.ค. ๒๕๔๕
barbarian art	ศิลปะอนารยชน	๑๑ มี.ค. ๒๕๔๕
bark painting	จิตรกรรมเปลือกไม้	๑๑ มี.ค. ๒๕๔๕
baroque	บาโรก, บารอก	๑๑ มี.ค. ๒๕๔๕
bas-relief; bosso-rilievo; low relief	รูปนูนต่ำ	๑๑ มี.ค. ๒๕๔๕
basaltes	เครื่องถ้วยหินดำ	๑๑ มี.ค. ๒๕๔๕
basket weave	ลายสาน	๑๑ มี.ค. ๒๕๔๕
batik	ปาเต๊ะ	๑๑ มี.ค. ๒๕๔๕
battle-piece	ภาพการรบ	๑๑ มี.ค. ๒๕๔๕
bay window	มุขหน้าต่างเหลี่ยม	๑๑ มี.ค. ๒๕๔๕
battlement	ปราการ	๑๑ มี.ค. ๒๕๔๕
Bauhaus	สถาบันเบาเฮาส์	๑๑ มี.ค. ๒๕๔๕
beak style	กระบวนแบบจะงอย	๑๑ มี.ค. ๒๕๔๕
bearing wall	ผนังรับน้ำหนัก	๑๑ มี.ค. ๒๕๔๕
Beauvais	โรงทอพรมโบเว	๑๑ มี.ค. ๒๕๔๕
Beaux-Arts	โบซาร์	๑๑ มี.ค. ๒๕๔๕
belvedere	หอทัศนา	๑๑ มี.ค. ๒๕๔๕
bench	ม้านั่งยาว	๑๑ มี.ค. ๒๕๔๕
bench hook	แผงยึดพื้นโต๊ะ	๑๑ มี.ค. ๒๕๔๕
benizuri-e	สมัยเบะนิซุริเอะ	๑๑ มี.ค. ๒๕๔๕
beni-e	ภาพพิมพ์แบบเบะนิเอะ	๑๑ มี.ค. ๒๕๔๕
Bharahut school	สกุลศิลปะภารหุต	๑๑ มี.ค. ๒๕๔๕
bianco sangiovanni	สีขาวน้ำปูน	๑๑ มี.ค. ๒๕๔๕
Biedermeier	แบบบีเดอร์ไมเออร์	๑๑ มี.ค. ๒๕๔๕
bimorphic art; biomorphic art	ศิลปะชีวรูป	๑๑ มี.ค. ๒๕๔๕
binder	๑. สารยึด<br/>๒. เครื่องยึด	๑๑ มี.ค. ๒๕๔๕
biomorphic art; bimorphic art	ศิลปะชีวรูป	๑๑ มี.ค. ๒๕๔๕
bird’s-eye view	วิวตานก	๑๑ มี.ค. ๒๕๔๕
biscuit firing	การเผาดินดิบ	๑๑ มี.ค. ๒๕๔๕
biscuitware	เครื่องดินเผาดิบ	๑๑ มี.ค. ๒๕๔๕
bistre	หมึกเขม่า	๑๑ มี.ค. ๒๕๔๕
black-figure	แบบตัวรูปดำ	๑๑ มี.ค. ๒๕๔๕
biting	รอยกรดกัด	๑๑ มี.ค. ๒๕๔๕
blanc de chine; china white	เครื่องถ้วยกระเบื้องขาว	๑๑ มี.ค. ๒๕๔๕
blanc fixe	สีขาวคงทน	๑๑ มี.ค. ๒๕๔๕
Blaue Reiter, Der	กลุ่มเบลาเออไรเทอร์	๑๑ มี.ค. ๒๕๔๕
Blaue Vier	กลุ่มเบลาเออเฟียร์	๑๑ มี.ค. ๒๕๔๕
blending colour	สีกลืนกัน	๑๑ มี.ค. ๒๕๔๕
blind printing; graffage	กลวิธีพิมพ์ไร้สี	๑๑ มี.ค. ๒๕๔๕
block book	หนังสือพิมพ์แกะไม้	๑๑ มี.ค. ๒๕๔๕
bloom	รอยด้าน	๑๑ มี.ค. ๒๕๔๕
blot drawing	ภาพสลัดสี	๑๑ มี.ค. ๒๕๔๕
Blue Rose Group	กลุ่มดอกกุหลาบน้ำเงิน	๑๑ มี.ค. ๒๕๔๕
blue-and-white ware	เครื่องลายคราม	๑๑ มี.ค. ๒๕๔๕
"<font class=""europe"">bodegón</font>"	ภาพโบเดกอน	๑๑ มี.ค. ๒๕๔๕
boiserie	แผงไม้ประดับฝา	๑๑ มี.ค. ๒๕๔๕
Bolognese Classicism	คตินิยมคลาสสิกแบบโบโลญญา	๑๑ มี.ค. ๒๕๔๕
body	๑. เนื้อสี<br/>๒. เนื้อดิน	๑๑ มี.ค. ๒๕๔๕
body art	กายศิลป์	๑๑ มี.ค. ๒๕๔๕
body colour	๑. สีเนื้อทึบ<br/>๒. สีเนื้อดิน	๑๑ มี.ค. ๒๕๔๕
"<font class=""europe"">bombé</font>"	เครื่องเรือนทรงกระพุ้ง	๑๑ มี.ค. ๒๕๔๕
bone china	เครื่องกระเบื้องกระดูก	๑๑ มี.ค. ๒๕๔๕
bonsai	๑. ไม้แคระ<br/>๒. ศิลปะไม้แคระ	๑๑ มี.ค. ๒๕๔๕
Book of Hours	หนังสือกำหนดเทศกาล	๑๑ มี.ค. ๒๕๔๕
Book of the Dead	คัมภีร์มรณะ	๑๑ มี.ค. ๒๕๔๕
borax	น้ำประสานทอง	๑๑ มี.ค. ๒๕๔๕
Boulle marquetry; Buhl marquetry	งานฝังประดับแบบบูล	๑๑ มี.ค. ๒๕๔๕
bosso-rilievo; bas-relief; low relief	รูปนูนต่ำ	๑๑ มี.ค. ๒๕๔๕
bow window	มุขหน้าต่างโค้ง	๑๑ มี.ค. ๒๕๔๕
bozzetto	หุ่นร่าง	๑๑ มี.ค. ๒๕๔๕
brayer	ลูกกลิ้งมือ	๑๑ มี.ค. ๒๕๔๕
breakfast piece	ภาพอาหารเช้า	๑๑ มี.ค. ๒๕๔๕
bridge	สะพานรองมือ	๑๑ มี.ค. ๒๕๔๕
Bristol glaze	การเคลือบแบบบริสตอล	๑๑ มี.ค. ๒๕๔๕
broken colour	สีภินรงค์	๑๑ มี.ค. ๒๕๔๕
brocade	ผ้ายก	๑๑ มี.ค. ๒๕๔๕
bronze	ทองสัมฤทธิ์	๑๑ มี.ค. ๒๕๔๕
brush	พู่กัน	๑๑ มี.ค. ๒๕๔๕
bucchero	บุคเคอโร	๑๑ มี.ค. ๒๕๔๕
Buddhist railing	รั้วพุทธสถาน	๑๑ มี.ค. ๒๕๔๕
Buhl marquetry; Boulle marquetry	งานฝังประดับแบบบูล	๑๑ มี.ค. ๒๕๔๕
burnisher	เครื่องมือถู	๑๑ มี.ค. ๒๕๔๕
burnishing	กลวิธีพิมพ์แบบถู	๑๑ มี.ค. ๒๕๔๕
buroshi	แปรงบุโรชิ	๑๑ มี.ค. ๒๕๔๕
burin; graver	สิ่วแท่ง	๑๑ มี.ค. ๒๕๔๕
C-gouge	สิ่วร่องรูปตัวซี (C)	๑๑ มี.ค. ๒๕๔๕
วรรณะสี	tone	๑๑ มี.ค. ๒๕๔๕
cabinet picture	ภาพประดับตู้	๑๑ มี.ค. ๒๕๔๕
cabochon	๑. อัญมณีทรงหลังเบี้ย<br/>๒. รูปทรงหลังเบี้ย	๑๑ มี.ค. ๒๕๔๕
calligraphic painting	จิตรกรรมรอยพู่กัน	๑๑ มี.ค. ๒๕๔๕
calligraphy	อักษรวิจิตร	๑๑ มี.ค. ๒๕๔๕
callipers	ก้ามวัด	๑๑ มี.ค. ๒๕๔๕
calvary cross	ไม้กางเขนแบบแคลวารี	๑๑ มี.ค. ๒๕๔๕
camaieu	เอกรงค์น้อยระดับ	๑๑ มี.ค. ๒๕๔๕
cameo	๑. กลวิธีรูปนูนสีต่างพื้น<br/>๒. รูปนูนสีต่างพื้น	๑๑ มี.ค. ๒๕๔๕
camera obscura	กล้องทาบเงา	๑๑ มี.ค. ๒๕๔๕
campanile	หอระฆัง	๑๑ มี.ค. ๒๕๔๕
cancelled plate	แม่พิมพ์ยกเลิก	๑๑ มี.ค. ๒๕๔๕
Canon of Proportion	บัญญัติส่วนสัด	๑๑ มี.ค. ๒๕๔๕
canopy	พิดาน	๑๑ มี.ค. ๒๕๔๕
cantilever	คานยื่น	๑๑ มี.ค. ๒๕๔๕
capital	หัวเสา	๑๑ มี.ค. ๒๕๔๕
capriccio	รูปตามอำเภอใจ	๑๑ มี.ค. ๒๕๔๕
caricature	ภาพล้อ	๑๑ มี.ค. ๒๕๔๕
cartoon	๑. ภายลายปรุ<br/>๒. การ์ตูน	๑๑ มี.ค. ๒๕๔๕
carving	๑. การแกะสลัก<br/>๒. งานแกะสลัก	๑๑ มี.ค. ๒๕๔๕
caryatid	แคริอาทิด	๑๑ มี.ค. ๒๕๔๕
cased glass	แก้วกรุแก้วสี	๑๑ มี.ค. ๒๕๔๕
casein	เคซีน	๑๑ มี.ค. ๒๕๔๕
casein colour	สีเคซีน	๑๑ มี.ค. ๒๕๔๕
casting	การหล่อ	๑๑ มี.ค. ๒๕๔๕
catacomb	สุสานใต้ดิน	๑๑ มี.ค. ๒๕๔๕
cavo-rilievo; hollow relief; incised relief; intaglio rilevato	รูปเว้า	๑๑ มี.ค. ๒๕๔๕
celadon	เครื่องสังคโลก	๑๑ มี.ค. ๒๕๔๕
cella; cellae	ครรภมณฑล	๑๑ มี.ค. ๒๕๔๕
cellae; cella	ครรภมณฑล	๑๑ มี.ค. ๒๕๔๕
cellar	ห้องเก็บของใต้ดิน	๑๑ มี.ค. ๒๕๔๕
Celtic art	ศิลปะเซลต์	๑๑ มี.ค. ๒๕๔๕
Celtic cross	ไม้กางเขนแบบเซลต์	๑๑ มี.ค. ๒๕๔๕
ceramic	เครื่องปั้นเผา	๑๑ มี.ค. ๒๕๔๕
chair	เก้าอี้	๑๑ มี.ค. ๒๕๔๕
"<font class=""europe"">champlevé</font>"	ชองเปลอเว	๑๑ มี.ค. ๒๕๔๕
chandelier	โคมระย้า	๑๑ มี.ค. ๒๕๔๕
cherub	ดรุณเทพ, เชรับ	๑๑ มี.ค. ๒๕๔๕
chiaroscuro	ค่าต่างแสง	๑๑ มี.ค. ๒๕๔๕
chiaroscuro woodcut	๑. กลวิธีพิมพ์แกะไม้ค่าต่างแสง<br/>๒. ภาพพิมพ์แกะไม้ค่าต่างแสง	๑๑ มี.ค. ๒๕๔๕
china; chinaware	เครื่องถ้วยกระเบื้อง	๑๑ มี.ค. ๒๕๔๕
china white; blance de chine	เครื่องถ้วยกระเบื้องขาว	๑๑ มี.ค. ๒๕๔๕
chinaware; china	เครื่องถ้วยกระเบื้อง	๑๑ มี.ค. ๒๕๔๕
chinese white	สีขาวจีน	๑๑ มี.ค. ๒๕๔๕
chinoiserie	แบบจีน	๑๑ มี.ค. ๒๕๔๕
Chippendale	เครื่องเรือนแบบชิปเพนเดล	๑๑ มี.ค. ๒๕๔๕
chisel	สิ่วหน้าแบน	๑๑ มี.ค. ๒๕๔๕
chop	ตราประทับ	๑๑ มี.ค. ๒๕๔๕
chroma	รงคะ, ความสดของสี	๑๑ มี.ค. ๒๕๔๕
chromatic colour	สีรงค์	๑๑ มี.ค. ๒๕๔๕
cirage	เอกรงค์เหลือง	๑๑ มี.ค. ๒๕๔๕
cire perdue; lost wax	สูญขี้ผึ้ง	๑๑ มี.ค. ๒๕๔๕
classic; classical	คลาสสิก	๑๑ มี.ค. ๒๕๔๕
classical; classic	คลาสสิก	๑๑ มี.ค. ๒๕๔๕
classical abstraction	นามธรรมแบบคลาสสิก	๑๑ มี.ค. ๒๕๔๕
Classical period	สมัยคลาสสิก	๑๑ มี.ค. ๒๕๔๕
clay body	เนื้อดิน	๑๑ มี.ค. ๒๕๔๕
"<font class=""europe"">cliché-verre</font>; glass print"	ภาพพิมพ์ถ่ายกระจก	๑๑ มี.ค. ๒๕๔๕
cloister	ระเบียงฉันนบถ	๑๑ มี.ค. ๒๕๔๕
cloison	เส้นกั้นสี	๑๑ มี.ค. ๒๕๔๕
cloisonism	คตินิยมเส้นกั้นสี	๑๑ มี.ค. ๒๕๔๕
"<font class=""europe"">cloisonné</font>"	กลัวซอนเน	๑๑ มี.ค. ๒๕๔๕
วัสดุสำเร็จรูป	ready made	๑๑ มี.ค. ๒๕๔๕
วัชรอาสน์, โพธิบัลลังก์	diamond throne	๑๑ มี.ค. ๒๕๔๕
วัชราสน์, ขัดสมาธิเพชร	diamond posture	๑๑ มี.ค. ๒๕๔๕
วัชราสน์, ขัดสมาธิเพชร	diamond posture	๑๑ มี.ค. ๒๕๔๕
วิภาคนิยม	divisionism	๑๑ มี.ค. ๒๕๔๕
COBRA	กลุ่มโคบรา	๑๑ มี.ค. ๒๕๔๕
วิวตานก	bird’s-eye view	๑๑ มี.ค. ๒๕๔๕
วิวตาหนอน	worm’s-eye view	๑๑ มี.ค. ๒๕๔๕
วิสัยใกล้ไกล	zones of recession	๑๑ มี.ค. ๒๕๔๕
วิหาร	vihara	๑๑ มี.ค. ๒๕๔๕
coiling	การขดขึ้นรูป	๑๑ มี.ค. ๒๕๔๕
cold art	ศิลปะเย็นชา	๑๑ มี.ค. ๒๕๔๕
collage	ภาพปะติด	๑๑ มี.ค. ๒๕๔๕
collagraph; collograph	งานพิมพ์วัสดุปะติด	๑๑ มี.ค. ๒๕๔๕
collograph; collagraph	งานพิมพ์วัสดุปะติด	๑๑ มี.ค. ๒๕๔๕
colonial architecture	สถาปัตยกรรมอาณานิคม	๑๑ มี.ค. ๒๕๔๕
colonial Georgian	แบบอาณานิคมจอร์เจียน	๑๑ มี.ค. ๒๕๔๕
colonnade	นางจรัล	๑๑ มี.ค. ๒๕๔๕
colour notation	สัญกรณ์สี	๑๑ มี.ค. ๒๕๔๕
colour painting	จิตรกรรมสี	๑๑ มี.ค. ๒๕๔๕
colour print	ภาพพิมพ์สี	๑๑ มี.ค. ๒๕๔๕
colour saturation; saturation	ความอิ่มตัวสี	๑๑ มี.ค. ๒๕๔๕
colour-field painting	จิตรกรรมสนามสี	๑๑ มี.ค. ๒๕๔๕
colour	สี	๑๑ มี.ค. ๒๕๔๕
colour circle	วงสี	๑๑ มี.ค. ๒๕๔๕
column	เสา	๑๑ มี.ค. ๒๕๔๕
combine painting	จิตรกรรมแบบผสม	๑๑ มี.ค. ๒๕๔๕
commercial art	พาณิชยศิลป์	๑๑ มี.ค. ๒๕๔๕
complementary colour	สีตรงข้าม	๑๑ มี.ค. ๒๕๔๕
composition	องค์ประกอบ	๑๑ มี.ค. ๒๕๔๕
computer art	ศิลปะคอมพิวเตอร์	๑๑ มี.ค. ๒๕๔๕
conceptual art	มโนทัศนศิลป์	๑๑ มี.ค. ๒๕๔๕
concrete art	ศิลปะรูปธรรม	๑๑ มี.ค. ๒๕๔๕
concrete painting	จิตรกรรมแนวทรงสถิต	๑๑ มี.ค. ๒๕๔๕
concrete poetry	กวีนิพนธ์รูปธรรม	๑๑ มี.ค. ๒๕๔๕
constructivism	ลัทธิเค้าโครง	๑๑ มี.ค. ๒๕๔๕
contemporary	ร่วมสมัย	๑๑ มี.ค. ๒๕๔๕
content	เนื้อหา	๑๑ มี.ค. ๒๕๔๕
contour drawing	การวาดเส้นแสดงทรง	๑๑ มี.ค. ๒๕๔๕
contraposto; contrapposto	รูปตริภังค์	๑๑ มี.ค. ๒๕๔๕
contrapposto; contraposto	รูปตริภังค์	๑๑ มี.ค. ๒๕๔๕
conventionalism	คติสัญนิยม	๑๑ มี.ค. ๒๕๔๕
conversation piece	ภาพสังสันทน์	๑๑ มี.ค. ๒๕๔๕
cool colour	สีเย็น	๑๑ มี.ค. ๒๕๔๕
copy	รูปถ่ายแบบ	๑๑ มี.ค. ๒๕๔๕
copying press	เครื่องอัด	๑๑ มี.ค. ๒๕๔๕
Coptic art	ศิลปะคอปต์	๑๑ มี.ค. ๒๕๔๕
corbel	ขั้นยื่น	๑๑ มี.ค. ๒๕๔๕
cornice	บัวคอร์นิซ	๑๑ มี.ค. ๒๕๔๕
Corrente	สมาคมคอร์เรนเต	๑๑ มี.ค. ๒๕๔๕
corridor	๑. ทางเดินในอาคาร<br/>๒. ทางเดินเชื่อมอาคาร	๑๑ มี.ค. ๒๕๔๕
counter	เคาน์เตอร์	๑๑ มี.ค. ๒๕๔๕
counter proof	ภาพพิสูจน์แม่พิมพ์	๑๑ มี.ค. ๒๕๔๕
วิลักษณ์	grotesque	๑๑ มี.ค. ๒๕๔๕
วิจิตรศิลป์	fine art	๑๑ มี.ค. ๒๕๔๕
วิญญาณนิยม	animism	๑๑ มี.ค. ๒๕๔๕
วิถีทัศน์	vista	๑๑ มี.ค. ๒๕๔๕
วิธีตีตาราง	squaring	๑๑ มี.ค. ๒๕๔๕
crackle glaze	การเคลือบราน	๑๑ มี.ค. ๒๕๔๕
crayon	ถ่านแท่ง	๑๑ มี.ค. ๒๕๔๕
crayon engraving; crayon manner	๑. กลวิธีพิมพ์แบบเขียนถ่าน<br/>๒. ภาพพิมพ์แบบเขียนถ่าน	๑๑ มี.ค. ๒๕๔๕
crayon manner; crayon engraving	๑. กลวิธีพิมพ์แบบเขียนถ่าน<br/>๒. ภาพพิมพ์แบบเขียนถ่าน	๑๑ มี.ค. ๒๕๔๕
"<font class=""europe"">crevé</font>"	แอ่งกรดกัด	๑๑ มี.ค. ๒๕๔๕
"<font class=""europe"">criblé</font>"	กลวิธีลายจุด	๑๑ มี.ค. ๒๕๔๕
cross section	รูปตัดตามขวาง	๑๑ มี.ค. ๒๕๔๕
cross-hatching	การแรเส้นเงาขวาง	๑๑ มี.ค. ๒๕๔๕
cruciform	รูปทรงไม้กางเขน	๑๑ มี.ค. ๒๕๔๕
crushed relief; rilievo-schiacciato; rilievo-stiacciato	รูปนูนบาง	๑๑ มี.ค. ๒๕๔๕
cubism	บาศกนิยม	๑๑ มี.ค. ๒๕๔๕
cubist-realism	สัจนิยมแนวบาศกนิยม	๑๑ มี.ค. ๒๕๔๕
cupola	๑. หอหลังคาโดม<br/>๒. หลังคาโดม	๑๑ มี.ค. ๒๕๔๕
curtain wall	ผนังม่าน	๑๑ มี.ค. ๒๕๔๕
cybernetic art	ศิลปะไซเบอร์เนติก	๑๑ มี.ค. ๒๕๔๕
Cycladic art	ศิลปะไซคลาดิส	๑๑ มี.ค. ๒๕๔๕
วงสี	colour circle	๑๑ มี.ค. ๒๕๔๕
dabber	ลูกประคบ	๑๑ มี.ค. ๒๕๔๕
dada; dadaism	คติดาด	๑๑ มี.ค. ๒๕๔๕
dadaism; dada	คติดาด	๑๑ มี.ค. ๒๕๔๕
dado	แผงประกบผนัง	๑๑ มี.ค. ๒๕๔๕
Daedalic style	กระบวนแบบเดดาลัส	๑๑ มี.ค. ๒๕๔๕
damascene	คร่ำเงิน, คร่ำทอง	๑๑ มี.ค. ๒๕๔๕
Danube school	สกุลศิลปะดานูบ	๑๑ มี.ค. ๒๕๔๕
De Stijl	เดสตีเจล	๑๑ มี.ค. ๒๕๔๕
dead colour	สีตาย	๑๑ มี.ค. ๒๕๔๕
decal; decalcomania	ภาพทาบสี	๑๑ มี.ค. ๒๕๔๕
decalcomania; decal	ภาพทาบสี	๑๑ มี.ค. ๒๕๔๕
decorative art	มัณฑนศิลป์	๑๑ มี.ค. ๒๕๔๕
deep relief; alto-rilievo; high relief	รูปนูนสูง	๑๑ มี.ค. ๒๕๔๕
delftware	เครื่องถ้วยเดลฟต์	๑๑ มี.ค. ๒๕๔๕
demi relief; mezzo-rilievo; middle relief	รูปนูนปานกลาง	๑๑ มี.ค. ๒๕๔๕
dentils	ลายฟันเรียง	๑๑ มี.ค. ๒๕๔๕
Der Blaue Reiter	กลุ่มเบลาเออไรเทอร์	๑๑ มี.ค. ๒๕๔๕
diamond posture	ขัดสมาธิเพชร, วัชราสน์	๑๑ มี.ค. ๒๕๔๕
diamond throne	วัชรอาสน์, โพธิบัลลังก์	๑๑ มี.ค. ๒๕๔๕
diorama	ประจักษทัศน์	๑๑ มี.ค. ๒๕๔๕
direct sculpture	ประติมากรรมวิธีตรง	๑๑ มี.ค. ๒๕๔๕
direct metal sculpture	ประติมากรรมโลหะวิธีตรง	๑๑ มี.ค. ๒๕๔๕
direct painting; alla prima; au premier coup	การระบายสีโดยตรง	๑๑ มี.ค. ๒๕๔๕
divan	ม้านวมยาว	๑๑ มี.ค. ๒๕๔๕
divisionism	วิภาคนิยม	๑๑ มี.ค. ๒๕๔๕
Documenta	นิทรรศการศิลปกรรมดอคิวเมนตา	๑๑ มี.ค. ๒๕๔๕
dormer window	หน้าต่างหลังคา	๑๑ มี.ค. ๒๕๔๕
"dotted manner; <font class=""europe"">manière criblée</font>"	กลวิธีพิมพ์ภาพลายจุด	๑๑ มี.ค. ๒๕๔๕
double ikat	มัดหมี่สองทาง	๑๑ มี.ค. ๒๕๔๕
double image	ทวิภาพ	๑๑ มี.ค. ๒๕๔๕
dragging stroke	รอยพู่กันปัด	๑๑ มี.ค. ๒๕๔๕
drawing	๑. ภาพวาดเส้น<br/>๒. การวาดเส้น	๑๑ มี.ค. ๒๕๔๕
dressing table	โต๊ะเครื่องแป้ง	๑๑ มี.ค. ๒๕๔๕
dry-brush painting	การเขียนภาพพู่กันแห้ง	๑๑ มี.ค. ๒๕๔๕
drypoint	๑. กลวิธีพิมพ์จารเข็ม<br/>๒. เข็มจาร<br/>๓. ภาพพิมพ์จารเข็ม	๑๑ มี.ค. ๒๕๔๕
dust box	กล่องฝุ่นยางสน	๑๑ มี.ค. ๒๕๔๕
สมมาตร	symmetry	๑๑ มี.ค. ๒๕๔๕
สมัยคลาสสิก	Classical period	๑๑ มี.ค. ๒๕๔๕
สมัยรีเจนซี	Regency	๑๑ มี.ค. ๒๕๔๕
สมัยเบะนิซุริเอะ	benizuri-e	๑๑ มี.ค. ๒๕๔๕
สมัยอาร์เคอิก	Archaic period	๑๑ มี.ค. ๒๕๔๕
สมัย	epoch	๑๑ มี.ค. ๒๕๔๕
สมัย	period	๑๑ มี.ค. ๒๕๔๕
สมัยโรมาเนสก์	Romanesque	๑๑ มี.ค. ๒๕๔๕
สมัยเรขาคณิต	Geometric period	๑๑ มี.ค. ๒๕๔๕
สมัยเฮลเลนิสติก	Hellenistic period	๑๑ มี.ค. ๒๕๔๕
สมัยฟื้นฟูศิลปวิทยา	Renaissance	๑๑ มี.ค. ๒๕๔๕
สมัยนิยม	fashion	๑๑ มี.ค. ๒๕๔๕
สภาศิลปิน	Artist’s Congress	๑๑ มี.ค. ๒๕๔๕
สมาคมคอร์เรนเต	Corrente	๑๑ มี.ค. ๒๕๔๕
สมาคมช่าง	gild; guild	๑๑ มี.ค. ๒๕๔๕
หยางไฉ่	yang-ts’ai	๑๑ มี.ค. ๒๕๔๕
earth art	ภูมิศิลป์	๑๑ มี.ค. ๒๕๔๕
earth colour	สีดิน	๑๑ มี.ค. ๒๕๔๕
earthenware	เครื่องดินเผา	๑๑ มี.ค. ๒๕๔๕
easel painting	จิตรกรรมขาหยั่ง	๑๑ มี.ค. ๒๕๔๕
หมึกเขม่า	bistre	๑๑ มี.ค. ๒๕๔๕
"<font class=""europe"">échoppe</font>"	เข็มจารปลายตัด	๑๑ มี.ค. ๒๕๔๕
eclecticism	คตินิยมสรรผสาน	๑๑ มี.ค. ๒๕๔๕
"<font class=""europe"">École des Beaux-Arts</font>"	สถาบันโบซาร์	๑๑ มี.ค. ๒๕๔๕
"<font class=""europe"">ecorché</font>"	หุ่นกายวิภาค	๑๑ มี.ค. ๒๕๔๕
สะพานรองมือ	bridge	๑๑ มี.ค. ๒๕๔๕
ส่วนมูลฐาน	element	๑๑ มี.ค. ๒๕๔๕
ส่วนสัด	proportion	๑๑ มี.ค. ๒๕๔๕
ส่วนสัดแบบลิซิปปัส	Lysippian proportion	๑๑ มี.ค. ๒๕๔๕
ห้องเก็บของใต้ดิน	cellar	๑๑ มี.ค. ๒๕๔๕
ห้องจัดพิธีเลี้ยง	banqueting hall	๑๑ มี.ค. ๒๕๔๕
ห้องชุด	apartment; flat	๑๑ มี.ค. ๒๕๔๕
ห้องชุด	flat; apartment	๑๑ มี.ค. ๒๕๔๕
ห้องปฏิบัติงานศิลปะ	atelier	๑๑ มี.ค. ๒๕๔๕
ห้องปฏิบัติงานศิลปะเสรี	atelier libre	๑๑ มี.ค. ๒๕๔๕
ห้องพักรอ	anteroom; vestibule	๑๑ มี.ค. ๒๕๔๕
หอระฆัง	campanile	๑๑ มี.ค. ๒๕๔๕
หอศิลป์	gallery	๑๑ มี.ค. ๒๕๔๕
หอหลังคาโดม	cupola	๑๑ มี.ค. ๒๕๔๕
Eight, The	กลุ่มแปด	๑๑ มี.ค. ๒๕๔๕
หออะซาน	minaret	๑๑ มี.ค. ๒๕๔๕
หอทัศนา	belvedere	๑๑ มี.ค. ๒๕๔๕
element	ส่วนมูลฐาน	๑๑ มี.ค. ๒๕๔๕
elevation	รูปตั้ง	๑๑ มี.ค. ๒๕๔๕
Elizabethan style	กระบวนแบบเอลิซาเบท	๑๑ มี.ค. ๒๕๔๕
elementarism	คติมูลฐาน	๑๑ มี.ค. ๒๕๔๕
embossing	การทำลายนูน	๑๑ มี.ค. ๒๕๔๕
embroidery	งานเย็บปักถักร้อย	๑๑ มี.ค. ๒๕๔๕
empreinte	ภาพรอยพิมพ์	๑๑ มี.ค. ๒๕๔๕
enamel	การลงยา	๑๑ มี.ค. ๒๕๔๕
encaustic; encaustic painting	การเขียนสีขี้ผึ้งร้อน	๑๑ มี.ค. ๒๕๔๕
encaustic painting; encaustic	การเขียนสีขี้ผึ้งร้อน	๑๑ มี.ค. ๒๕๔๕
หัวเสา	capital	๑๑ มี.ค. ๒๕๔๕
enclosure wall	ผนังปิดล้อม	๑๑ มี.ค. ๒๕๔๕
end-grain block	แม่พิมพ์ไม้ตัดตามขวาง	๑๑ มี.ค. ๒๕๔๕
engaged column	เสาแนบ	๑๑ มี.ค. ๒๕๔๕
English delftware	เครื่องถ้วยเดลฟต์แบบอังกฤษ	๑๑ มี.ค. ๒๕๔๕
engraving	๑. การแกะลาย<br/>๒. ภาพพิมพ์ลายแกะ	๑๑ มี.ค. ๒๕๔๕
entresol; mezzanine	ชั้นเสริม	๑๑ มี.ค. ๒๕๔๕
environmental art	ศิลปะผสานสิ่งแวดล้อม	๑๑ มี.ค. ๒๕๔๕
สังเคราะห์นิยม	synthetism	๑๑ มี.ค. ๒๕๔๕
สังยุกตนิยม	associationism	๑๑ มี.ค. ๒๕๔๕
สังหาริมศิลป์	art mobilier; furnishing art	๑๑ มี.ค. ๒๕๔๕
สัจนิยม	realism	๑๑ มี.ค. ๒๕๔๕
สัจนิยมแนวมายา	magic realism	๑๑ มี.ค. ๒๕๔๕
สัจนิยมแนวสังคมนิยม	socialist realism	๑๑ มี.ค. ๒๕๔๕
สัจนิยมแนวบาศกนิยม	cubist-realism	๑๑ มี.ค. ๒๕๔๕
สัจนิยมแบบภาพถ่าย	photo realism	๑๑ มี.ค. ๒๕๔๕
สัญลักษณ์นิยม	symbolism	๑๑ มี.ค. ๒๕๔๕
สัญกรณ์สี	colour notation	๑๑ มี.ค. ๒๕๔๕
สี	colour	๑๑ มี.ค. ๒๕๔๕
สีเย็น	cool colour	๑๑ มี.ค. ๒๕๔๕
สารยึด	binder	๑๑ มี.ค. ๒๕๔๕
สารแต่งผิว	modelling paste	๑๑ มี.ค. ๒๕๔๕
สารเพิ่มเนื้อสี	inert pigment	๑๑ มี.ค. ๒๕๔๕
สีร้อน	hot colour	๑๑ มี.ค. ๒๕๔๕
สารสี	pigment	๑๑ มี.ค. ๒๕๔๕
สีเสน	red lead	๑๑ มี.ค. ๒๕๔๕
สารัตถศิลป์	minimal art	๑๑ มี.ค. ๒๕๔๕
สีภินรงค์	broken colour	๑๑ มี.ค. ๒๕๔๕
สีใกล้	advancing colour	๑๑ มี.ค. ๒๕๔๕
สารกันกรด	acid resist	๑๑ มี.ค. ๒๕๔๕
สีเคซีน	casein colour	๑๑ มี.ค. ๒๕๔๕
สีใต้เคลือบ	underglazed colour	๑๑ มี.ค. ๒๕๔๕
สีแดง	lake	๑๑ มี.ค. ๒๕๔๕
สีแดง	red	๑๑ มี.ค. ๒๕๔๕
สีแดงโทลูอิดีน	toluidine red	๑๑ มี.ค. ๒๕๔๕
สีรงค์	chromatic colour	๑๑ มี.ค. ๒๕๔๕
สีแท่ง	pastel colour	๑๑ มี.ค. ๒๕๔๕
สีเนื้อดิน	body colour	๑๑ มี.ค. ๒๕๔๕
สีเนื้อทึบ	body colour	๑๑ มี.ค. ๒๕๔๕
สีโปร่งใส	lake	๑๑ มี.ค. ๒๕๔๕
สิ่วร่อง	gouge	๑๑ มี.ค. ๒๕๔๕
สิ่วร่องรูปตัวยู	U-gouge	๑๑ มี.ค. ๒๕๔๕
สิ่วร่องรูปตัววี (V)	V-gouge	๑๑ มี.ค. ๒๕๔๕
สิ่วร่องรูปตัวซี	C-gouge	๑๑ มี.ค. ๒๕๔๕
สิ่วแท่ง	burin; graver	๑๑ มี.ค. ๒๕๔๕
สิ่วหน้าแบน	chisel	๑๑ มี.ค. ๒๕๔๕
สีสะท้อน	reflected colour	๑๑ มี.ค. ๒๕๔๕
สีสัน	hue	๑๑ มี.ค. ๒๕๔๕
สิ่งเก็บตก	"found object; <font class=""europe"">objet trouvé</font>"	๑๑ มี.ค. ๒๕๔๕
สิ่งบ่งชี้	attribution	๑๑ มี.ค. ๒๕๔๕
สิ่งประดิษฐ์	artefact; artifact	๑๑ มี.ค. ๒๕๔๕
สีอรงค์	achromatic colour	๑๑ มี.ค. ๒๕๔๕
สีอะลูมิเนียม	aluminium paint	๑๑ มี.ค. ๒๕๔๕
สีอ่อน, สีจาง	tint	๑๑ มี.ค. ๒๕๔๕
สีอุ่น	warm colour	๑๑ มี.ค. ๒๕๔๕
สีอุบัติการณ์	accidental colour	๑๑ มี.ค. ๒๕๔๕
สีลักษณะเดียว	flat colour	๑๑ มี.ค. ๒๕๔๕
ศาลา	pavilion	๑๑ มี.ค. ๒๕๔๕
ศาลาเล็ก	kiosk	๑๑ มี.ค. ๒๕๔๕
ศิลปวิจักษณ์	art appreciation	๑๑ มี.ค. ๒๕๔๕
ศิลปะเซลต์	Celtic art	๑๑ มี.ค. ๒๕๔๕
ศิลปะโตเลมี	Ptolemaic art	๑๑ มี.ค. ๒๕๔๕
ศิลปะมนัสปรีดิ์	psychedelic art	๑๑ มี.ค. ๒๕๔๕
ศิลปะแบบมิโนส	Minoan art	๑๑ มี.ค. ๒๕๔๕
ศิลปะแบบดั้งเดิม	primitive art	๑๑ มี.ค. ๒๕๔๕
ศิลปะแบบประเพณี	traditional art	๑๑ มี.ค. ๒๕๔๕
ศิลปะเบื้องต้น	ABC art	๑๑ มี.ค. ๒๕๔๕
ศิลปะเพื่อศิลปะ	art for art’s sake	๑๑ มี.ค. ๒๕๔๕
ศิลปวิจารณ์	art criticism	๑๑ มี.ค. ๒๕๔๕
ศิลปะ	art	๑๑ มี.ค. ๒๕๔๕
ศิลปะเย็นชา	cold art	๑๑ มี.ค. ๒๕๔๕
ศิลปะแสดงลักษณ์	representational art	๑๑ มี.ค. ๒๕๔๕
ศิลปะเฮลลีน	Hellenic art	๑๑ มี.ค. ๒๕๔๕
ศิลปะแอฟริกา	African art	๑๑ มี.ค. ๒๕๔๕
ศิลปะรูปลักษณ์	figurative art	๑๑ มี.ค. ๒๕๔๕
ศิลปะรูปธรรม	concrete art	๑๑ มี.ค. ๒๕๔๕
ศิลปะเกรโก-โรมัน	Greco-Roman art	๑๑ มี.ค. ๒๕๔๕
ศิลปะไร้รูปเคารพ	iconoclast art	๑๑ มี.ค. ๒๕๔๕
ศิลปะไม้แคระ	bonsai	๑๑ มี.ค. ๒๕๔๕
ศิลปะไร้วัตถุวิสัย	non-objective art	๑๑ มี.ค. ๒๕๔๕
ศิลปะไมซีนี	Mycenean art	๑๑ มี.ค. ๒๕๔๕
ศิลปะไซเบอร์เนติก	cybernetic art	๑๑ มี.ค. ๒๕๔๕
ศิลปะไซคลาดิส	Cycladic art	๑๑ มี.ค. ๒๕๔๕
ศิลปะกอทิก	Gothic art	๑๑ มี.ค. ๒๕๔๕
ศิลปะขยะ	junk art	๑๑ มี.ค. ๒๕๔๕
ศิลปะยุคกลาง	Medieval art	๑๑ มี.ค. ๒๕๔๕
ศิลปะวัตถุวิสัย	objective art	๑๑ มี.ค. ๒๕๔๕
ศิลปะสมถะ	arte povera; impoverished art	๑๑ มี.ค. ๒๕๔๕
ศิลปะสะพรึงกลัว	funk art	๑๑ มี.ค. ๒๕๔๕
ศิลปะสลายตัว	autodestructive art	๑๑ มี.ค. ๒๕๔๕
ศิลปะอะมาร์นา	Amarna art	๑๑ มี.ค. ๒๕๔๕
ศิลปะอนารยชน	barbarian art	๑๑ มี.ค. ๒๕๔๕
ศิลปะลวงตา	op art	๑๑ มี.ค. ๒๕๔๕
ศิลปะไม่แสดงลักษณ์	non-representational art	๑๑ มี.ค. ๒๕๔๕
ศิลปะไร้มายา	naive art	๑๑ มี.ค. ๒๕๔๕
ศิลปะคอมพิวเตอร์	computer art	๑๑ มี.ค. ๒๕๔๕
ศิลปะคอปต์	Coptic art	๑๑ มี.ค. ๒๕๔๕
ศิลปะจิตอลวน	psychiatric art	๑๑ มี.ค. ๒๕๔๕
ศิลปะชีวรูป	biomorphic art; bimorphic art	๑๑ มี.ค. ๒๕๔๕
ศิลปะชนดั้งเดิมออสเตรเลีย	Australian Aboriginal art	๑๑ มี.ค. ๒๕๔๕
ศิลปะดิบ	art brut	๑๑ มี.ค. ๒๕๔๕
ศิลปะตามหลักวิชา	academic art	๑๑ มี.ค. ๒๕๔๕
ศิลปะทรงรูป	plastic art	๑๑ มี.ค. ๒๕๔๕
ศิลปะนอกแบบ	art informel	๑๑ มี.ค. ๒๕๔๕
ศิลปะนามธรรม	abstract art	๑๑ มี.ค. ๒๕๔๕
ศิลปะประยุกต์	applied art	๑๑ มี.ค. ๒๕๔๕
ศิลปะประชานิยม	pop art	๑๑ มี.ค. ๒๕๔๕
ศิลปะผสานสิ่งแวดล้อม	environmental art	๑๑ มี.ค. ๒๕๔๕
ศิลปะพื้นบ้าน	folk art	๑๑ มี.ค. ๒๕๔๕
ศิลปหัตถกรรม	art and craft	๑๑ มี.ค. ๒๕๔๕
ศิลปิน	artist	๑๑ มี.ค. ๒๕๔๕
สีกลาง	neutral colour	๑๑ มี.ค. ๒๕๔๕
สีขาวคงทน	blanc fixe	๑๑ มี.ค. ๒๕๔๕
สีขาวจีน	chinese white	๑๑ มี.ค. ๒๕๔๕
สีขาวดีบุก	tin white	๑๑ มี.ค. ๒๕๔๕
สีขาวน้ำปูน	bianco sangiovanni	๑๑ มี.ค. ๒๕๔๕
สีคล้ำ	shade	๑๑ มี.ค. ๒๕๔๕
สีจาง, สีอ่อน	tint	๑๑ มี.ค. ๒๕๔๕
สีจาดตะกั่ว	flake white; white lead	๑๑ มี.ค. ๒๕๔๕
สีชุ่มน้ำ	mother wash	๑๑ มี.ค. ๒๕๔๕
สีซีเปีย	sepia	๑๑ มี.ค. ๒๕๔๕
สีกลืนกัน	blending colour	๑๑ มี.ค. ๒๕๔๕
สีขาว	white	๑๑ มี.ค. ๒๕๔๕
สีขาวสังกะสี	zinc white	๑๑ มี.ค. ๒๕๔๕
สีขาวไทเทเนียม	titanium white	๑๑ มี.ค. ๒๕๔๕
สีดิน	earth colour	๑๑ มี.ค. ๒๕๔๕
สีดินแดง	red ochre	๑๑ มี.ค. ๒๕๔๕
สีดินขาว	white earth	๑๑ มี.ค. ๒๕๔๕
สีตรงข้าม	complementary colour	๑๑ มี.ค. ๒๕๔๕
สีตาย	dead colour	๑๑ มี.ค. ๒๕๔๕
สีทอง	gold paint	๑๑ มี.ค. ๒๕๔๕
สีน้ำ	watercolour	๑๑ มี.ค. ๒๕๔๕
สีน้ำมัน	oil colour	๑๑ มี.ค. ๒๕๔๕
สีน้ำทอง	liquid bright gold	๑๑ มี.ค. ๒๕๔๕
สีน้ำทึบ	gouache	๑๑ มี.ค. ๒๕๔๕
หินหลักยอดโค้ง	keystone	๑๑ มี.ค. ๒๕๔๕
หินอะลาบาสเตอร์	alabaster	๑๑ มี.ค. ๒๕๔๕
หินอัญมณี	gemstone	๑๑ มี.ค. ๒๕๔๕
หินอัฒจันทร์	moonstone	๑๑ มี.ค. ๒๕๔๕
สำนักศิลปะ	academy of art	๑๑ มี.ค. ๒๕๔๕
หินตุ๊กตาจีน	agalmatolite	๑๑ มี.ค. ๒๕๔๕
สีบนเคลือบ	onglazed colour; overglazed colour	๑๑ มี.ค. ๒๕๔๕
สีบนเคลือบ	overglazed colour; onglazed colour	๑๑ มี.ค. ๒๕๔๕
สีปรกติ	local colour	๑๑ มี.ค. ๒๕๔๕
สีฝุ่น	tempera	๑๑ มี.ค. ๒๕๔๕
สีพอลิเมอร์	polymer paint	๑๑ มี.ค. ๒๕๔๕
epoch	สมัย	๑๑ มี.ค. ๒๕๔๕
erotic art	กามิกศิลป์	๑๑ มี.ค. ๒๕๔๕
etching	๑. กลวิธีพิมพ์กัดกรด<br/>๒. ภาพพิมพ์กัดกรด	๑๑ มี.ค. ๒๕๔๕
etching ground	พื้นพิมพ์กัดกรด	๑๑ มี.ค. ๒๕๔๕
etching press	เครื่องพิมพ์กัดกรด	๑๑ มี.ค. ๒๕๔๕
สูญขี้ผึ้ง	cire perdue; lost wax	๑๑ มี.ค. ๒๕๔๕
expressionism	ลัทธิสำแดงพลังอารมณ์	๑๑ มี.ค. ๒๕๔๕
หลักการซ้อนผสาน	simultaneity	๑๑ มี.ค. ๒๕๔๕
หลังคาทรงจั่วหักมุม	gambrel roof	๑๑ มี.ค. ๒๕๔๕
หลังคาทรงปั้นหยา	hip roof	๑๑ มี.ค. ๒๕๔๕
หลังคาโดม	cupola	๑๑ มี.ค. ๒๕๔๕
หลังคาแบบแมนซาร์ด	mansard roof	๑๑ มี.ค. ๒๕๔๕
หลังคาทรงเพิง	lean-to roof	๑๑ มี.ค. ๒๕๔๕
หลังคาทรงอานม้า	hyperbolic paraboloid roof	๑๑ มี.ค. ๒๕๔๕
หลังคาทรงจั่ว	gable roof	๑๑ มี.ค. ๒๕๔๕
สกุลศิลปะ	school	๑๑ มี.ค. ๒๕๔๕
สกุลศิลปะเวนิส	Venetian school	๑๑ มี.ค. ๒๕๔๕
สกุลศิลปะแอชแคน	Ashcan school	๑๑ มี.ค. ๒๕๔๕
สกุลศิลปะภารหุต	Bharahut school	๑๑ มี.ค. ๒๕๔๕
สกุลศิลปะดานูบ	Danube school	๑๑ มี.ค. ๒๕๔๕
สกุลศิลปะนอริช	Norwich school	๑๑ มี.ค. ๒๕๔๕
สกุลศิลปะบาร์บิซง	Barbizon school	๑๑ มี.ค. ๒๕๔๕
สกุลศิลปะปารีส	School of Paris	๑๑ มี.ค. ๒๕๔๕
สกุลศิลปะฟงแตนโบล	Fontainebleau school	๑๑ มี.ค. ๒๕๔๕
หงส์	hamsa	๑๑ มี.ค. ๒๕๔๕
สถานพักตากอากาศ	resort	๑๑ มี.ค. ๒๕๔๕
สถาปัตยลักษณ์	architectonic	๑๑ มี.ค. ๒๕๔๕
สถาปัตยกรรม	architecture	๑๑ มี.ค. ๒๕๔๕
สถาปัตยกรรมเฉพาะคราว	pseudo-architecture	๑๑ มี.ค. ๒๕๔๕
สถาบันเบาเฮาส์	Bauhaus	๑๑ มี.ค. ๒๕๔๕
สถาบันโบซาร์	"<font class=""europe"">École des Beaux-Arts</font>"	๑๑ มี.ค. ๒๕๔๕
สถาปัตยกรรมสมัยใหม่ยุคหลัง	post-modern architecture	๑๑ มี.ค. ๒๕๔๕
สถาปัตยกรรมอาณานิคม	colonial architecture	๑๑ มี.ค. ๒๕๔๕
หน้าจั่ว	gable	๑๑ มี.ค. ๒๕๔๕
หน้าต่างมุข	oriel; oriel window	๑๑ มี.ค. ๒๕๔๕
หน้าต่างหลังคา	dormer window	๑๑ มี.ค. ๒๕๔๕
หน้าต่างฝรั่งเศส	French window	๑๑ มี.ค. ๒๕๔๕
หน้ากระดานทับหลัง	architrave	๑๑ มี.ค. ๒๕๔๕
หนังสือกำหนดเทศกาล	Book of Hours	๑๑ มี.ค. ๒๕๔๕
หนังสือพิมพ์แกะไม้	block book	๑๑ มี.ค. ๒๕๔๕
สื่อ	medium	๑๑ มี.ค. ๒๕๔๕
สื่อผสม	intermedia; mixed media; multimedia	๑๑ มี.ค. ๒๕๔๕
หุ่นกระดาษ	"<font class=""europe"">papier mâché</font>"	๑๑ มี.ค. ๒๕๔๕
หุ่นกายวิภาค	"<font class=""europe"">ecorché</font>"	๑๑ มี.ค. ๒๕๔๕
หุ่นขี้ผึ้ง	wax model	๑๑ มี.ค. ๒๕๔๕
สุสานใต้ดิน	catacomb	๑๑ มี.ค. ๒๕๔๕
หุ่นร่าง	bozzetto	๑๑ มี.ค. ๒๕๔๕
หุ่นเชิด	marionette; puppet	๑๑ มี.ค. ๒๕๔๕
หุ่นจัดท่า	lay figure; manakin; manikin; mannikin	๑๑ มี.ค. ๒๕๔๕
สุนทรียศาสตร์	aesthetics	๑๑ มี.ค. ๒๕๔๕
สุนทรีย์	aesthetic	๑๑ มี.ค. ๒๕๔๕
fa-hua	ฝาหัว	๑๑ มี.ค. ๒๕๔๕
fa-lang	ฟาลัง	๑๑ มี.ค. ๒๕๔๕
facade	ด้านหน้าอาคาร	๑๑ มี.ค. ๒๕๔๕
facet cubism	บาศกนิยมแบบหน้าตัด	๑๑ มี.ค. ๒๕๔๕
facsimile	งานเหมือนแบบ	๑๑ มี.ค. ๒๕๔๕
faience	เครื่องถ้วยฟายองซ์	๑๑ มี.ค. ๒๕๔๕
fake	งานปลอม	๑๑ มี.ค. ๒๕๔๕
fancy	๑. การฝันเฟื่อง<br/>๒. แฟนซี	๑๑ มี.ค. ๒๕๔๕
fantasy	การฝันเฟื่อง	๑๑ มี.ค. ๒๕๔๕
fashion	สมัยนิยม	๑๑ มี.ค. ๒๕๔๕
fauves; fauvism	คติโฟวิสต์	๑๑ มี.ค. ๒๕๔๕
fauvism; fauves	คติโฟวิสต์	๑๑ มี.ค. ๒๕๔๕
"<font class=""europe"">Fête galante</font>"	ภาพรื่นรมย์หรูหรา	๑๑ มี.ค. ๒๕๔๕
fiberglass	ใยแก้ว	๑๑ มี.ค. ๒๕๔๕
figurative art	ศิลปะรูปลักษณ์	๑๑ มี.ค. ๒๕๔๕
figurine	จุลประติมากรรม	๑๑ มี.ค. ๒๕๔๕
filigree	ทองถัก, เงินถัก	๑๑ มี.ค. ๒๕๔๕
fine art	วิจิตรศิลป์	๑๑ มี.ค. ๒๕๔๕
finial	เครื่องยอด	๑๑ มี.ค. ๒๕๔๕
finish	๑. การแต่งสำเร็จ<br/>๒. งานสมบูรณ์แบบ	๑๑ มี.ค. ๒๕๔๕
fixative	น้ำยาเคลือบภาพ	๑๑ มี.ค. ๒๕๔๕
flake white; white lead	สีจาดตะกั่ว	๑๑ มี.ค. ๒๕๔๕
flashed glass	แก้วเคลือบแก้วสี	๑๑ มี.ค. ๒๕๔๕
flat; apartment	ห้องชุด	๑๑ มี.ค. ๒๕๔๕
flat colour	สีลักษณะเดียว	๑๑ มี.ค. ๒๕๔๕
flying buttress	ครีบยันลอย	๑๑ มี.ค. ๒๕๔๕
Fontainebleau school	สกุลศิลปะฟงแตนโบล	๑๑ มี.ค. ๒๕๔๕
folk art	ศิลปะพื้นบ้าน	๑๑ มี.ค. ๒๕๔๕
foreground	ฉากหน้า	๑๑ มี.ค. ๒๕๔๕
foreshortening	ลักษณะกินตา	๑๑ มี.ค. ๒๕๔๕
forgery	งานปลอมแปลง	๑๑ มี.ค. ๒๕๔๕
form	๑. รูปแบบ<br/>๒. รูปทรง	๑๑ มี.ค. ๒๕๔๕
forum	ลานประชาคม	๑๑ มี.ค. ๒๕๔๕
foul biting	รอยกรดกัดเปรอะ	๑๑ มี.ค. ๒๕๔๕
"<font class=""europe"">found object; objet trouvé</font>"	สิ่งเก็บตก	๑๑ มี.ค. ๒๕๔๕
free form	รูปทรงอิสระ	๑๑ มี.ค. ๒๕๔๕
free-standing	รูปเห็นรอบตัว	๑๑ มี.ค. ๒๕๔๕
French window	หน้าต่างฝรั่งเศส	๑๑ มี.ค. ๒๕๔๕
fresco	๑.กลวิธีวาดภาพปูนเปียก<br/>๒. ภาพปูนเปียก	๑๑ มี.ค. ๒๕๔๕
fret	ลายประแจ	๑๑ มี.ค. ๒๕๔๕
fretwork	งานไม้ฉลุ	๑๑ มี.ค. ๒๕๔๕
frottage	งานภาพถู	๑๑ มี.ค. ๒๕๔๕
fumage	กลวิธีรมควัน	๑๑ มี.ค. ๒๕๔๕
functionalism	คติคำนึงประโยชน์	๑๑ มี.ค. ๒๕๔๕
funk art	ศิลปะสะพรึงกลัว	๑๑ มี.ค. ๒๕๔๕
furnishing art; art mobilier	สังหาริมศิลป์	๑๑ มี.ค. ๒๕๔๕
gable	หน้าจั่ว	๑๑ มี.ค. ๒๕๔๕
gable roof	หลังคาทรงจั่ว	๑๑ มี.ค. ๒๕๔๕
fusuma-e	ฟุซุมะเอะ	๑๑ มี.ค. ๒๕๔๕
futurism	อนาคตนิยม	๑๑ มี.ค. ๒๕๔๕
gambrel roof	หลังคาทรงจั่วหักมุม	๑๑ มี.ค. ๒๕๔๕
gallery	หอศิลป์	๑๑ มี.ค. ๒๕๔๕
garuda	ครุฑ	๑๑ มี.ค. ๒๕๔๕
garden city	อุทยานนคร	๑๑ มี.ค. ๒๕๔๕
gargoyle	ปนาลี	๑๑ มี.ค. ๒๕๔๕
gems	อัญมณี	๑๑ มี.ค. ๒๕๔๕
gemstone	หินอัญมณี	๑๑ มี.ค. ๒๕๔๕
genre painting	ภาพชีวิตประจำวัน	๑๑ มี.ค. ๒๕๔๕
geometric abstraction	นามธรรมแบบเรขาคณิต	๑๑ มี.ค. ๒๕๔๕
geodesic dome	โดมแบบจีออเดสิก	๑๑ มี.ค. ๒๕๔๕
Geometric period	สมัยเรขาคณิต	๑๑ มี.ค. ๒๕๔๕
Georgian style	กระบวนแบบจอร์เจียน	๑๑ มี.ค. ๒๕๔๕
gesso	เจสโซ	๑๑ มี.ค. ๒๕๔๕
Gestalt	เกสตัลต์	๑๑ มี.ค. ๒๕๔๕
gild; guild	สมาคมช่าง	๑๑ มี.ค. ๒๕๔๕
gingerbread work	ลายขนมปังขิง	๑๑ มี.ค. ๒๕๔๕
glass craft	งานช่างแก้วและกระจก	๑๑ มี.ค. ๒๕๔๕
glass inlay	งานฝังประดับกระจก	๑๑ มี.ค. ๒๕๔๕
glass mosaic	งานโมเสกแก้ว	๑๑ มี.ค. ๒๕๔๕
glass painting	จิตรกรรมบนกระจก	๑๑ มี.ค. ๒๕๔๕
"<font class=""europe"">glass print; cliché-verre</font>"	ภาพพิมพ์ถ่ายกระจก	๑๑ มี.ค. ๒๕๔๕
glaze	๑. การเคลือบผิว<br/>๒. การระบายสีใส	๑๑ มี.ค. ๒๕๔๕
gloss firing	การเผาเคลือบ	๑๑ มี.ค. ๒๕๔๕
Gobelins	พรมผนังโกเบอแลง	๑๑ มี.ค. ๒๕๔๕
gold paint	สีทอง	๑๑ มี.ค. ๒๕๔๕
gold power	ผงทองคำ	๑๑ มี.ค. ๒๕๔๕
gold size	น้ำยาปิดทอง	๑๑ มี.ค. ๒๕๔๕
gold leaf	ทองคำเปลว	๑๑ มี.ค. ๒๕๔๕
Gothic art	ศิลปะกอทิก	๑๑ มี.ค. ๒๕๔๕
gouache	สีน้ำทึบ	๑๑ มี.ค. ๒๕๔๕
gouge	สิ่วร่อง	๑๑ มี.ค. ๒๕๔๕
grabiware	กราบิแวร์	๑๑ มี.ค. ๒๕๔๕
graffiti	รอยขูดขีดเขียน	๑๑ มี.ค. ๒๕๔๕
grain	ลายเนื้อวัสดุ	๑๑ มี.ค. ๒๕๔๕
graffito; sgraffito	๑. กลวิธีวาดภาพผนังขูด<br/>๒. ภาพผนังขูด	๑๑ มี.ค. ๒๕๔๕
graffrage; blind printing	กลวิธีพิมพ์ไร้สี	๑๑ มี.ค. ๒๕๔๕
graphic art	เลขนศิลป์	๑๑ มี.ค. ๒๕๔๕
graver; burin	สิ่วแท่ง	๑๑ มี.ค. ๒๕๔๕
Greco-Roman art	ศิลปะเกรโก-โรมัน	๑๑ มี.ค. ๒๕๔๕
grisaille	เอกรงค์เทา	๑๑ มี.ค. ๒๕๔๕
grog	เชื้อผงอิฐ	๑๑ มี.ค. ๒๕๔๕
grotesque	วิลักษณ์	๑๑ มี.ค. ๒๕๔๕
ground	พื้น	๑๑ มี.ค. ๒๕๔๕
guild; gild	สมาคมช่าง	๑๑ มี.ค. ๒๕๔๕
gypsum plaster	ปูนยิปซัม	๑๑ มี.ค. ๒๕๔๕
H.P.	เอชพี (รอยกดร้อน)	๑๑ มี.ค. ๒๕๔๕
hamsa	หงส์	๑๑ มี.ค. ๒๕๔๕
happening; manifestation; realization	คติฉับพลัน	๑๑ มี.ค. ๒๕๔๕
hard-edge painting	จิตรกรรมขอบคม	๑๑ มี.ค. ๒๕๔๕
harmika	บัลลังก์	๑๑ มี.ค. ๒๕๔๕
hatching	การแรเส้นเงา	๑๑ มี.ค. ๒๕๔๕
Hellenic art	ศิลปะเฮลลีน	๑๑ มี.ค. ๒๕๔๕
Hellenistic period	สมัยเฮลเลนิสติก	๑๑ มี.ค. ๒๕๔๕
high relief; alto-rilievo; deep relief	รูปนูนสูง	๑๑ มี.ค. ๒๕๔๕
hip roof	หลังคาทรงปั้นหยา	๑๑ มี.ค. ๒๕๔๕
historicism	ประวัติศาสตร์นิยม	๑๑ มี.ค. ๒๕๔๕
history painting	จิตรกรรมประวัติศาสตร์	๑๑ มี.ค. ๒๕๔๕
historiated initial	อักษรตัวต้นประดิษฐ์	๑๑ มี.ค. ๒๕๔๕
hollow relief; cavo-rilievo; incised relief; intaglio rilevato	รูปเว้า	๑๑ มี.ค. ๒๕๔๕
hot pressed	รอยกดร้อน (เอชพี)	๑๑ มี.ค. ๒๕๔๕
hot colour	สีร้อน	๑๑ มี.ค. ๒๕๔๕
hue	สีสัน	๑๑ มี.ค. ๒๕๔๕
hyper realism; super realism	อภิสัจนิยม	๑๑ มี.ค. ๒๕๔๕
hyperbolic paraboloid roof	หลังคาทรงอานม้า	๑๑ มี.ค. ๒๕๔๕
hypogeum	คูหาใต้ดิน	๑๑ มี.ค. ๒๕๔๕
อภิสัจนิยม	hyper realism; super realism	๑๑ มี.ค. ๒๕๔๕
icon	รูปเคารพ	๑๑ มี.ค. ๒๕๔๕
iconoclasm	ลัทธิทำลายรูปเคารพ	๑๑ มี.ค. ๒๕๔๕
iconoclast art	ศิลปะไร้รูปเคารพ	๑๑ มี.ค. ๒๕๔๕
iconology	ประติพิมพวิทยา	๑๑ มี.ค. ๒๕๔๕
อะมอริโน, เปมเทพ [เป-มะ-เทบ]	amorino	๑๑ มี.ค. ๒๕๔๕
อะลูมิเนียมชุบผิว	anodized aluminium	๑๑ มี.ค. ๒๕๔๕
อสมมาตร	asymmetry	๑๑ มี.ค. ๒๕๔๕
อ่างแช่กรด	acid bath	๑๑ มี.ค. ๒๕๔๕
ikat	มัดหมี่	๑๑ มี.ค. ๒๕๔๕
impressionism	ลัทธิประทับใจ	๑๑ มี.ค. ๒๕๔๕
impoverished art; arte povera	ศิลปะสมถะ	๑๑ มี.ค. ๒๕๔๕
impression	รอยพิมพ์	๑๑ มี.ค. ๒๕๔๕
incised relief; cavo-rilievo; hollow relief; intaglio rilevato	รูปเว้า	๑๑ มี.ค. ๒๕๔๕
industrial art	อุตสาหกรรมศิลป์	๑๑ มี.ค. ๒๕๔๕
industrial design	การออกแบบอุตสาหกรรม	๑๑ มี.ค. ๒๕๔๕
inert pigment	สารเพิ่มเนื้อสี	๑๑ มี.ค. ๒๕๔๕
inlay	งานฝังประดับ	๑๑ มี.ค. ๒๕๔๕
ink ball	ลูกประคบหมึก	๑๑ มี.ค. ๒๕๔๕
intaglio rilevato; cavo-rilievo; hollow relief; incised relief	รูปเว้า	๑๑ มี.ค. ๒๕๔๕
intaglio	กลวิธีพิมพ์ร่องลึก	๑๑ มี.ค. ๒๕๔๕
interior decoration	การตกแต่งภายใน	๑๑ มี.ค. ๒๕๔๕
interior design	การออกแบบภายใน	๑๑ มี.ค. ๒๕๔๕
intermedia; mixed media; multimedia	สื่อผสม	๑๑ มี.ค. ๒๕๔๕
intimism; intimisme	นิวาสนิยม	๑๑ มี.ค. ๒๕๔๕
intimisme; intimism	นิวาสนิยม	๑๑ มี.ค. ๒๕๔๕
อักษรวิจิตร	calligraphy	๑๑ มี.ค. ๒๕๔๕
อักษรตัวต้นประดิษฐ์	historiated initial	๑๑ มี.ค. ๒๕๔๕
อัครปุระ	acropolis	๑๑ มี.ค. ๒๕๔๕
อังก์	ankh	๑๑ มี.ค. ๒๕๔๕
อัญมณี	gems	๑๑ มี.ค. ๒๕๔๕
อัญมณีทรงหลังเบี้ย	cabochon	๑๑ มี.ค. ๒๕๔๕
อัตเลขน์	autograph	๑๑ มี.ค. ๒๕๔๕
อับสตรักซียง-เกรอาซียง	"<font class=""europe"">Abstraction-Création</font>"	๑๑ มี.ค. ๒๕๔๕
อาร์เมอรีโชว์	Armory Show	๑๑ มี.ค. ๒๕๔๕
อาร์ตเวิร์ก, งานศิลป์	artwork	๑๑ มี.ค. ๒๕๔๕
อาก์คันด์แวร์	aghkandware	๑๑ มี.ค. ๒๕๔๕
อาคารอิฐดิบ	adobe	๑๑ มี.ค. ๒๕๔๕
อิฐดิบ	adobe	๑๑ มี.ค. ๒๕๔๕
อินทรียสถาปัตยกรรม	organic architecture	๑๑ มี.ค. ๒๕๔๕
อู๋ไฉ่	wu-ts’ai	๑๑ มี.ค. ๒๕๔๕
อลังการศิลป์	art deco	๑๑ มี.ค. ๒๕๔๕
องค์ประกอบ	composition	๑๑ มี.ค. ๒๕๔๕
อนาคตนิยม	futurism	๑๑ มี.ค. ๒๕๔๕
อนุตรนิยม	suprematism	๑๑ มี.ค. ๒๕๔๕
อุตสาหกรรมศิลป์	industrial art	๑๑ มี.ค. ๒๕๔๕
อุทยานนคร	garden city	๑๑ มี.ค. ๒๕๔๕
อุปมานิทัศน์	allegory	๑๑ มี.ค. ๒๕๔๕
Jacobean style	กระบวนแบบจาโคเบียน	๑๑ มี.ค. ๒๕๔๕
Japanism; Japonism	คตินิยมศิลปะญี่ปุ่น	๑๑ มี.ค. ๒๕๔๕
Japonism; Japanism	คตินิยมศิลปะญี่ปุ่น	๑๑ มี.ค. ๒๕๔๕
jewelry	เครื่องเพชรพลอย	๑๑ มี.ค. ๒๕๔๕
joist	ตง, รอด, รา	๑๑ มี.ค. ๒๕๔๕
Jugendstil; art nouveau; modern style; modernista; noodle style; stile liberti	นวศิลป์	๑๑ มี.ค. ๒๕๔๕
junk art	ศิลปะขยะ	๑๑ มี.ค. ๒๕๔๕
kaolin	ดินขาว	๑๑ มี.ค. ๒๕๔๕
key	ระดับสี	๑๑ มี.ค. ๒๕๔๕
key block	แม่พิมพ์หลัก	๑๑ มี.ค. ๒๕๔๕
keystone	หินหลักยอดโค้ง	๑๑ มี.ค. ๒๕๔๕
kilin	กิเลน	๑๑ มี.ค. ๒๕๔๕
kiln	เตาเผา	๑๑ มี.ค. ๒๕๔๕
kinetic art	จลนศิลป์	๑๑ มี.ค. ๒๕๔๕
king post	ดั้ง	๑๑ มี.ค. ๒๕๔๕
kiosk	ศาลาเล็ก	๑๑ มี.ค. ๒๕๔๕
kirende	คิเร็นเดะ	๑๑ มี.ค. ๒๕๔๕
kirtimukha	เกียรติมุข	๑๑ มี.ค. ๒๕๔๕
knockdown	ถอดได้	๑๑ มี.ค. ๒๕๔๕
kore	โคเร	๑๑ มี.ค. ๒๕๔๕
kouros	คูรอส	๑๑ มี.ค. ๒๕๔๕
lacquer	แลกเกอร์	๑๑ มี.ค. ๒๕๔๕
lacquer work	งานลงรัก	๑๑ มี.ค. ๒๕๔๕
lacquerware	เครื่องเขิน	๑๑ มี.ค. ๒๕๔๕
laid paper	กระดาษลายอัด	๑๑ มี.ค. ๒๕๔๕
lake	๑. สีแดง<br/>๒. สีโปร่งใส	๑๑ มี.ค. ๒๕๔๕
laminated glass	กระจกประกบ	๑๑ มี.ค. ๒๕๔๕
lancet	ช่องรูปใบหอก	๑๑ มี.ค. ๒๕๔๕
landscape	๑. ภูมิทัศน์<br/>๒. ภาพทิวทัศน์บก	๑๑ มี.ค. ๒๕๔๕
lay figure; manakin; manikin; mannikin	หุ่นจัดท่า	๑๑ มี.ค. ๒๕๔๕
layout plan	แผนผังบริเวณ	๑๑ มี.ค. ๒๕๔๕
lean-to roof	หลังคาทรงเพิง	๑๑ มี.ค. ๒๕๔๕
limited edition	จำนวนพิมพ์จำกัด	๑๑ มี.ค. ๒๕๔๕
line engraving	๑. กลวิธีพิมพ์แกะลายเส้น<br/>๒. ภาพพิมพ์แกะลายเส้น	๑๑ มี.ค. ๒๕๔๕
linear perspective	ทัศนมิติเชิงเส้น	๑๑ มี.ค. ๒๕๔๕
linear style	กระบวนแบบเชิงเส้น	๑๑ มี.ค. ๒๕๔๕
linocut	๑. กลวิธีพิมพ์ยางแกะ<br/>๒. ภาพพิมพ์ยางแกะ	๑๑ มี.ค. ๒๕๔๕
lintel	ทับหลัง	๑๑ มี.ค. ๒๕๔๕
lithography	กลวิธีพิมพ์หิน	๑๑ มี.ค. ๒๕๔๕
liquid bright gold	สีน้ำทอง	๑๑ มี.ค. ๒๕๔๕
local colour	สีปรกติ	๑๑ มี.ค. ๒๕๔๕
lock up; quoin	ลิ่มอัดตัวพิมพ์	๑๑ มี.ค. ๒๕๔๕
logo	ตราสัญลักษณ์	๑๑ มี.ค. ๒๕๔๕
longitudinal section	รูปตัดตามยาว	๑๑ มี.ค. ๒๕๔๕
lost wax; cire perdue	สูญขี้ผึ้ง	๑๑ มี.ค. ๒๕๔๕
lotus throne	ปัทมอาสน์, ปัทมาสน์	๑๑ มี.ค. ๒๕๔๕
low relief; bas-relief; bosso-relievo	รูปนูนต่ำ	๑๑ มี.ค. ๒๕๔๕
luminous	เรืองรอง	๑๑ มี.ค. ๒๕๔๕
Lysippian proportion	ส่วนสัดแบบลิซิปปัส	๑๑ มี.ค. ๒๕๔๕
macrame	๑. งานถักปม<br/>๒. ชายครุยถักปม	๑๑ มี.ค. ๒๕๔๕
magic realism	สัจนิยมแนวมายา	๑๑ มี.ค. ๒๕๔๕
Madonna	ภาพแม่พระ	๑๑ มี.ค. ๒๕๔๕
maiolica	เครื่องถ้วยมาอิโอลิกา	๑๑ มี.ค. ๒๕๔๕
makeready	การเพิ่มแรงกดพิมพ์	๑๑ มี.ค. ๒๕๔๕
makara	มกร	๑๑ มี.ค. ๒๕๔๕
malerisch	แบบเชิงฝีแปรง	๑๑ มี.ค. ๒๕๔๕
manakin; lay figure; manikin; mannikin	หุ่นจัดท่า	๑๑ มี.ค. ๒๕๔๕
mandala	ภาพมณฑล	๑๑ มี.ค. ๒๕๔๕
"<font class=""europe"">manière criblée</font>; dotted manner"	๑. กลวิธีพิมพ์ภาพลายจุด<br/>๒. ภาพพิมพ์ลายจุด	๑๑ มี.ค. ๒๕๔๕
manifestation; happening; realization	คติฉับพลัน	๑๑ มี.ค. ๒๕๔๕
manifesto	คำแถลงอุดมการณ์, คำประกาศเจตนา	๑๑ มี.ค. ๒๕๔๕
manikin; lay figure; manakin; mannikin	หุ่นจัดท่า	๑๑ มี.ค. ๒๕๔๕
mansard roof	หลังคาแบบแมนซาร์ด	๑๑ มี.ค. ๒๕๔๕
mannerism	ลัทธิเกินพอดี, จริตนิยม	๑๑ มี.ค. ๒๕๔๕
mannikin; lay figure; manakin; manikin	หุ่นจัดท่า	๑๑ มี.ค. ๒๕๔๕
marine painting	จิตรกรรมท้องทะเล	๑๑ มี.ค. ๒๕๔๕
marionette; puppet	หุ่นเชิด	๑๑ มี.ค. ๒๕๔๕
marquetry	งานฝังไม้	๑๑ มี.ค. ๒๕๔๕
Master of...	ครูช่าง	๑๑ มี.ค. ๒๕๔๕
masterpiece	ผลงานยอดเยี่ยม	๑๑ มี.ค. ๒๕๔๕
Medieval art	ศิลปะยุคกลาง	๑๑ มี.ค. ๒๕๔๕
medium	สื่อ	๑๑ มี.ค. ๒๕๔๕
megaron	โถงแบบท้องพระโรง	๑๑ มี.ค. ๒๕๔๕
metal graphic	ภาพพิมพ์โลหะ	๑๑ มี.ค. ๒๕๔๕
metaphysical painting	จิตรกรรมแนวอภิปรัชญา	๑๑ มี.ค. ๒๕๔๕
mezzanine; entresol	ชั้นเสริม	๑๑ มี.ค. ๒๕๔๕
mezzo-rilievo; demi relief; middle relief	รูปนูนปานกลาง	๑๑ มี.ค. ๒๕๔๕
mezzotint	๑. กลวิธีพิมพ์มัชฌิมรงค์<br/>๒. ภาพพิมพ์มัชฌิมรงค์	๑๑ มี.ค. ๒๕๔๕
middle ground	ฉากกลาง	๑๑ มี.ค. ๒๕๔๕
middle relief; demi relief; mezzo-rilievo	รูปนูนปานกลาง	๑๑ มี.ค. ๒๕๔๕
minaret	หออะซาน	๑๑ มี.ค. ๒๕๔๕
miniature	จุลจิตรกรรม	๑๑ มี.ค. ๒๕๔๕
minimal art	สารัตถศิลป์	๑๑ มี.ค. ๒๕๔๕
Minoan art	ศิลปะแบบมิโนส	๑๑ มี.ค. ๒๕๔๕
minor art	จุลศิลป์	๑๑ มี.ค. ๒๕๔๕
mirror painting	จิตรกรรมกระจกเงา	๑๑ มี.ค. ๒๕๔๕
mixed media; intermedia; multimedia	สื่อผสม	๑๑ มี.ค. ๒๕๔๕
mobile	ประติมากรรมจลดุล	๑๑ มี.ค. ๒๕๔๕
modelling	๑. การปั้น<br/>๒. การเสริมมิติ<br/>๓. การวางท่าหุ่น	๑๑ มี.ค. ๒๕๔๕
modelling paste	สารแต่งผิว	๑๑ มี.ค. ๒๕๔๕
modern style; art nouveau; Jugendstil; modernista; noodle style; stile liberti	นวศิลป์	๑๑ มี.ค. ๒๕๔๕
modernista; art nouveau; Jugendstil; modern style; noodle style; stile liberti	นวศิลป์	๑๑ มี.ค. ๒๕๔๕
monochrome	เอกรงค์	๑๑ มี.ค. ๒๕๔๕
monographic	ภาพพิมพ์เอกเลขน์	๑๑ มี.ค. ๒๕๔๕
monoprint; monotype	ภาพพิมพ์แผ่นเดียว	๑๑ มี.ค. ๒๕๔๕
monotype; monoprint	ภาพพิมพ์แผ่นเดียว	๑๑ มี.ค. ๒๕๔๕
monumental	เชิงอนุสาวรีย์	๑๑ มี.ค. ๒๕๔๕
moonstone	๑. พลอยจันทรกานต์<br/>๒. หินอัฒจันทร์	๑๑ มี.ค. ๒๕๔๕
mosaic	งานโมเสก	๑๑ มี.ค. ๒๕๔๕
mother wash	สีชุ่มน้ำ	๑๑ มี.ค. ๒๕๔๕
motif	แม่บท	๑๑ มี.ค. ๒๕๔๕
moulding	บัว, ลวดบัว	๑๑ มี.ค. ๒๕๔๕
multimedia; intermedia; mixed media	สื่อผสม	๑๑ มี.ค. ๒๕๔๕
Munsell system	ระบบมันเซลล์	๑๑ มี.ค. ๒๕๔๕
mural painting	จิตรกรรมฝาผนัง	๑๑ มี.ค. ๒๕๔๕
museum	พิพิธภัณฑสถาน	๑๑ มี.ค. ๒๕๔๕
Mycenean art	ศิลปะไมซีนี	๑๑ มี.ค. ๒๕๔๕
Nabis	กลุ่มนาบี	๑๑ มี.ค. ๒๕๔๕
naive art	ศิลปะไร้มายา	๑๑ มี.ค. ๒๕๔๕
narrative painting	จิตรกรรมบรรยาย	๑๑ มี.ค. ๒๕๔๕
naturalism	ธรรมชาตินิยม	๑๑ มี.ค. ๒๕๔๕
neo-dada	คติดาดาใหม่	๑๑ มี.ค. ๒๕๔๕
neo-impressionism	ลัทธิประทับใจใหม่	๑๑ มี.ค. ๒๕๔๕
neo-plasticism	ลัทธิรูปทรงแนวใหม่	๑๑ มี.ค. ๒๕๔๕
neoclassicism	ลัทธิคลาสสิกใหม่	๑๑ มี.ค. ๒๕๔๕
neon sculpture	ประติมากรรมนีออน	๑๑ มี.ค. ๒๕๔๕
Neue Sachlichkeit; new objectivity	คติรูปธรรมแนวใหม่	๑๑ มี.ค. ๒๕๔๕
new objectivity; Neue Sachlichkeit	คติรูปธรรมแนวใหม่	๑๑ มี.ค. ๒๕๔๕
neutral colour	สีกลาง	๑๑ มี.ค. ๒๕๔๕
niche	ช่องเว้า	๑๑ มี.ค. ๒๕๔๕
nielloware	เครื่องถม	๑๑ มี.ค. ๒๕๔๕
non-objective art	ศิลปะไร้วัตถุวิสัย	๑๑ มี.ค. ๒๕๔๕
non-representational art	ศิลปะไม่แสดงลักษณ์	๑๑ มี.ค. ๒๕๔๕
noodle style; art nouveau; Jugendstil; modern style; modernista; stile liberti	นวศิลป์	๑๑ มี.ค. ๒๕๔๕
Norwich school	สกุลศิลปะนอริช	๑๑ มี.ค. ๒๕๔๕
objective art	ศิลปะวัตถุวิสัย	๑๑ มี.ค. ๒๕๔๕
objet d’art	งานวัตถุศิลป์	๑๑ มี.ค. ๒๕๔๕
"<font class=""europe"">objet trouvé; found object</font>"	สิ่งเก็บตก	๑๑ มี.ค. ๒๕๔๕
odalisque	ภาพนางในฮาเร็ม	๑๑ มี.ค. ๒๕๔๕
offset	กลวิธีออฟเซต	๑๑ มี.ค. ๒๕๔๕
OG (ogee)	โอจี	๑๑ มี.ค. ๒๕๔๕
ogee arch	ช่องโค้งโอจี	๑๑ มี.ค. ๒๕๔๕
ogee(OG)	โอจี	๑๑ มี.ค. ๒๕๔๕
oil colour	สีน้ำมัน	๑๑ มี.ค. ๒๕๔๕
onglazed colour; overglazed colour	สีบนเคลือบ	๑๑ มี.ค. ๒๕๔๕
op art	ศิลปะลวงตา	๑๑ มี.ค. ๒๕๔๕
open bite	รอยกรดกัดทะลุ	๑๑ มี.ค. ๒๕๔๕
opaque projector	เครื่องฉายภาพทึบแสง	๑๑ มี.ค. ๒๕๔๕
optical mixture	การผสานสีทางตา	๑๑ มี.ค. ๒๕๔๕
organic architecture	อินทรียสถาปัตยกรรม	๑๑ มี.ค. ๒๕๔๕
oriel; oriel window	หน้าต่างมุข	๑๑ มี.ค. ๒๕๔๕
oriel window; oriel	หน้าต่างมุข	๑๑ มี.ค. ๒๕๔๕
original	ต้นแบบ	๑๑ มี.ค. ๒๕๔๕
original print	ภาพพิมพ์ต้นแบบ	๑๑ มี.ค. ๒๕๔๕
ornament	ลายวิจิตร	๑๑ มี.ค. ๒๕๔๕
orphism	กลุ่มออร์ฟิสต์	๑๑ มี.ค. ๒๕๔๕
outline drawing	การวาดเส้นขอบ	๑๑ มี.ค. ๒๕๔๕
overglazed colour; onglazed colour	สีบนเคลือบ	๑๑ มี.ค. ๒๕๔๕
oxidation firing	การเผาแบบสมบูรณ์	๑๑ มี.ค. ๒๕๔๕
pagoda	เจดีย์	๑๑ มี.ค. ๒๕๔๕
painterly	เชิงฝีแปรง	๑๑ มี.ค. ๒๕๔๕
painterly style	กระบวนแบบเชิงฝีแปรง	๑๑ มี.ค. ๒๕๔๕
painting	จิตรกรรม	๑๑ มี.ค. ๒๕๔๕
painting knife	เกรียงเขียนภาพ	๑๑ มี.ค. ๒๕๔๕
Palissy ware	เครื่องถ้วยปาลีซี	๑๑ มี.ค. ๒๕๔๕
Palladian style	กระบวนแบบปัลลาดีโย	๑๑ มี.ค. ๒๕๔๕
palette knife	เกรียงผสมสี	๑๑ มี.ค. ๒๕๔๕
panel painting	จิตรกรรมแผง	๑๑ มี.ค. ๒๕๔๕
panorama	ภาพปริทัศน์	๑๑ มี.ค. ๒๕๔๕
pantograph	เครื่องวาดเขียนย่อขยาย	๑๑ มี.ค. ๒๕๔๕
paper-dimension	มิติกระดาษ	๑๑ มี.ค. ๒๕๔๕
"<font class=""europe"">papier collé</font>"	ภาพปะกระดาษ	๑๑ มี.ค. ๒๕๔๕
"<font class=""europe"">papier mâché</font>"	หุ่นกระดาษ	๑๑ มี.ค. ๒๕๔๕
parquet	งานปูปาร์เกต์	๑๑ มี.ค. ๒๕๔๕
paste print	ภาพพิมพ์กดกระดาษ	๑๑ มี.ค. ๒๕๔๕
pastel colour	สีแท่ง	๑๑ มี.ค. ๒๕๔๕
pastoral	จิตรกรรมท้องทุ่ง	๑๑ มี.ค. ๒๕๔๕
pattern	๑. แม่แบบ, กระสวน<br/>๒. แบบลาย	๑๑ มี.ค. ๒๕๔๕
patina	รอยคร่ำ	๑๑ มี.ค. ๒๕๔๕
patio	ลานกลางอาคาร	๑๑ มี.ค. ๒๕๔๕
pavilion	ศาลา	๑๑ มี.ค. ๒๕๔๕
period	สมัย	๑๑ มี.ค. ๒๕๔๕
perspective	ทัศนมิติ	๑๑ มี.ค. ๒๕๔๕
photo realism	สัจนิยมแบบภาพถ่าย	๑๑ มี.ค. ๒๕๔๕
piece mould	แม่พิมพ์ชิ้น	๑๑ มี.ค. ๒๕๔๕
"<font class=""europe"">pietà</font>"	รูปปีเอตา	๑๑ มี.ค. ๒๕๔๕
picture rail	รางแขวนภาพ	๑๑ มี.ค. ๒๕๔๕
picturesque	งามดั่งวาด	๑๑ มี.ค. ๒๕๔๕
Picturesque, the	ความงามดั่งภาพ	๑๑ มี.ค. ๒๕๔๕
pilaster	เสาอิง	๑๑ มี.ค. ๒๕๔๕
pigment	สารสี	๑๑ มี.ค. ๒๕๔๕
plan	ผัง	๑๑ มี.ค. ๒๕๔๕
plaster of Paris	ปูนปลาสเตอร์	๑๑ มี.ค. ๒๕๔๕
planography	กลวิธีพิมพ์พื้นราบ	๑๑ มี.ค. ๒๕๔๕
plastic art	ศิลปะทรงรูป	๑๑ มี.ค. ๒๕๔๕
pochoir	๑. กลวิธีพิมพ์สีลายฉลุ<br/>๒. ภาพพิมพ์สีลายฉลุ	๑๑ มี.ค. ๒๕๔๕
pointillism	ลัทธิผสานจุดสี	๑๑ มี.ค. ๒๕๔๕
polymer paint	สีพอลิเมอร์	๑๑ มี.ค. ๒๕๔๕
pop art	ศิลปะประชานิยม	๑๑ มี.ค. ๒๕๔๕
pornography	งานลามก	๑๑ มี.ค. ๒๕๔๕
porcelain	เครื่องถ้วยเปลือกไข่	๑๑ มี.ค. ๒๕๔๕
portfolio	แฟ้มภาพผลงาน	๑๑ มี.ค. ๒๕๔๕
portrait	รูปคนเหมือน	๑๑ มี.ค. ๒๕๔๕
post-impressionism	ลัทธิประทับใจยุคหลัง	๑๑ มี.ค. ๒๕๔๕
post-modern architecture	สถาปัตยกรรมสมัยใหม่ยุคหลัง	๑๑ มี.ค. ๒๕๔๕
post-painterly abstraction	งานนามธรรมเชิงฝีแปรงยุคหลัง	๑๑ มี.ค. ๒๕๔๕
prataksina	ประทักษิณ	๑๑ มี.ค. ๒๕๔๕
Pre-Raphaelite Brotherhood	กลุ่มนิยมแบบก่อนราฟาเอล	๑๑ มี.ค. ๒๕๔๕
prefabrication	การปรุงประกอบ	๑๑ มี.ค. ๒๕๔๕
primitive art	ศิลปะแบบดั้งเดิม	๑๑ มี.ค. ๒๕๔๕
primitivism	คตินิยมแบบดั้งเดิม	๑๑ มี.ค. ๒๕๔๕
product design	การออกแบบผลิตภัณฑ์	๑๑ มี.ค. ๒๕๔๕
proportion	ส่วนสัด	๑๑ มี.ค. ๒๕๔๕
pseudo-architecture	สถาปัตยกรรมเฉพาะคราว	๑๑ มี.ค. ๒๕๔๕
psychedelic art	ศิลปะมนัสปรีดิ์	๑๑ มี.ค. ๒๕๔๕
psychiatric art	ศิลปะจิตอลวน	๑๑ มี.ค. ๒๕๔๕
Ptolemaic art	ศิลปะโตเลมี	๑๑ มี.ค. ๒๕๔๕
puppet; marionette	หุ่นเชิด	๑๑ มี.ค. ๒๕๔๕
purism	พิสุทธินิยม	๑๑ มี.ค. ๒๕๔๕
push and pull	ดันและดึง	๑๑ มี.ค. ๒๕๔๕
putto	เปมเทพ, พุตโต	๑๑ มี.ค. ๒๕๔๕
Queen Anne style	กระบวนแบบควีนแอนน์	๑๑ มี.ค. ๒๕๔๕
quion; lock up	ลิ่มอัดตัวพิมพ์	๑๑ มี.ค. ๒๕๔๕
rayonism; rayonnism	ประภานิยม	๑๑ มี.ค. ๒๕๔๕
rayonnism; rayonism	ประภานิยม	๑๑ มี.ค. ๒๕๔๕
ready made	วัสดุสำเร็จรูป	๑๑ มี.ค. ๒๕๔๕
realism	สัจนิยม	๑๑ มี.ค. ๒๕๔๕
realization; happening; manifestation	คติฉับพลัน	๑๑ มี.ค. ๒๕๔๕
red	สีแดง	๑๑ มี.ค. ๒๕๔๕
red lead	สีเสน	๑๑ มี.ค. ๒๕๔๕
red ochre	สีดินแดง	๑๑ มี.ค. ๒๕๔๕
reduction firing	การเผาแบบไม่สมบูรณ์	๑๑ มี.ค. ๒๕๔๕
reflected colour	สีสะท้อน	๑๑ มี.ค. ๒๕๔๕
Regency	สมัยรีเจนซี	๑๑ มี.ค. ๒๕๔๕
relief	๑. นูน<br/>๒. รูปนูน	๑๑ มี.ค. ๒๕๔๕
relief engraving	กลวิธีพิมพ์ผิวนูน	๑๑ มี.ค. ๒๕๔๕
Renaissance	สมัยฟื้นฟูศิลปวิทยา	๑๑ มี.ค. ๒๕๔๕
replica	รูปถอดแบบ	๑๑ มี.ค. ๒๕๔๕
representational art	ศิลปะแสดงลักษณ์	๑๑ มี.ค. ๒๕๔๕
"<font class=""europe"">repoussé</font>"	การดุนลาย	๑๑ มี.ค. ๒๕๔๕
reproduction	การจำลองแบบ	๑๑ มี.ค. ๒๕๔๕
resort	สถานพักตากอากาศ	๑๑ มี.ค. ๒๕๔๕
rilievo-schiacciato; crushed relief; rilievo-stiacciato	รูปนูนบาง	๑๑ มี.ค. ๒๕๔๕
rilievo-stiacciato; crushed relief; rilievo-schiacciato	รูปนูนบาง	๑๑ มี.ค. ๒๕๔๕
rococo	โรโกโก	๑๑ มี.ค. ๒๕๔๕
Romanesque	สมัยโรมาเนสก์	๑๑ มี.ค. ๒๕๔๕
romanticism	จินตนิยม	๑๑ มี.ค. ๒๕๔๕
rostral column	เสานาวิกชัย	๑๑ มี.ค. ๒๕๔๕
rubbing	การถูภาพ	๑๑ มี.ค. ๒๕๔๕
Salon d’Automne	นิทรรศการศิลปกรรมซาลงโดตอน	๑๑ มี.ค. ๒๕๔๕
Salon des Refuses	นิทรรศการศิลปกรรมซาลงเดเรอฟูเซ	๑๑ มี.ค. ๒๕๔๕
Salon, The	นิทรรศการศิลปกรรมซาลง	๑๑ มี.ค. ๒๕๔๕
sand painting	จิตรกรรมทราย	๑๑ มี.ค. ๒๕๔๕
sand blasting	การพ่นทราย	๑๑ มี.ค. ๒๕๔๕
sand casting	การหล่อด้วยแม่พิมพ์ทราย	๑๑ มี.ค. ๒๕๔๕
saturation; colour saturation	ความอิ่มตัวสี	๑๑ มี.ค. ๒๕๔๕
School of Paris	สกุลศิลปะปารีส	๑๑ มี.ค. ๒๕๔๕
school	สกุลศิลปะ	๑๑ มี.ค. ๒๕๔๕
sculpture	ประติมากรรม	๑๑ มี.ค. ๒๕๔๕
seascape	ภาพทิวทัศน์ทะเล	๑๑ มี.ค. ๒๕๔๕
secco	๑. กลวิธีวาดภาพปูนแห้ง<br/>๒. ภาพปูนแห้ง	๑๑ มี.ค. ๒๕๔๕
secretary	โต๊ะเขียนหนังสือส่วนตัว	๑๑ มี.ค. ๒๕๔๕
section	รูปตัด	๑๑ มี.ค. ๒๕๔๕
sepia	สีซีเปีย	๑๑ มี.ค. ๒๕๔๕
serigraphy	กลวิธีพิมพ์ผ้าไหม	๑๑ มี.ค. ๒๕๔๕
settle	เก้าอี้ยาวพนักสูง	๑๑ มี.ค. ๒๕๔๕
settee	เก้าอี้ยาว	๑๑ มี.ค. ๒๕๔๕
sfumato	ภาพสีม่านหมอก	๑๑ มี.ค. ๒๕๔๕
sgraffito; graffito	๑. กลวิธีวาดภาพผนังขูด<br/>๒. ภาพผนังขูด	๑๑ มี.ค. ๒๕๔๕
shade	๑. ระดับคล้ำสี<br/>๒. สีคล้ำ	๑๑ มี.ค. ๒๕๔๕
sideboard	ตู้ชิดฝา	๑๑ มี.ค. ๒๕๔๕
silhouette	ภาพเงาทึบ	๑๑ มี.ค. ๒๕๔๕
silk screen	๑. กลวิธีพิมพ์ผ้าไหม<br/>๒. ภาพพิมพ์ผ้าไหม<br/>๓. แม่พิมพ์ผ้าไหม	๑๑ มี.ค. ๒๕๔๕
simultaneity	หลักการซ้อนผสาน	๑๑ มี.ค. ๒๕๔๕
simultaneous representation	การเสนอภาพซ้อนผสาน	๑๑ มี.ค. ๒๕๔๕
site plan	ผังเขต	๑๑ มี.ค. ๒๕๔๕
sketch	แบบร่าง	๑๑ มี.ค. ๒๕๔๕
sofa	เก้าอี้นวมยาว	๑๑ มี.ค. ๒๕๔๕
socialist realism	สัจนิยมแนวสังคมนิยม	๑๑ มี.ค. ๒๕๔๕
soft sculpture	ประติมากรรมนุ่ม	๑๑ มี.ค. ๒๕๔๕
soft-ground etching	๑. กลวิธีพิมพ์กัดกรดพื้นนิ่ม<br/>๒. ภาพพิมพ์กัดกรดพื้นนิ่ม	๑๑ มี.ค. ๒๕๔๕
sotto in su	ภาพมองแหงน	๑๑ มี.ค. ๒๕๔๕
space	ที่ว่าง	๑๑ มี.ค. ๒๕๔๕
space art	ปริภูมิศิลป์	๑๑ มี.ค. ๒๕๔๕
squaring	วิธีตีตาราง	๑๑ มี.ค. ๒๕๔๕
stabile	ประติมากรรมสถิต	๑๑ มี.ค. ๒๕๔๕
stained glass	งานกระจกสี	๑๑ มี.ค. ๒๕๔๕
stencil	กลวิธีพิมพ์ลายฉลุ	๑๑ มี.ค. ๒๕๔๕
still life	ภาพหุ่นนิ่ง	๑๑ มี.ค. ๒๕๔๕
stile liberti; art nouveau; Jugendstil; modern style; modernista	นวศิลป์	๑๑ มี.ค. ๒๕๔๕
stipple engraving	๑. กลวิธีพิมพ์แกะลายปรุ<br/>๒. ภาพพิมพ์แกะลายปรุ	๑๑ มี.ค. ๒๕๔๕
stoneware	เครื่องถ้วยหิน	๑๑ มี.ค. ๒๕๔๕
stool	ม้านั่งเดี่ยว	๑๑ มี.ค. ๒๕๔๕
stucco	ปูนแต่ง	๑๑ มี.ค. ๒๕๔๕
study	งานศึกษา	๑๑ มี.ค. ๒๕๔๕
style	กระบวนแบบ	๑๑ มี.ค. ๒๕๔๕
super realism; hyper realism	อภิสัจนิยม	๑๑ มี.ค. ๒๕๔๕
suprematism	อนุตรนิยม	๑๑ มี.ค. ๒๕๔๕
surrealism	ลัทธิเหนือจริง	๑๑ มี.ค. ๒๕๔๕
symbolism	สัญลักษณ์นิยม	๑๑ มี.ค. ๒๕๔๕
symmetry	สมมาตร	๑๑ มี.ค. ๒๕๔๕
synchromism; synchronism	รงคดุริยางค์	๑๑ มี.ค. ๒๕๔๕
synchronism; synchromism	รงคดุริยางค์	๑๑ มี.ค. ๒๕๔๕
synthetism	สังเคราะห์นิยม	๑๑ มี.ค. ๒๕๔๕
synthetic cubism	บาศกนิยมแบบสังเคราะห์	๑๑ มี.ค. ๒๕๔๕
tachisme	ตาชิสม์	๑๑ มี.ค. ๒๕๔๕
tactile values	คุณค่าเชิงผัสสะ	๑๑ มี.ค. ๒๕๔๕
tanka; thanka	ตังกา	๑๑ มี.ค. ๒๕๔๕
tapa	ผ้าเปลือกไม้	๑๑ มี.ค. ๒๕๔๕
tapestry	พรมผนัง	๑๑ มี.ค. ๒๕๔๕
Tatlinism	คตินิยมตัตลิน	๑๑ มี.ค. ๒๕๔๕
tea table	โต๊ะน้ำชา	๑๑ มี.ค. ๒๕๔๕
tempera	๑. สีฝุ่น<br/>๒. กลวิธีวาดภาพสีฝุ่น<br/>๓. จิตรกรรมสีฝุ่น	๑๑ มี.ค. ๒๕๔๕
tenebrism	แนวนิยมภาพสว่างในความมืด	๑๑ มี.ค. ๒๕๔๕
terracotta	เครื่องดินเผาสีหม้อใหม่	๑๑ มี.ค. ๒๕๔๕
texture	พื้นผิว	๑๑ มี.ค. ๒๕๔๕
thanka; tanka	ตังกา	๑๑ มี.ค. ๒๕๔๕
The Eight	กลุ่มแปด	๑๑ มี.ค. ๒๕๔๕
the Picturesque	ความงามดั่งภาพ	๑๑ มี.ค. ๒๕๔๕
The Salon	นิทรรศการศิลปกรรมซาลง	๑๑ มี.ค. ๒๕๔๕
thumbnail sketch	แบบร่างขนาดเล็ก	๑๑ มี.ค. ๒๕๔๕
time	กาละ	๑๑ มี.ค. ๒๕๔๕
tin white	สีขาวดีบุก	๑๑ มี.ค. ๒๕๔๕
tint	๑. ระดับอ่อนสี<br/>๒. สีอ่อน, สีจาง	๑๑ มี.ค. ๒๕๔๕
titanium white	สีขาวไทเทเนียม	๑๑ มี.ค. ๒๕๔๕
toluidine red	สีแดงโทลูอิดีน	๑๑ มี.ค. ๒๕๔๕
tone	วรรณะสี	๑๑ มี.ค. ๒๕๔๕
topiary work	ไม้แต่งทรง	๑๑ มี.ค. ๒๕๔๕
topography	ภูมิลักษณ์, ลักษณะภูมิประเทศ	๑๑ มี.ค. ๒๕๔๕
torana	ประตูโดรณะ	๑๑ มี.ค. ๒๕๔๕
torso	รูปลำตัว	๑๑ มี.ค. ๒๕๔๕
town planning	การวางผังเมือง	๑๑ มี.ค. ๒๕๔๕
townscape	ภาพทิวทัศน์เมือง	๑๑ มี.ค. ๒๕๔๕
traditional art	ศิลปะแบบประเพณี	๑๑ มี.ค. ๒๕๔๕
trompe l’oeil	ภาพหลอกตา	๑๑ มี.ค. ๒๕๔๕
turpentine	น้ำมันสน	๑๑ มี.ค. ๒๕๔๕
U-gouge	สิ่วร่องรูปตัวยู	๑๑ มี.ค. ๒๕๔๕
underglazed colour	สีใต้เคลือบ	๑๑ มี.ค. ๒๕๔๕
V-gouge	สิ่วร่องรูปตัววี (V)	๑๑ มี.ค. ๒๕๔๕
value	ค่าสี	๑๑ มี.ค. ๒๕๔๕
Venetian school	สกุลศิลปะเวนิส	๑๑ มี.ค. ๒๕๔๕
verism	คติสมจริง	๑๑ มี.ค. ๒๕๔๕
vestibule	๑. โถงทางเข้า<br/>๒. ห้องพักรอ	๑๑ มี.ค. ๒๕๔๕
vihara	วิหาร	๑๑ มี.ค. ๒๕๔๕
vista	วิถีทัศน์	๑๑ มี.ค. ๒๕๔๕
visual art	ทัศนศิลป์	๑๑ มี.ค. ๒๕๔๕
vorticism	คติวัฏฏารมณ์	๑๑ มี.ค. ๒๕๔๕
walnut oil	น้ำมันวอลนัต	๑๑ มี.ค. ๒๕๔๕
warp ikat	มัดหมี่ด้ายยืน	๑๑ มี.ค. ๒๕๔๕
warm colour	สีอุ่น	๑๑ มี.ค. ๒๕๔๕
waste mould	แม่พิมพ์ทุบ	๑๑ มี.ค. ๒๕๔๕
wash drawing	ภาพวาดเส้นไล้น้ำ	๑๑ มี.ค. ๒๕๔๕
water mark	ลายน้ำ	๑๑ มี.ค. ๒๕๔๕
wax sculpture	ประติมากรรมขี้ผึ้ง	๑๑ มี.ค. ๒๕๔๕
watercolour	สีน้ำ	๑๑ มี.ค. ๒๕๔๕
wax	ไข	๑๑ มี.ค. ๒๕๔๕
wax model	หุ่นขี้ผึ้ง	๑๑ มี.ค. ๒๕๔๕
weft ikat	มัดหมี่ด้ายพุ่ง	๑๑ มี.ค. ๒๕๔๕
white	สีขาว	๑๑ มี.ค. ๒๕๔๕
white earth	สีดินขาว	๑๑ มี.ค. ๒๕๔๕
white lead; flake white	สีจาดตะกั่ว	๑๑ มี.ค. ๒๕๔๕
wood engraving	ภาพพิมพ์ลายแกะไม้	๑๑ มี.ค. ๒๕๔๕
woodcut	ภาพพิมพ์แกะไม้	๑๑ มี.ค. ๒๕๔๕
workshop	งานร่วมปฏิบัติ	๑๑ มี.ค. ๒๕๔๕
worm’s-eye view	วิวตาหนอน	๑๑ มี.ค. ๒๕๔๕
x-ray painting	จิตรกรรมเอกซเรย์	๑๑ มี.ค. ๒๕๔๕
x-ray style	กระบวนแบบเอกซเรย์	๑๑ มี.ค. ๒๕๔๕
wu-ts’ai	อู๋ไฉ่	๑๑ มี.ค. ๒๕๔๕
yang-ts’ai	หยางไฉ่	๑๑ มี.ค. ๒๕๔๕
zinc etching	กลวิธีพิมพ์กัดกรดสังกะสี	๑๑ มี.ค. ๒๕๔๕
zinc white	สีขาวสังกะสี	๑๑ มี.ค. ๒๕๔๕
zirconium drier	น้ำยาแห้งเร็วเซอร์โคเนียม	๑๑ มี.ค. ๒๕๔๕
zones of recession	วิสัยใกล้ไกล	๑๑ มี.ค. ๒๕๔๕
zoning	การจำแนกย่าน	๑๑ มี.ค. ๒๕๔๕
ลวดบัว, บัว	moulding	๑๑ มี.ค. ๒๕๔๕
ลักษณะภูมิประเทศ, ภูมิลักษณ์	topography	๑๑ มี.ค. ๒๕๔๕
ลักษณะกินตา	foreshortening	๑๑ มี.ค. ๒๕๔๕
ลัทธิเหนือจริง	surrealism	๑๑ มี.ค. ๒๕๔๕
ลัทธิรูปทรงแนวใหม่	neo-plasticism	๑๑ มี.ค. ๒๕๔๕
ลัทธิเกินพอดี, จริตนิยม	mannerism	๑๑ มี.ค. ๒๕๔๕
ลัทธิเค้าโครง	constructivism	๑๑ มี.ค. ๒๕๔๕
ลัทธิสำแดงพลังอารมณ์	expressionism	๑๑ มี.ค. ๒๕๔๕
ลัทธิสำแดงพลังอารมณ์แนวนามธรรม	abstract expressionism	๑๑ มี.ค. ๒๕๔๕
ลัทธิทำลายรูปเคารพ	iconoclasm	๑๑ มี.ค. ๒๕๔๕
ลัทธิประทับใจ	impressionism	๑๑ มี.ค. ๒๕๔๕
ลัทธิประทับใจใหม่	neo-impressionism	๑๑ มี.ค. ๒๕๔๕
ลัทธิประทับใจยุคหลัง	post-impressionism	๑๑ มี.ค. ๒๕๔๕
ลัทธิผสานจุดสี	pointillism	๑๑ มี.ค. ๒๕๔๕
ลัทธิคลาสสิกใหม่	neoclassicism	๑๑ มี.ค. ๒๕๔๕
ลายเนื้อวัสดุ	grain	๑๑ มี.ค. ๒๕๔๕
ลายใบอะแคนทัส	acanthus	๑๑ มี.ค. ๒๕๔๕
ลายอะราเบสก์	arabesque	๑๑ มี.ค. ๒๕๔๕
ลำรางส่งน้ำ	aqueduct	๑๑ มี.ค. ๒๕๔๕
ลายวิจิตร	ornament	๑๑ มี.ค. ๒๕๔๕
ลายสัตว์กระหวัด	animal interlace	๑๑ มี.ค. ๒๕๔๕
ลายสาน	basket weave	๑๑ มี.ค. ๒๕๔๕
ลายขนมปังขิง	gingerbread work	๑๑ มี.ค. ๒๕๔๕
ลายน้ำ	water mark	๑๑ มี.ค. ๒๕๔๕
ลายนูน	anaglyph	๑๑ มี.ค. ๒๕๔๕
ลายประแจ	fret	๑๑ มี.ค. ๒๕๔๕
ลายฟันเรียง	dentils	๑๑ มี.ค. ๒๕๔๕
ลิ่มอัดตัวพิมพ์	lock up; quoin	๑๑ มี.ค. ๒๕๔๕
ลานกลางอาคาร	atrium; patio	๑๑ มี.ค. ๒๕๔๕
ลานประชาคม	forum	๑๑ มี.ค. ๒๕๔๕
ลูกกรงทรงคนโท	baluster	๑๑ มี.ค. ๒๕๔๕
ลูกกลิ้งมือ	brayer	๑๑ มี.ค. ๒๕๔๕
ลูกประคบ	dabber	๑๑ มี.ค. ๒๕๔๕
ลูกประคบหมึก	ink ball	๑๑ มี.ค. ๒๕๔๕
ไม้แคระ	bonsai	๑๑ มี.ค. ๒๕๔๕
ไม้แต่งทรง	topiary work	๑๑ มี.ค. ๒๕๔๕
ไม้กางเขนแบบแคลวารี	calvary cross	๑๑ มี.ค. ๒๕๔๕
ไม้กางเขนแบบเซลต์	Celtic cross	๑๑ มี.ค. ๒๕๔๕
ไข	wax	๑๑ มี.ค. ๒๕๔๕
กระสวน, แม่แบบ	pattern	๑๑ มี.ค. ๒๕๔๕
กระดาษลายอัด	laid paper	๑๑ มี.ค. ๒๕๔๕
กระจกประกบ	laminated glass	๑๑ มี.ค. ๒๕๔๕
กระบวนแบบ	style	๑๑ มี.ค. ๒๕๔๕
กระบวนแบบเอลิซาเบท	Elizabethan style	๑๑ มี.ค. ๒๕๔๕
กระบวนแบบเอกซเรย์	x-ray style	๑๑ มี.ค. ๒๕๔๕
กระบวนแบบรูปสัตว์	animal style	๑๑ มี.ค. ๒๕๔๕
กระบวนแบบเชิงเส้น	linear style	๑๑ มี.ค. ๒๕๔๕
กระบวนแบบเชิงฝีแปรง	painterly style	๑๑ มี.ค. ๒๕๔๕
กระบวนแบบเดดาลัส	Daedalic style	๑๑ มี.ค. ๒๕๔๕
กระบวนแบบใบหู	auricular style	๑๑ มี.ค. ๒๕๔๕
กระบวนแบบควีนแอนน์	Queen Anne style	๑๑ มี.ค. ๒๕๔๕
กระบวนแบบจะงอย	beak style	๑๑ มี.ค. ๒๕๔๕
กระบวนแบบจอร์เจียน	Georgian style	๑๑ มี.ค. ๒๕๔๕
กระบวนแบบจาโคเบียน	Jacobean style	๑๑ มี.ค. ๒๕๔๕
กระบวนแบบปัลลาดีโย	Palladian style	๑๑ มี.ค. ๒๕๔๕
กราบิแวร์	grabiware	๑๑ มี.ค. ๒๕๔๕
กวีนิพนธ์รูปธรรม	concrete poetry	๑๑ มี.ค. ๒๕๔๕
ก้ามวัด	callipers	๑๑ มี.ค. ๒๕๔๕
กอทิกแบบอเมริกัน	American Gothic	๑๑ มี.ค. ๒๕๔๕
กัมมันตจิตรกรรม	action painting	๑๑ มี.ค. ๒๕๔๕
การแรเส้นเงา	hatching	๑๑ มี.ค. ๒๕๔๕
การแรเส้นเงาขวาง	cross-hatching	๑๑ มี.ค. ๒๕๔๕
การระบายสีใส	glaze	๑๑ มี.ค. ๒๕๔๕
การระบายสีโดยตรง	alla prima; au premier coup; direct painting	๑๑ มี.ค. ๒๕๔๕
การเสริมมิติ	modelling	๑๑ มี.ค. ๒๕๔๕
การเสนอภาพซ้อนผสาน	simultaneous representation	๑๑ มี.ค. ๒๕๔๕
การแกะสลัก	carving	๑๑ มี.ค. ๒๕๔๕
การแกะลาย	engraving	๑๑ มี.ค. ๒๕๔๕
การเขียนภาพพู่กันแห้ง	dry-brush painting	๑๑ มี.ค. ๒๕๔๕
การเขียนสีขี้ผึ้งร้อน	encaustic; encaustic painting	๑๑ มี.ค. ๒๕๔๕
การเคลือบราน	crackle glaze	๑๑ มี.ค. ๒๕๔๕
การเคลือบเกล็ดประกาย	aventurine glaze	๑๑ มี.ค. ๒๕๔๕
การเคลือบแบบบริสตอล	Bristol glaze	๑๑ มี.ค. ๒๕๔๕
การเคลือบขี้เถ้า	ash glaze	๑๑ มี.ค. ๒๕๔๕
การเคลือบด่าง	alkaline glaze	๑๑ มี.ค. ๒๕๔๕
การเคลือบผิว	glaze	๑๑ มี.ค. ๒๕๔๕
การแต่งสำเร็จ	finish	๑๑ มี.ค. ๒๕๔๕
การแต่งลายนูนดินเหลว	barbotine	๑๑ มี.ค. ๒๕๔๕
การเน้นให้เด่น	accent	๑๑ มี.ค. ๒๕๔๕
การเผาดินดิบ	biscuit firing	๑๑ มี.ค. ๒๕๔๕
การเผาเคลือบ	gloss firing	๑๑ มี.ค. ๒๕๔๕
การเผาแบบสมบูรณ์	oxidation firing	๑๑ มี.ค. ๒๕๔๕
การเผาแบบไม่สมบูรณ์	reduction firing	๑๑ มี.ค. ๒๕๔๕
การเพิ่มแรงกดพิมพ์	makeready	๑๑ มี.ค. ๒๕๔๕
กายวิภาคทางศิลปะ	artistic anatomy	๑๑ มี.ค. ๒๕๔๕
กายวิภาคศาสตร์	anatomy	๑๑ มี.ค. ๒๕๔๕
การวางท่าหุ่น	modelling	๑๑ มี.ค. ๒๕๔๕
การวางผังเมือง	town planning	๑๑ มี.ค. ๒๕๔๕
การวาดเส้น	drawing	๑๑ มี.ค. ๒๕๔๕
การวาดเส้นแสดงทรง	contour drawing	๑๑ มี.ค. ๒๕๔๕
การวาดเส้นขอบ	outline drawing	๑๑ มี.ค. ๒๕๔๕
กายศิลป์	body art	๑๑ มี.ค. ๒๕๔๕
การหล่อ	casting	๑๑ มี.ค. ๒๕๔๕
การหล่อด้วยแม่พิมพ์ทราย	sand casting	๑๑ มี.ค. ๒๕๔๕
การออกแบบภายใน	interior design	๑๑ มี.ค. ๒๕๔๕
การออกแบบอุตสาหกรรม	industrial design	๑๑ มี.ค. ๒๕๔๕
การออกแบบผลิตภัณฑ์	product design	๑๑ มี.ค. ๒๕๔๕
การ์ตูน	cartoon	๑๑ มี.ค. ๒๕๔๕
กามิกศิลป์	erotic art	๑๑ มี.ค. ๒๕๔๕
การลงยา	enamel	๑๑ มี.ค. ๒๕๔๕
กิเลน	kilin	๑๑ มี.ค. ๒๕๔๕
การขดขึ้นรูป	coiling	๑๑ มี.ค. ๒๕๔๕
การค้างานศิลปะ	art dealing	๑๑ มี.ค. ๒๕๔๕
การจำแนกย่าน	zoning	๑๑ มี.ค. ๒๕๔๕
การจำลองแบบ	reproduction	๑๑ มี.ค. ๒๕๔๕
การดุนลาย	"<font class=""europe"">repoussé</font>"	๑๑ มี.ค. ๒๕๔๕
การตกแต่งภายใน	interior decoration	๑๑ มี.ค. ๒๕๔๕
การถูภาพ	rubbing	๑๑ มี.ค. ๒๕๔๕
การทำลายนูน	embossing	๑๑ มี.ค. ๒๕๔๕
การประดับ	adornment	๑๑ มี.ค. ๒๕๔๕
การปรุงประกอบ	prefabrication	๑๑ มี.ค. ๒๕๔๕
การปั้น	modelling	๑๑ มี.ค. ๒๕๔๕
การผสมผเส	assemblage	๑๑ มี.ค. ๒๕๔๕
การผสานสีทางตา	optical mixture	๑๑ มี.ค. ๒๕๔๕
การฝันเฟื่อง	fancy; fantasy	๑๑ มี.ค. ๒๕๔๕
การพ่นทราย	sand blasting	๑๑ มี.ค. ๒๕๔๕
กาละ	time	๑๑ มี.ค. ๒๕๔๕
กลวิธีพิมพ์ร่องลึก	intaglio	๑๑ มี.ค. ๒๕๔๕
กลวิธีพิมพ์มัชฌิมรงค์	mezzotint	๑๑ มี.ค. ๒๕๔๕
กลวิธีพิมพ์มัชฌิมรงค์อย่างสีน้ำ	aquatint mezzotint	๑๑ มี.ค. ๒๕๔๕
กลวิธีพิมพ์ยางแกะ	linocut	๑๑ มี.ค. ๒๕๔๕
กลวิธีพิมพ์ภาพลายจุด	"dotted manner; <font class=""europe"">manière criblée</font>"	๑๑ มี.ค. ๒๕๔๕
กลวิธีพิมพ์แกะลายเส้น	line engraving	๑๑ มี.ค. ๒๕๔๕
กลวิธีรมควัน	fumage	๑๑ มี.ค. ๒๕๔๕
กลวิธีรูปนูนสีต่างพื้น	cameo	๑๑ มี.ค. ๒๕๔๕
กลวิธีวาดภาพสีฝุ่น	tempera	๑๑ มี.ค. ๒๕๔๕
กลวิธีวาดภาพปูนแห้ง	secco	๑๑ มี.ค. ๒๕๔๕
กลวิธีวาดภาพปูนเปียก	fresco	๑๑ มี.ค. ๒๕๔๕
กลวิธีวาดภาพผนังขูด	graffito; sgraffito	๑๑ มี.ค. ๒๕๔๕
กลวิธีออฟเซต	offset	๑๑ มี.ค. ๒๕๔๕
กลวิธีลายจุด	"<font class=""europe"">criblé</font>"	๑๑ มี.ค. ๒๕๔๕
กลวิธีพิมพ์แกะลายปรุ	stipple engraving	๑๑ มี.ค. ๒๕๔๕
กลวิธีพิมพ์แกะไม้ค่าต่างแสง	chiaroscuro woodcut	๑๑ มี.ค. ๒๕๔๕
กลวิธีพิมพ์แบบเขียนถ่าน	crayon engraving; crayon manner	๑๑ มี.ค. ๒๕๔๕
กลวิธีพิมพ์แบบถู	burnishing	๑๑ มี.ค. ๒๕๔๕
กลวิธีพิมพ์สีลายฉลุ	pochoir	๑๑ มี.ค. ๒๕๔๕
กลวิธีพิมพ์หิน	lithography	๑๑ มี.ค. ๒๕๔๕
กลวิธีพิมพ์อย่างสีน้ำ	aquatint	๑๑ มี.ค. ๒๕๔๕
กลวิธีพิมพ์ลายฉลุ	stencil	๑๑ มี.ค. ๒๕๔๕
กลวิธีพิมพ์ไร้สี	blind printing; graffage	๑๑ มี.ค. ๒๕๔๕
กลวิธีพิมพ์กัดกรด	etching	๑๑ มี.ค. ๒๕๔๕
กลวิธีพิมพ์กัดกรดส่วนนูน	anastatic printing	๑๑ มี.ค. ๒๕๔๕
กลวิธีพิมพ์กัดกรดสังกะสี	zinc etching	๑๑ มี.ค. ๒๕๔๕
กลวิธีพิมพ์กัดกรดพื้นนิ่ม	soft-ground etching	๑๑ มี.ค. ๒๕๔๕
กลวิธีพิมพ์จารเข็ม	drypoint	๑๑ มี.ค. ๒๕๔๕
กลวิธีพิมพ์ผ้าไหม	serigraphy	๑๑ มี.ค. ๒๕๔๕
กลวิธีพิมพ์ผ้าไหม	silk screen	๑๑ มี.ค. ๒๕๔๕
กลวิธีพิมพ์ผิวนูน	relief engraving	๑๑ มี.ค. ๒๕๔๕
กลวิธีพิมพ์พื้นราบ	planography	๑๑ มี.ค. ๒๕๔๕
กล้องทาบเงา	camera obscura	๑๑ มี.ค. ๒๕๔๕
กล่องฝุ่นยางสน	dust box	๑๑ มี.ค. ๒๕๔๕
กลัวซอนเน	"<font class=""europe"">cloisonné</font>"	๑๑ มี.ค. ๒๕๔๕
กลุ่มโคบรา	COBRA	๑๑ มี.ค. ๒๕๔๕
กลุ่มเบลาเออเฟียร์	Blaue Vier	๑๑ มี.ค. ๒๕๔๕
กลุ่มเบลาเออไรเทอร์	Der Blaue Reiter	๑๑ มี.ค. ๒๕๔๕
กลุ่มแปด	The Eight	๑๑ มี.ค. ๒๕๔๕
กลุ่มศิลปินอเมริกันแนวนามธรรม	American abstract artists	๑๑ มี.ค. ๒๕๔๕
กลุ่มออร์ฟิสต์	orphism	๑๑ มี.ค. ๒๕๔๕
กลุ่มล้ำยุค	avant-garde	๑๑ มี.ค. ๒๕๔๕
กลุ่มดอกกุหลาบน้ำเงิน	Blue Rose Group	๑๑ มี.ค. ๒๕๔๕
กลุ่มนิยมแบบก่อนราฟาเอล	Pre-Raphaelite Brotherhood	๑๑ มี.ค. ๒๕๔๕
กลุ่มนาบี	Nabis	๑๑ มี.ค. ๒๕๔๕
ขวดอะลาบาสตรอน	alabastron	๑๑ มี.ค. ๒๕๔๕
ขั้นยื่น	corbel	๑๑ มี.ค. ๒๕๔๕
ขัดสมาธิเพชร, วัชราสน์	diamond posture	๑๑ มี.ค. ๒๕๔๕
ขบวนการศิลปหัตถกรรม	Art and Craft Movement	๑๑ มี.ค. ๒๕๔๕
ครรภมณฑล	cella; cellae	๑๑ มี.ค. ๒๕๔๕
คร่ำเงิน, คร่ำทอง	damascene	๑๑ มี.ค. ๒๕๔๕
คร่ำทอง, คร่ำเงิน	damascene	๑๑ มี.ค. ๒๕๔๕
ครีบยันลอย	flying buttress	๑๑ มี.ค. ๒๕๔๕
ครูช่าง	Master of...	๑๑ มี.ค. ๒๕๔๕
ครุฑ	garuda	๑๑ มี.ค. ๒๕๔๕
ความสดของสี, รงคะ	chroma	๑๑ มี.ค. ๒๕๔๕
ความอิ่มตัวสี	colour saturation; saturation	๑๑ มี.ค. ๒๕๔๕
ความงามดั่งภาพ	the Picturesque	๑๑ มี.ค. ๒๕๔๕
ค่าสี	value	๑๑ มี.ค. ๒๕๔๕
ค่าต่างแสง	chiaroscuro	๑๑ มี.ค. ๒๕๔๕
คอนกรีตเปลือย	bare concrete	๑๑ มี.ค. ๒๕๔๕
คัมภีร์มรณะ	Book of the Dead	๑๑ มี.ค. ๒๕๔๕
คิเร็นเดะ	kirende	๑๑ มี.ค. ๒๕๔๕
คำแถลงอุดมการณ์, คำประกาศเจตนา	manifesto	๑๑ มี.ค. ๒๕๔๕
คานยื่น	cantilever	๑๑ มี.ค. ๒๕๔๕
คำประกาศเจตนา, คำแถลงอุดมการณ์	manifesto	๑๑ มี.ค. ๒๕๔๕
คูรอส	kouros	๑๑ มี.ค. ๒๕๔๕
คูหาใต้ดิน	hypogeum	๑๑ มี.ค. ๒๕๔๕
คลาสสิก	classic; classical	๑๑ มี.ค. ๒๕๔๕
คติมูลฐาน	elementarism	๑๑ มี.ค. ๒๕๔๕
คติรูปธรรมแนวใหม่	Neue Sachlichkeit; new objectivity	๑๑ มี.ค. ๒๕๔๕
คติคำนึงประโยชน์	functionalism	๑๑ มี.ค. ๒๕๔๕
คติฉับพลัน	happening; manifestation; realization	๑๑ มี.ค. ๒๕๔๕
คติดาดา	dada; dadaism	๑๑ มี.ค. ๒๕๔๕
คติดาดาใหม่	neo-dada	๑๑ มี.ค. ๒๕๔๕
คติโฟวิสต์	fauvism; fauves	๑๑ มี.ค. ๒๕๔๕
คติวัฏฏารมณ์	vorticism	๑๑ มี.ค. ๒๕๔๕
คติสมจริง	verism	๑๑ มี.ค. ๒๕๔๕
คติสัญนิยม	conventionalism	๑๑ มี.ค. ๒๕๔๕
คติลวงตานามธรรม	abstract illusionism	๑๑ มี.ค. ๒๕๔๕
คตินิยมเส้นกั้นสี	cloisonism	๑๑ มี.ค. ๒๕๔๕
คตินิยมแบบดั้งเดิม	primitivism	๑๑ มี.ค. ๒๕๔๕
คตินิยมคลาสสิกแบบโบโลญญา	Bolognese Classicism	๑๑ มี.ค. ๒๕๔๕
คตินิยมตัตลิน	Tatlinism	๑๑ มี.ค. ๒๕๔๕
คตินิยมวิชาการ	academicism	๑๑ มี.ค. ๒๕๔๕
คตินิยมสรรผสาน	eclecticism	๑๑ มี.ค. ๒๕๔๕
คตินิยมศิลปะญี่ปุ่น	Japonism; Japanism	๑๑ มี.ค. ๒๕๔๕
คุณลักษณะ	attribute	๑๑ มี.ค. ๒๕๔๕
คุณค่าเชิงผัสสะ	tactile values	๑๑ มี.ค. ๒๕๔๕
งามดั่งวาด	picturesque	๑๑ มี.ค. ๒๕๔๕
งานโมเสก	mosaic	๑๑ มี.ค. ๒๕๔๕
งานโมเสกแก้ว	glass mosaic	๑๑ มี.ค. ๒๕๔๕
งานเย็บปักถักร้อย	embroidery	๑๑ มี.ค. ๒๕๔๕
งานเหมือนแบบ	facsimile	๑๑ มี.ค. ๒๕๔๕
งานร่วมปฏิบัติ	workshop	๑๑ มี.ค. ๒๕๔๕
งานภาพถู	frottage	๑๑ มี.ค. ๒๕๔๕
งานแกะสลัก	carving	๑๑ มี.ค. ๒๕๔๕
งานวัตถุศิลป์	objet d’art	๑๑ มี.ค. ๒๕๔๕
งานศิลป์, อาร์ตเวิร์ก	artwork	๑๑ มี.ค. ๒๕๔๕
งานศึกษา	study	๑๑ มี.ค. ๒๕๔๕
งานลามก	pornography	๑๑ มี.ค. ๒๕๔๕
งานปูปาร์เกต์	parquet	๑๑ มี.ค. ๒๕๔๕
งานปลอม	fake	๑๑ มี.ค. ๒๕๔๕
งานปลอมแปลง	forgery	๑๑ มี.ค. ๒๕๔๕
งานผ้าปะติด	"<font class=""europe"">appliqué</font>"	๑๑ มี.ค. ๒๕๔๕
งานฝังไม้	marquetry	๑๑ มี.ค. ๒๕๔๕
งานฝังประดับ	inlay	๑๑ มี.ค. ๒๕๔๕
งานฝังประดับแบบบูล	Boulle marquetry; Buhl marquetry	๑๑ มี.ค. ๒๕๔๕
งานฝังประดับกระจก	glass inlay	๑๑ มี.ค. ๒๕๔๕
งานลงรัก	lacquer work	๑๑ มี.ค. ๒๕๔๕
งานไม้ฉลุ	fretwork	๑๑ มี.ค. ๒๕๔๕
งานกระจกสี	stained glass	๑๑ มี.ค. ๒๕๔๕
งานช่างแก้วและกระจก	glass craft	๑๑ มี.ค. ๒๕๔๕
งานถักปม	macrame	๑๑ มี.ค. ๒๕๔๕
งานนามธรรมเชิงฝีแปรงยุคหลัง	post-painterly abstraction	๑๑ มี.ค. ๒๕๔๕
งานพิมพ์วัสดุปะติด	collagraph; collograph	๑๑ มี.ค. ๒๕๔๕
งานพิลึก	antic work	๑๑ มี.ค. ๒๕๔๕
จริตนิยม, ลัทธิเกินพอดี	mannerism	๑๑ มี.ค. ๒๕๔๕
จิตรกรรมเอกซเรย์	x-ray painting	๑๑ มี.ค. ๒๕๔๕
จิตรกรรมเต็มผืน	all-over painting	๑๑ มี.ค. ๒๕๔๕
จิตรกรรมแนวอภิปรัชญา	metaphysical painting	๑๑ มี.ค. ๒๕๔๕
จิตรกรรมแนวทรงสถิต	concrete painting	๑๑ มี.ค. ๒๕๔๕
จิตรกรรมแบบผสม	combine painting	๑๑ มี.ค. ๒๕๔๕
จิตรกรรมเปลือกไม้	bark painting	๑๑ มี.ค. ๒๕๔๕
จิตรกรรมแผง	panel painting	๑๑ มี.ค. ๒๕๔๕
จิตรกรรมสี	colour painting	๑๑ มี.ค. ๒๕๔๕
จิตรกรรมสีฝุ่น	tempera	๑๑ มี.ค. ๒๕๔๕
จิตรกรรมสนามสี	colour-field painting	๑๑ มี.ค. ๒๕๔๕
จิตรกรรมกระจกเงา	mirror painting	๑๑ มี.ค. ๒๕๔๕
จิตรกรรมขอบคม	hard-edge painting	๑๑ มี.ค. ๒๕๔๕
จิตรกรรมขาหยั่ง	easel painting	๑๑ มี.ค. ๒๕๔๕
จิตรกรรมคนยากไร้	bambocciata	๑๑ มี.ค. ๒๕๔๕
จิตรกรรมจินตภาพนามธรรม	abstract image painting	๑๑ มี.ค. ๒๕๔๕
จิตรกรรมชีวิตอเมริกัน	American scene painting	๑๑ มี.ค. ๒๕๔๕
จิตรกรรมถ้ำอัลตามีรา	Altamira Cave painting	๑๑ มี.ค. ๒๕๔๕
จิตรกรรมถ้ำอชันตา	Ajanta Cave painting	๑๑ มี.ค. ๒๕๔๕
จิตรกรรมทราย	sand painting	๑๑ มี.ค. ๒๕๔๕
จิตรกรรมท้องทะเล	marine painting	๑๑ มี.ค. ๒๕๔๕
จิตรกรรม	painting	๑๑ มี.ค. ๒๕๔๕
จิตรกรรมรอยพู่กัน	calligraphic painting	๑๑ มี.ค. ๒๕๔๕
จิตรกรรมท้องทุ่ง	pastoral	๑๑ มี.ค. ๒๕๔๕
จิตรกรรมบรรยาย	narrative painting	๑๑ มี.ค. ๒๕๔๕
จิตรกรรมบนกระจก	glass painting	๑๑ มี.ค. ๒๕๔๕
จิตรกรรมประวัติศาสตร์	history painting	๑๑ มี.ค. ๒๕๔๕
จิตรกรรมฝาผนัง	mural painting	๑๑ มี.ค. ๒๕๔๕
จำนวนพิมพ์จำกัด	limited edition	๑๑ มี.ค. ๒๕๔๕
จานสีพาดแขน	arm palette	๑๑ มี.ค. ๒๕๔๕
จินตนิยม	romanticism	๑๑ มี.ค. ๒๕๔๕
จลนศิลป์	kinetic art	๑๑ มี.ค. ๒๕๔๕
จุลศิลป์	minor art	๑๑ มี.ค. ๒๕๔๕
จุลจิตรกรรม	miniature	๑๑ มี.ค. ๒๕๔๕
จุลประติมากรรม	figurine	๑๑ มี.ค. ๒๕๔๕
ฉันนบถ	arcade	๑๑ มี.ค. ๒๕๔๕
ฉากหลัง	background	๑๑ มี.ค. ๒๕๔๕
ฉากหน้า	foreground	๑๑ มี.ค. ๒๕๔๕
ฉากกลาง	middle ground	๑๑ มี.ค. ๒๕๔๕
ฉากประดับแท่นบูชา	altarpiece	๑๑ มี.ค. ๒๕๔๕
ช่องเว้า	niche	๑๑ มี.ค. ๒๕๔๕
ช่องโค้ง	arch	๑๑ มี.ค. ๒๕๔๕
ช่องโค้งโอจี	ogee arch	๑๑ มี.ค. ๒๕๔๕
ช่องรูปใบหอก	lancet	๑๑ มี.ค. ๒๕๔๕
ช่องทางเดิน	aisle	๑๑ มี.ค. ๒๕๔๕
ช่างศิลป์	artisan	๑๑ มี.ค. ๒๕๔๕
ชองเปลอเว	"<font class=""europe"">champlevé</font>"	๑๑ มี.ค. ๒๕๔๕
ชั้นเสริม	entresol; mezzanine	๑๑ มี.ค. ๒๕๔๕
ชายครุยถักปม	macrame	๑๑ มี.ค. ๒๕๔๕
ซุ้มบูชา	aedicula	๑๑ มี.ค. ๒๕๔๕
ดรุณเทพ, เชรับ	cherub	๑๑ มี.ค. ๒๕๔๕
ด้านหน้าอาคาร	facade	๑๑ มี.ค. ๒๕๔๕
ดั้ง	king post	๑๑ มี.ค. ๒๕๔๕
ดันและดึง	push and pull	๑๑ มี.ค. ๒๕๔๕
ดินขาว	kaolin	๑๑ มี.ค. ๒๕๔๕
ดุลยภาพ	balance	๑๑ มี.ค. ๒๕๔๕
ตราสัญลักษณ์	logo	๑๑ มี.ค. ๒๕๔๕
ตราประทับ	chop	๑๑ มี.ค. ๒๕๔๕
ต้นแบบ	original	๑๑ มี.ค. ๒๕๔๕
ตังกา	tanka; thanka	๑๑ มี.ค. ๒๕๔๕
ตับลูกกรง	balustrade	๑๑ มี.ค. ๒๕๔๕
ตามแบบอย่าง	after	๑๑ มี.ค. ๒๕๔๕
ตาชิสม์	tachisme	๑๑ มี.ค. ๒๕๔๕
ตู้ชิดฝา	sideboard	๑๑ มี.ค. ๒๕๔๕
ตง, รอด, รา	joist	๑๑ มี.ค. ๒๕๔๕
ถ่านแท่ง	crayon	๑๑ มี.ค. ๒๕๔๕
ถอดได้	knockdown	๑๑ มี.ค. ๒๕๔๕
ทวิภาพ	double image	๑๑ มี.ค. ๒๕๔๕
ทวิอัฒจันทร์	amphitheatre	๑๑ มี.ค. ๒๕๔๕
ทองสัมฤทธิ์	bronze	๑๑ มี.ค. ๒๕๔๕
ทองคำเปลว	gold leaf	๑๑ มี.ค. ๒๕๔๕
ทองถัก, เงินถัก	filigree	๑๑ มี.ค. ๒๕๔๕
ทัศนมิติ	perspective	๑๑ มี.ค. ๒๕๔๕
ทัศนมิติเชิงเส้น	linear perspective	๑๑ มี.ค. ๒๕๔๕
ทัศนมิติเชิงอากาศ	aerial perspective	๑๑ มี.ค. ๒๕๔๕
ทัศนมิติเชิงบรรยากาศ	atmospheric perspective	๑๑ มี.ค. ๒๕๔๕
ทัศนศิลป์	visual art	๑๑ มี.ค. ๒๕๔๕
ทับหลัง	lintel	๑๑ มี.ค. ๒๕๔๕
ที่ว่าง	space	๑๑ มี.ค. ๒๕๔๕
ทางเดินเชื่อมอาคาร	corridor	๑๑ มี.ค. ๒๕๔๕
ทางเดินในอาคาร	corridor	๑๑ มี.ค. ๒๕๔๕
ทูตสวรรค์, เทวทูต, นางฟ้า	angel	๑๑ มี.ค. ๒๕๔๕
ธรรมชาตินิยม	naturalism	๑๑ มี.ค. ๒๕๔๕
นวศิลป์	art nouveau; Jugendstil; modern style; modernista; noodle style; stile liberti	๑๑ มี.ค. ๒๕๔๕
น้ำมันวอลนัต	walnut oil	๑๑ มี.ค. ๒๕๔๕
น้ำมันสน	turpentine	๑๑ มี.ค. ๒๕๔๕
น้ำยาแห้งเร็วเซอร์โคเนียม	zirconium drier	๑๑ มี.ค. ๒๕๔๕
น้ำยาเคลือบภาพ	fixative	๑๑ มี.ค. ๒๕๔๕
น้ำยาปิดทอง	gold size	๑๑ มี.ค. ๒๕๔๕
น้ำประสานทอง	borax	๑๑ มี.ค. ๒๕๔๕
นามธรรมแบบเรขาคณิต	geometric abstraction	๑๑ มี.ค. ๒๕๔๕
นามธรรมแบบคลาสสิก	classical abstraction	๑๑ มี.ค. ๒๕๔๕
นิวาสนิยม	intimism; intimisme	๑๑ มี.ค. ๒๕๔๕
นางจรัล	colonnade	๑๑ มี.ค. ๒๕๔๕
นางฟ้า, ทูตสวรรค์, เทวทูต	angel	๑๑ มี.ค. ๒๕๔๕
นูน	relief	๑๑ มี.ค. ๒๕๔๕
นิทรรศการศิลปกรรมซาลง	The Salon	๑๑ มี.ค. ๒๕๔๕
นิทรรศการศิลปกรรมซาลงเดเรอฟูเซ	Salon des Refuses	๑๑ มี.ค. ๒๕๔๕
นิทรรศการศิลปกรรมซาลงโดตอน	Salon d’Automne	๑๑ มี.ค. ๒๕๔๕
นิทรรศการศิลปกรรมดอคิวเมนตา	Documenta	๑๑ มี.ค. ๒๕๔๕
บัว, ลวดบัว	moulding	๑๑ มี.ค. ๒๕๔๕
บัวคอร์นิซ	cornice	๑๑ มี.ค. ๒๕๔๕
บัวปิดแนววงกบ	architrave	๑๑ มี.ค. ๒๕๔๕
บัลลังก์	harmika	๑๑ มี.ค. ๒๕๔๕
บัญญัติส่วนสัด	Canon of Proportion	๑๑ มี.ค. ๒๕๔๕
บาโรก, บารอก	baroque	๑๑ มี.ค. ๒๕๔๕
บารอก, บาโรก	baroque	๑๑ มี.ค. ๒๕๔๕
บาศกนิยม	cubism	๑๑ มี.ค. ๒๕๔๕
บาศกนิยมแบบวิเคราะห์	analytical cubism	๑๑ มี.ค. ๒๕๔๕
บาศกนิยมแบบสังเคราะห์	synthetic cubism	๑๑ มี.ค. ๒๕๔๕
บาศกนิยมแบบหน้าตัด	facet cubism	๑๑ มี.ค. ๒๕๔๕
บานเฟี้ยม	accordion door	๑๑ มี.ค. ๒๕๔๕
บุคเคอโร	bucchero	๑๑ มี.ค. ๒๕๔๕
ประภานิยม	rayonism; rayonnism	๑๑ มี.ค. ๒๕๔๕
ประวัติศาสตร์นิยม	historicism	๑๑ มี.ค. ๒๕๔๕
ประจักษทัศน์	diorama	๑๑ มี.ค. ๒๕๔๕
ประติมากรรม	sculpture	๑๑ มี.ค. ๒๕๔๕
ประติมากรรมโลหะวิธีตรง	direct metal sculpture	๑๑ มี.ค. ๒๕๔๕
ประติมากรรมวิธีตรง	direct sculpture	๑๑ มี.ค. ๒๕๔๕
ประติมากรรมสถิต	stabile	๑๑ มี.ค. ๒๕๔๕
ประติมากรรมขี้ผึ้ง	wax sculpture	๑๑ มี.ค. ๒๕๔๕
ประติมากรรมจลดุล	mobile	๑๑ มี.ค. ๒๕๔๕
ประติมากรรมนีออน	neon sculpture	๑๑ มี.ค. ๒๕๔๕
ประติมากรรมนุ่ม	soft sculpture	๑๑ มี.ค. ๒๕๔๕
ประติพิมพวิทยา	iconology	๑๑ มี.ค. ๒๕๔๕
ประตูโดรณะ	torana	๑๑ มี.ค. ๒๕๔๕
ประทักษิณ	prataksina	๑๑ มี.ค. ๒๕๔๕
ปริภูมิศิลป์	space art	๑๑ มี.ค. ๒๕๔๕
ปราการ	battlement	๑๑ มี.ค. ๒๕๔๕
ปัทมอาสน์, ปัทมาสน์	lotus throne	๑๑ มี.ค. ๒๕๔๕
ปัทมาสน์, ปัทมอาสน์	lotus throne	๑๑ มี.ค. ๒๕๔๕
ปาเต๊ะ	batik	๑๑ มี.ค. ๒๕๔๕
ปูนยิปซัม	gypsum plaster	๑๑ มี.ค. ๒๕๔๕
ปูนแต่ง	stucco	๑๑ มี.ค. ๒๕๔๕
ปูนปลาสเตอร์	plaster of Paris	๑๑ มี.ค. ๒๕๔๕
ปฏิศิลป์	anti-art	๑๑ มี.ค. ๒๕๔๕
ปฏิลักษณ์	anti-form	๑๑ มี.ค. ๒๕๔๕
ปนาลี	gargoyle	๑๑ มี.ค. ๒๕๔๕
ผ้ายก	brocade	๑๑ มี.ค. ๒๕๔๕
ผ้าใบอะคริลิก	acrylic canvas	๑๑ มี.ค. ๒๕๔๕
ผ้าเปลือกไม้	tapa	๑๑ มี.ค. ๒๕๔๕
ผัง	plan	๑๑ มี.ค. ๒๕๔๕
ผังเขต	site plan	๑๑ มี.ค. ๒๕๔๕
ผลงานยอดเยี่ยม	masterpiece	๑๑ มี.ค. ๒๕๔๕
ผงทองคำ	gold power	๑๑ มี.ค. ๒๕๔๕
ผนังม่าน	curtain wall	๑๑ มี.ค. ๒๕๔๕
ผนังรับน้ำหนัก	bearing wall	๑๑ มี.ค. ๒๕๔๕
ผนังปิดล้อม	enclosure wall	๑๑ มี.ค. ๒๕๔๕
ฝาหัว	fa-hua	๑๑ มี.ค. ๒๕๔๕
พรมผนัง	tapestry	๑๑ มี.ค. ๒๕๔๕
พรมผนังโกเบอแลง	Gobelins	๑๑ มี.ค. ๒๕๔๕
พิสุทธินิยม	purism	๑๑ มี.ค. ๒๕๔๕
พาณิชยศิลป์	commercial art	๑๑ มี.ค. ๒๕๔๕
พิดาน	canopy	๑๑ มี.ค. ๒๕๔๕
พิพิธภัณฑสถาน	museum	๑๑ มี.ค. ๒๕๔๕
พู่กัน	brush	๑๑ มี.ค. ๒๕๔๕
พู่กันลม	air brush	๑๑ มี.ค. ๒๕๔๕
พลวง	antimony	๑๑ มี.ค. ๒๕๔๕
พลอยจันทรกานต์	moonstone	๑๑ มี.ค. ๒๕๔๕
พื้น	ground	๑๑ มี.ค. ๒๕๔๕
พื้นซับสี	absorbent ground	๑๑ มี.ค. ๒๕๔๕
พื้นผิว	texture	๑๑ มี.ค. ๒๕๔๕
พื้นพิมพ์กัดกรด	etching ground	๑๑ มี.ค. ๒๕๔๕
พุตโต, เปมเทพ	putto	๑๑ มี.ค. ๒๕๔๕
ฟาลัง	fa-lang	๑๑ มี.ค. ๒๕๔๕
ฟุซุมะเอะ	fusuma-e	๑๑ มี.ค. ๒๕๔๕
